,Lyrics,label,y,knu_score,kosac_score,total
0,아침에 일어나 너에게 짧은 인사를 보낸다 아무리 멀리 떨어져 있어도 널 생각하고 있어 늦은 밤 졸린 눈 비비며 너에게 편지를 쓸게 반가운 사진 속 표정만큼 아름다운 나날들이기를 찬 바람이 불어와 어깨가 움츠러들 때에도 너를 떠올린다면 씩씩한 표정 할 수 있어 알고 있니 넌 나의 숫자 두근대는 맘은 아직까지 여기에 언제까지나 나의 하나뿐인 좋아한단 말은 나를 웃음 짓게 해 번호 나의 하나뿐인 때로는 지쳐 울어도 번호 당신과 있고 싶습니 다우 우내 번호 눈을 감으니 꼭 곁에 있는 같아 짠 하고 나타날 생각지 못한 날 우연히 문득 뒤돌아 봤을 꼭 내가 있을게 꼭 하고 껴안을게 가장 반가운 얼굴로 눈물이 왈칵 쏟아진다 해도 환하게 웃을 거야 오늘 너에게 서러운 일이 생긴다면 오래전 그날처럼 달려가 안아주고파아름답게 빛나길 알고 있니 넌 숫자 두근대는 맘은 아직까지 여기에 언제까지나 하나뿐인 좋아한단 말은 나를 웃음 짓게 해내 때로는 지쳐 울어도 당신과 사랑에 빠지고 싶어 눈을 감으니 곁에 있는 같아 기억해줘 넌 숫자 보고 싶은 사람 이만 줄일게 안녕,0,1,4,0,4
1,그댈 보면 얼굴이 빨개지고 그댈 보면 가슴이 두근두근 아이처럼 수줍게 말하고 그댈 보면 괜스레 웃음이 바보처럼 자꾸만 아마 내게 사랑이 온 건 가봐 그대는 마음속의 대통령 가슴의 별 수놓지 당신을 위한 지니입니다 숨을 멎게 하지 그대가 원하는 건다 너를 사랑하니까 사랑에 이유는 없잖아 알잖아 그대는 밤 하늘 별빛보다 아름다워요 맘속 깊은 곳에서 반짝거리는 나만의 사랑 빛 그대를 사랑해요 언제나 곁에서 빛을 내줘요 매일 범퍼라 보고 바라봐도 아름다워요 그댄 나의 사랑 빛 구름을 기분 유치해도 자꾸만 아마 내게 사랑이 온 건 가봐 그대는 밤 하늘 별빛보다 아름다워요 맘속 깊은 곳에서 반짝거리는 나만의 사랑 빛 그대를 사랑해요 언제나 곁에서 빛을 내줘요 매일 밤 바라보고 바라봐도 그댄 나의 사랑스러운 하늘 햇살보다 눈이 부셔요 맘속 어두운 곳까지 밝게 비추는 나만의 그대를 사랑해요 사랑스러운 두 눈을 감아봐도 그대 보여요 이렇게 바파보고 바라봐도 눈이 부셔요 그댄 나의,0,1,7,-1,6
2,솔직하게 말하면 달콤한 건 싫었어 네가 좋아한 뜨거운 커피 나른한 비도 있었지 네가 좋아서 이제 어느새 커피 향기에 고개 돌리네 네가 남긴 메시지 웃는 사진들 내게 알려준 날 위한 너의 비밀 레시피 남긴 것들이 나의 전부야 지금 너에게 할 말이 있어 아기 사랑 곁엔 온통 너뿐이야 사랑 빗소리마저 눈이 부셔 사랑 표정까지 너를 닮아가 잠드는 시간마저 아까워 목소릴 들려줘 간직할 수 있게 사랑니가 있는 세상이 이제야 너를 발견했으니 솔직하게 말하면 뜨거운 건 싫었어 사랑한다고 말하나 마나 다시 떠나고 넌 달랐어 다시 생각해봤어 지금 너에게 할 말이 있어 아기 안엔 온통 너뿐이야 지난 눈물조차 눈이 부셔 눈빛까지 너를 닮아가 모른 시간이 아까워 얘길 들려줘 알 수 있게 사랑니가 있는 세상이 이제야 발견했으니 내가 사랑하게 하겠습니다 안엔 온통 너뿐이야 지난 눈물조차 눈이 부셔 눈빛까지 닮아가 모른 시간이 아까워 얘길 들려줘 알 수 있게 사랑니가 있는 세상이 이제야 발견했으니,0,1,6,-2,4
3,내가 사랑에 빠질 그대와 함께한다면 사라질 꿈이라도 달콤하기만 하죠 지금 순간 순간을 믿어요 내가 당신과 사랑에 빠질 어제부터 확신했죠 매일 그린 그림이 당신이란 걸 내일은 꼭 얘기할래요 아무 이유도 없이 보고 싶었다는 걸 사실 많이 설레었어요 그대는 아마 언제인지 모르겠지만 앞으로도 많이 궁금해질 같아요 당장이라도 그대를 껴안고만 싶은데 내가 사랑에 빠지면 그대와 함께한다면 사라질 꿈이라도 달콤하기만 하죠 지금 순간 순간을 믿어요 당신과 빠질 사실 조금은 겁이 나요 영화에도 엔딩이 있을까요 그대 손을 꼭 잡아줘 걷는 길 덕분에 따뜻해요 좋은 일만 매일 있을 거예요 날 보며 웃는 그대 예쁜 모습처럼 앞으로는 아직 걱정 안 하기로 당장이라도 그대를 껴안고만 싶은데 빠지면 그대와 함께한다면 사라질 꿈이라도 달콤하기만 하죠 지금 순간 순간을 믿어요 당신과 늘 그대였죠부푼 기대로 잠 못 들게 했죠왠지 우린 느낌 부드럽게 오당장이라도 그대를 껴안고만 싶은데 빠지면,0,1,5,0,5
4,아주 멀리까지 보고 싶어 그곳에선 누구를 만날 수가 있을지 아주 높이까지 오르고 싶어 먼 곳을 바라볼 수 있을지 작은 물병 먼지 낀 카메라 묻은 지도 가방 안에 넣고서 언덕을 넘어 숲길을 헤치고 가벼운 발걸음 닿는 대로 끝없이 이어진 길을 천천히 걸어가네 멍하니 앉아서 쉬기도 하고 가끔 길을 잃어도 서두르지 않는 법언 젠가는 나도 알게 되겠지 길이 나에게 가르쳐 테니까 촉촉한 땅바닥 앞서 간 발자국 처음 보는 하늘 낯익은 길 언덕을 넘어 숲길을 헤치고 가벼운 발걸음 닿는 대로 끝없이 이어진 길을 천천히 걸어가네 새로운 풍경에 가슴이 뛰고 별것 아닌 일에도 호들갑을 떨면서 걸어가네 휘파람 불며 때로는 넘어져도 작은 물병 먼지 낀 카메라 묻은 지도 가방 안에 넣고서 언덕을 넘어 숲길을 헤치고 가벼운 발걸음 닿는 대로 끝없이 이어진 천천히 내가 자라고 정든 거리를 가끔 그리워하겠지만 이렇게 떠나네 넓은 세상으로,0,1,5,2,7
5,그녀의 셔 눈은 별을 날아가지 않는 것처럼 스타를 일으키지 만 그녀의 시도가 너무 아름다워서 그녀에게 너무나 아름답고 그녀에게 매일 그녀에게 말하는 것을 알고 있다는 나에게 묻습니다 내가 당신의 글 볼 당신이 당신이 온 세상을 미소를 지을 당신이 불모하고 끔찍한 소녀를 응시할 불길한 방식으로 놀랍게도 당신의 얼굴을 쳐다보면 리버시 입술을 할 수 있는 방식에 놀랍습니다 그녀가 웃음 웃음을 웃게 그녀가 싫어한다면 너무 섹시하다고 생각합니다 너무 아름답다고 생각합니다 내가 괜찮아 보인다면 귀찮게 하는 것도 내가 당신의 글 볼 전 세계를 미소를 짓고 멈추고 멍청하게 쳐다보면 불길을 알기 얼굴이 아는 것이 아니라는 것을 알고 있습니다 당신은 방식으로 방식으로 아는 방식에 놀랍습니다 소녀 당신은 방식대로 놀랍습니다,0,1,2,1,3
6,물어보는 늘 확인하고픈 같은 말해줘도 매일 말해줘도 계속 물어 입술이 말라 오네 식은땀이 흐르네 정답은 알지만 네가 듣고 싶은 말 듣고 싶은 말 나를 시험하는 말 이쁘다 이쁘다 이쁘다니까 믿지 않는 건데 말하고 말하고 아무리 말해도 화난 듯한 너의 표정 수가 없어진 불안해지는 매일 같은 퀴즈 반복되는 게임 항상 술래 머리를 새로 했나도 손톱이 바뀌었을까 감이 오질 않아니가 듣고 싶은 말이 힌트도 없는지 이쁘다 이쁘다니까 믿지 않는 건데 말하고 아무리 말해도 화난 듯한 너의 표정 이쁘단 하나론 널 표현 하긴 부족하잖아 아기 맘이라도 꺼내줘야 넌 믿겠니 널 사랑해 사랑해 사랑하는데 변했다고 하는 건데 화내고 삐지고 매일 토라져도 그것마저 사랑스러워 네가 백번 천 번 내게 물어도 정답은 늘 하난데 어제도 오늘도 내일 물어도 세상에서 네가 제일 이뻐,0,1,0,1,1
7,우연히 내게 오나 봐봄 향기가 보여 너도 오나 멀리서 향기가 설레는 코끝에 나의 입술에 괜찮은 느낌 떨림 나도 몰래 우연히 봄 어느새 겨울 지나 봄이야 앞에 선 돌이야 아직 이게 믿기지가 않지만 왼손은 지금까지도 너의 향기가 미묘하게 흘렀던 분위기에 아직까지 숨 쉬네 무대 위완 다르게 눈을 피해 고개를 돌렸던 모습에 한숨 쉬네 오랜만에 느껴지는 떨림이 날 단순하게 만들어 너만 아는 거리 지다 고쳤다고 생각했던 버벅임이 도져서 준비했던 말을 잊어버리지 주워 담지 못할 말은 절대 안 해원하는 걸 말해봐널 위해서만 할 빼곤 다 색칠할 수 있어 까맣게 천천히 갈게 가깝게 우연히 내게 오나 봐봄 보여 너도 멀리서 설레는 코끝에 나의 입술에 괜찮은 느낌 떨림 나도 몰래 봄 봄 아직까지 짙네 발걸음이 가벼워 집에 가는 길엔 가까워질 너와 나를 상상하는 모습이 오글거려 몸서리치 네어 머릿속이 하얘지기 하루 종일 날씨 얘기만 반복하게 돼 것들에겐 무감각하게 돼 정적이 만드는 긴장감은 설레어나를 미소 짓게 만들어 모른 척하려 했더니 옆의 남자들은 흐릿했던 눈앞에 불을 키게 만들어 겨울은 유난히도 추웠고 다시 돌아온 그토록 기다렸던 움직이지 못하도록 잡고 있고 싶어날 느낄 수 있게 안고 있고 싶어 내게 봐봄 보여 너도 멀리서 설레는 코끝에 나의 입술에 괜찮은 느낌 떨림 나도 몰래 너를 사랑해서 사랑해 너무 쉬운 걸 참고 있을게 여자이니까 하루 기다려 바보야 말해봐 티 마음도 보여갖고 싶다고 해봐 이상은 감추지 마 어느새 앞에 앞에,0,1,-2,0,-2
8,혼자서 널 기다릴 때면 행성에 있는 듯해 여기서 네가 있는 곳까지 오래 걸릴지 궁금해 상상이 안돼내게 빨리 와줘 그대가 없는 이곳은 내게는 너무 캄캄해 여기서 두 벌려 그대를 안아줄 준비가 돼있어 너와 사이의 우주를 건너 내게로 나에게 오시고 싶습니까 너와 사이의 우주를 건너 내게로 날아와 줘 기다리게 하지 마나 지금 당신을 기다리고 있습니다 지금 당신이 필요합니다 지금 당신을 기다리고 있습니다 당신이 필요 해저 멀리 널 보고 있으면 너와 생각을 하는 듯해 여기서 언제까지나 기다리고 있어야 하는지 궁금해 답답하기만 해내게 빨리 와줘 그대가 없는 이곳은 내게는 너무 막막해 꼭 잡은 손 그대를 놓치지 않을 준비가 돼있어 사이의 우주를 건너 내게로 나에게 오시고 싶습니까 날아와 줘 기다리게 하지 마나 당신을 있습니다 당신이 필요합니다 필요해 멀리 있는 것만 같아도 손 내밀면 잡힐 듯한 그대 그림자 그댈 꼭 안고 마음 느낄 수 있도록 놓지 않으려나 나에게 오시고 싶습니까 거리 우주 가득히 너로 채울게 다가와 필요합니다 필요해 바비가 필요해,0,1,-1,2,1
9,사랑 노래가 너무 많아서 노래로 고백을 할까 처음 본 순간 당신과의 사랑이 떨어집니다 미칠 같은데 널 사랑하는 데니까 있어 좋다 사랑해서 좋다 말로 설명할 수 없는 기분 너무나도 좋다 너와 함께하는 순간 영원히 간직할 기분 멋진 말들로 꾸며댈수록 나의 마음을 가릴 같아빼고 빼고 줄여갈수록 보석과도 남아있는 사랑해서 말로 설명할 수 없는 기분 너무나도 너와 함께하는 순간 영원히 간직할 왠지 서툴러 보이는 작은 두 글자로 나의 마음을 전할 게니까 있어 사랑해서 말로 설명할 수 없는 너무나도 너와 함께하는 영원히 간직할,0,1,8,-4,4
10,그대여 그대여 그대여 오늘은 걸어요 거리를 밤에 들려오는 자장노래 어떤가요 오예 몰랐던 그대와 단둘이 손잡고 알 수 없는 떨림과 둘이 걸어요 봄바람 휘날리며 흩날리는 벚꽃 잎이 울려 퍼질 거리를 둘이 걸어요 봄바람 휘날리며 흩날리는 벚꽃 잎이 울려 퍼질 거리를 둘이 오예 이제 손잡아요 거리에 마침 들려오는 사랑 노래 어떤가요 오예 사랑하는 그대와 단둘이 손잡고 알 수 없는 봄바람 휘날리며 흩날리는 벚꽃 잎이 울려 퍼질 바람 불면 울렁이는 기분 탓에 나도 모르게 바람 불면 저편에서 모습이 겹쳐 울렁이는 기분 탓에 나도 모르게 바람 불면 저편에서 모습이 겹쳐 사랑하는 연인들이 많군요 알 수 없는 친구들이 많아요 많군요 좋아요,0,1,2,3,5
11,아름다운 밤입니다 우리가 쓰레기를 버는 현금을 얻었습니다를 찾는 무언가를 찾고 있습니다 내가 당신과 결혼하고 싶다고 생각합니다 당신의 눈에 모습이 당신의 눈에 보이는 것은 춤추는 주스가 걱정하는 것입니다 깨어나 넌 냉담한 사람이 아니에요 너를 비난하지 않겠어 당신은 내가 준비된 것처럼 준비가 된다 무언가를 찾고 있습니다 내가 당신과 결혼하고 싶다고 생각하기 위해 당신의 눈에 보이는 모습은 보인다 그것은 아름다운 밤입니다,0,1,-2,2,0
12,오늘은 고백할까 말을 걸까 당신이 나와 오는 것을 좋아합니다 멋지게 차려 입고 꽃다발 손에 들고 다가간다 너에게 오늘은 고백할까 언제쯤 말을 걸까 당신이 나와 오는 것을 좋아합니다 모른 체 기뻐하고 예쁘게 웃어야지 다가온다 나에게 사랑 살며시 다가와서 사랑고백해 널 좋아해 사랑 수줍은 내가 사랑하는다 언제나 둘이 손을 잡고 걸어가기 츄팝츄팝 바쁠 때도 통화는 꼭 하기 츄팝츄팝 혹시나 싸웠대도 웃으면서 화해하기 츄팝츄팝 상큼한 미소 한 번 달콤한 포옹 한 번 당신이 나와 오는 것을 좋아합니다 행복한 순간을 바랬는지 너는 알고 있을까 사랑 조금씩 다가가서 사랑고백해 널 사랑해 약속해 내가 사랑하는다 언제나 둘이 손을 잡고 걸어가기 바쁠 때도 통화는 꼭 하기 혹시나 싸웠대도 웃으면서 화해하기 꿈꾸던 너를 만나 행복해난 바랄 없어 추노에게만 사랑을 줄래 응아프고 힘들 때도 둘이라면 이겨 낼 수 있어츄팝츄팝 웨이는 사랑합니다 이제 거야에 대한 나의 유일한,0,1,13,0,13
13,초록빛 바람 불어오는 날 마른 비 지나 그녀를 닮은 나라 꽃길을 둘이 걷는다 가슴은 두근두근 약속한 듯이 발을 맞춘다 숨소리마저 입을 맞춘 다부 더러운 손길 팔을 감는다 살며시 기대온다 새까만 찰랑 찰랑 찰랑 그녀의 머릿결 살랑살랑 살랑 노래를 부르면 꽃바람 휘파람 너울너울 무지개 따뜻한 숨결 뺨을 스친다 짜릿한 상상 입술이 탄다 햇살이 반짝 아른거리다 노을빛 물이 든다 새까만 그녀의 머릿결 살랑살랑 살랑 노래를 부르면 꽃바람 휘파람 너울너울 무지개 바람이 널 타고 불어와 햇살이 아플 만큼 따가운 날이라도 괜찮아 무엇을 할지 어디를 갈지 목적지 없이 걷는 것도 좋아해가 저물어 올 때쯤 바래다주는 길은 이렇게도 짧은 건지 하늘은 어두운데 주변만 밝지 아직 밤공기는 찬데 두 볼이 뜨겁지 가만히 그녀 입술 위에 입을 맞춘다 산뜻 산뜻산뜻 그녀의 모든 하나하나 아름다운 걸 첫사랑 안녕 옛사랑 너는 나의 무지 개꽃 바람 닮아 휘파람 닮아아름다운 무지개,0,1,1,7,8
14,시간을 듣고 기능을 확인하고 있습니다 입술 엉덩이를 보고 당신의 슈퍼맨이 되고 싶어 당신의 슈퍼맨이 되지 않습니다 퐁당퐁당 너를 처음 보고 두근두근 빠져 버렸지 달콤달콤 너의 눈을 보고 어쩔 줄을 몰라 버렸지 웃기지도 않게 불쑥 내게 온 날 잡아 볼까 어떡해 어쩜 모습이 내가 우스워널 닮는 모습이 점점 우스워 스르륵 네가 기다려다가와 줘야 도로로 네가 달콤해 사랑 내겐 너무나 사탕 같은 어쩔 수 없는 걸눈과 코와 입술 맛 너를 처음 만난 건 네게 행운이었어 지 겨지겨운 세상 너의 손길 필요해 오사 탕 같은 널 항상 안아주고 싶어나 말이야 네가 필요하단 말다 문득문득 너의 입술 조심조심 키스 살랑살랑 손길 어쩔 줄을 몰라 버렸어 바라지도 않던 내게 찾아온 널 사랑할까 이제 어쩜 모습도 내게 묻어나날 닮은 모습 사랑해도 괜찮지나 사르륵 날 감쌀 짜릿해져 도로로 내가 널 안길 안길 날 안아버릴 때란 너에게 안길 시간이 영원히 멈추지 않기를 스르륵 네가기다려다가와 줘야 도로로 달콤해 사랑 내겐 너무나 사탕 같은 수 없는 건 손과 귀와 맛나 사르륵 감쌀 짜릿해져 내가 안아버릴 때란 너에게 그렇게 너에게 집으로 뽀로로 달려가서 안아줄 거야 사랑할 거야 그렇게 사랑하는 거 나의 맘이 이제 나에게 솔직히 이제는 나에게 가까이 몸이 두근두근 벌렁벌렁 어서 어서 와서 베이비 베이비 베이비,0,1,1,1,2
15,처음 너를 만나던 그날 설레던 월의 아침 아카시아 달콤한 향기 부드러운 바람 우릴 감싸주고 걸어왔던 시간들 그림 같은 예쁜 날 여우비 내리던 여름 하늘을 구르던 너의 웃음처럼 너는 나의 사랑 너는 나의 요정 온 세상 눈부신 향기를 뿌리고 너는 나의 노래 햇살 넌 비타민 날 깨어나게 해함께 걸어왔던 시간들 그림 같은 고운 날들 눈 내리던 겨울밤우리가 남겨놓은 발자국처럼 사랑 요정 온 세상 눈부신 향기를 뿌리고 노래 햇살 넌 비타민 날 깨어나게 해예쁜 영화 불꽃놀이와 플 아이스크림 롤러코스터 화이트 크리스마스 여름바다 당신의 미소 사랑 요정 온 세상 눈부신 향기를 뿌리고 노래 햇살 넌 비타민 깨어나게 해너는 해,0,1,7,7,14
16,우하하 우하하 케로로 중사 사랑을 내게 주세요 음 내가 어때서 이러시나 눈이 작다고 놀리지는 말아줘요 이렇게 귀엽게 웃을 수가 있어요 이렇게 엉덩이를 흔들고 춤추죠 으에으에으샤 우샤 우샤 우샤 나를 봐요 나를 봐줘요 내가 말하 다우 날 사랑해줘요 크게 우하하 나를 안아줘요 얼굴도 크고 바보 같지만 나만을 사랑해줘 봐요 내가 말하 다우 날 사랑해줘요 크게 우하 하나를 안아줘요 밝은 빛으로 감싸줄게요 사랑을 내게로 주세요 앞에 와서 웃어봐요 즐겁게 나와 춤을 춰요 우울할 때나 지겨울 때나 보면서 웃어봐요 앞에 와서 웃어봐요 즐겁게 나와 춤을 춰요 우울할 때나 지겨울 보면서 웃어요 사랑해라고 말해요 음 하나만이 가득 사랑을 주세요 눈이 작아도 귀엽다고 말해줘요 아주 큰 행복 안겨줄게요 이렇게 엉덩이를 흔들고 춤추죠 으에으에으샤 봐요 봐줘요 말하 다우 날 사랑해줘요 크게 안아줘요 얼굴도 크고 바보 같지만 나만을 사랑해줘 우하 하나를 밝은 빛으로 감싸줄게요 내게로 우하 하나를 밝은 빛으로 감싸줄게요 내게로 주세요우하하,0,1,5,-5,0
17,네가 날 싫어해 하는 걸 알아내는 서운해 그런 날 너는 못 이해해 당신은 이해하지 못합니다 너를 좋아한다고 내가 뭘 잘못했는데 내게 그러는데 그럴수록 되게 섭섭해 너무 슬프다 슬슬 내가 당신의 안에 들어오겠습니다 마음 중요한 건 마음 결코 얼굴만 보고 좋아하는 거 아니야 날 미워하는 너의 날이 선 말투까지도 사랑하게 된 거 이게 맘이야 너에 대한 건 사소한 것도 기억해 마니아 아무리 나삐 굴어도 넌 내게 순간 만화야 순정만화야 주인공은 맨날 맨날 이렇게 밤마다 기도해 사랑을 주다 사랑을 주세요 사랑이 모자라요 매일매일 자라는 사랑을 그녀에게 주는데도 받질 않으니 주다 주세요 주다 사랑이 모자라요 매일매일 자라는 그녀에게 주는데도 받질 않으니 주면서 사랑의 주십시오 잘못한 것도 없는데 무작정 싫어하고 보는 너나를 이해할 수 없는 유난 너를 좋아한다고 네가 싫어해 하는 걸 안 후부터 샘솟던 의욕이 다 시들고 설레던 맘도 끝이게구나 했는데 또다시 슬금슬금 다가가도 될까 바라보는 것조차 싫어할까 봐난 몰래 뒤에서 긍긍 전전해 점점 해가 지면 달빛 정전에 용기가 맘을 전해하지만 그녀와 사이 거리 너무 멀어주고 주는 사랑이 길바닥에다 버려져 낙엽처럼 쌓이네 봄이 되면 흙으로 남아 기대해 싹이 될까 주세요 모자라요 매일매일 자라는 그녀에게 주는데도 받질 않으니 사랑스럽게 사랑받는 사랑의 사랑과 사랑의 주십시오,0,1,5,0,5
18,그럴 수 있겠지 괜찮아 수 있어 너무 괜찮아 다시 혼자라니 믿어지니 새로 시작해 기대하지 않던 무엇이 이루어진 대 늘 똑같을 순 없어 계속 노력하십시오 계속 꿈을 꾸세요 조금씩 달콤해질 같아 그녀에게 키스할 수 있습니까 우리는 진짜 모르고 지냈어 너무 보였다 아픈걸 그것은 옳지 않아 다시 시작할 없는 거야 슬픈 얘기들 기대하지 않아 무엇도 설레지 않아 그녀의 이름을 속삭여 보네 계속 성장하고 있습니다 가장 이상한 느낌 조금씩 달콤해질 같아 당신을 데리고 싶어요 당신은 내가 지금 노래하는 이유입니다 당신이 나를 너무 웃게 만들기 기분이 좋아요 가까이 오세요 그녀의 이름을 속삭여 보네 성장하고 있습니다 가장 이상한 느낌 조금씩 달콤해질 같아 당신을 데리고 싶어요 당신은 내가 지금 노래하는 이유입니다 당신이 나를 웃게 만들기 기분이 좋아요 가까이 와서 당신이 나를 잘 만들기 당신의 마음을 느끼게 해주세요 당신은 사랑이 아니에요,0,1,3,12,15
19,가식적인 체면 다 다 버리고 사랑이 주는 많은 기쁨만을 노래해 미쳐있던 나의 사랑만큼 뛰면서 소리쳐 내가 버텨가야 하는 인생 속에 미쳐 갇혀 힘들다 하여도 그대와 나의 작은 사랑으로 가슴에 새기고 기쁘게 모든 걸 이겨가 어렵다고 생각 말아요 나도 그댈 바라보고 있는 걸 작은 고집 나의 마음을 감춰 둔 거죠 오지 치지 마요 힘을 내어요 오면 나를 느낄 수 있죠 날 안아줘요 깊은 맘으로 가슴 가득히 나를 사랑해 주세요 어디선가 들려오는 사랑 노래에 나와 기쁨에 파도에 몸을 실어봐 어차피 만들어 나가는 가치 너와 둘이서 하나가 되는 이치 모든 걸 맘 안아 뭘 하던 뭐든 건에 인생에 끝에 우리가 만났던 끝에 나를 담고 모든 다 맡기고 기쁨에 너와의 사랑에 차근차근 말해보세요 사랑하고 있다고 한 번만 말해줄래요 달콤함에 어지럽겠죠 오지 치지 마요 힘을 내어요 오면 느낄 수 있죠 날 안아줘요 깊은 맘으로 가슴 가득히 사랑해 주세요 너무도 힘이 때면 두 눈 꼭 감고 달려와요 내게도 그댄 전부죠 날 사랑해줘요 오지 치지 마요 힘을 내어요 오면 느낄 수 있죠 안아줘요 깊은 맘으로 가슴 가득히 사랑해 주세요,0,1,3,-2,1
20,늘 바라만 보네요 하루가 지나가고 하루가 지나도 그대 숨소리 그대 웃음소리 아직도 나를 흔들죠또 눈물이 흐르죠아픈 맘 모른 채 그댄 웃고 있네요 바보 같은 철없는 못난 나를 한 번쯤 그대 돌아봐 수 없는지 알고 있죠 바램들을 그대에겐 아무런 의미 없단 건 나였으면 사랑하는 사람 나였으면 수없이 많은 날을 기도해왔죠푸르른 나무처럼 말없이 빛난 별처럼 바라만 보고 있는 나를 그댄 알고 있나요 늘 오늘까지만 연습해왔던 사랑의 고백들도 슬픈 뒷모습 오늘까지만 맘을 모른 채 살아갈 테죠기다림이 잊힘보다 쉽다는 걸 슬프게 잘 알고 있죠 나였으면 사랑하는 사람 수없이 많은 날을 기도해왔죠푸르른 나무처럼 말없이 빛난 별처럼 바라만 보고 있는 그댄 있나요 묻고 싶죠 잘 지내는 가요 함께하는 사람이 그대에게 잘해주나요 바보 같은 걱정도 부질없단 걸 알지만 눈물 없이 꼭 한 번은 말하고 싶었죠 사랑한다고,0,1,-1,-5,-6
21,따스한 햇살 가득 가슴에 안고서 가벼운 기분으로 바람을 가르며 그대란 가슴 벅찬 기쁨과 단둘이 날아가 버리다 하늘 가득 흘러가는 구름에 이름을 새기며 그댈 바라봐요 참을 수 없죠 수줍은 그대의 뺨에 키스를 날아가서 당신의 눈으로 날아갈 것입니다 우릴 바라보는 햇살 속을 달려요 이렇게 좋은데 당신의 마음에 날아라 사랑이란 그런 말조차도 모자라 어디서나 한 움큼 가득 쥔 바람을 그대에게 햇살은 더욱 우릴 아름답게 하고 이렇게 일상의 고민들을 버리고 날아가 버리다 맘 가슴 벅찬 이름 하나를 새기고 그댈 바라봐요 참을 수 없죠 수줍은 그대의 뺨에 키스를 날아가서 당신의 눈으로 날아갈 것입니다 우릴 바라보는 햇살 속을 달려요 이렇게 좋은데 마음에 날아라 사랑이란 그런 말조차도 모자라나는 눈으로 날아갈 때마다 어디에서나 바라보는 속을 달려요 좋은데 사랑이란 그런 말조차도 모자라나는 때마다 어디에서나 마음에 날아라 모자라나는 때마다 어디에서나,0,1,6,-2,4
22,아름다운 너의 목소리는 내가 원하는 모든 것을 허락했지 흔들리는 많은 사람 속에서 넌 나만을 위한 춤 붉은 칵테일 빛에 담긴 밤 너와 단둘이 떠나고 싶어온 아름다운 너의 목소리는 내가 원하는 모든 것을 허락했지 지금 우리는 춤을 추고 있어 비밀스러운 몸짓과 노래로 검게 타버린 같은 심장이 터질 너를 비추고 붉게 물든 나의 입술 뜻밖의 아찔했던 입맞춤이 아름다운 너의 목소리는 내가 원하는 모든 것을 허락했지 지금 우리는 춤을 추고 있어 비밀스러운 몸짓과 노래로 아무 말 할 수 없어 넌 지금 앞에 있는데 밤이 다 지나가면 넌 사라질 같아오 우리는 춤을 추고 있어 비밀스러운 몸짓과 노래로 곁에서 있어하얀 달빛과 마음에 들어왔어 목소리에 녹아내리는 순간에 멈추고 싶어온 곁에서 있어하얀 달빛과 마음에 들어왔어 목소리에 녹아내리는 순간에 멈추고 싶어온,0,1,5,2,7
23,너의 한 마디 말도 웃음도 나에겐 커다란 의미 너의 작은 눈빛도 쓸쓸한 뒷모습도 나에겐 힘겨운 약속 너의 모든 것은 내게로 풀리지 않는 수수께끼가 되네 슬픔은 간이역의 코스모스로 피고 스쳐 불어온 넌 향긋한 바람나 이제 뭉게구름 위에 성을 짓고 널 향해 창을 내리 바람 드는 창을 한 마디 말도 웃음도 나에겐 커다란 의미 작은 눈빛도 쓸쓸한 뒷모습도 힘겨운 약속 모든 것은 내게로 풀리지 않는 수수께끼가 되네 슬픔은 간이역의 코스모스로 피고 스쳐 불어온 넌 향긋한 바람나 이제 뭉게구름 위에 성을 짓고 널 향해 창을 내리 바람 드는 슬픔은 간이역의 코스모스로 피고 스쳐 불어온 넌 향긋한 바람나 이제 뭉게구름 위에 성을 짓고 널 향해 내리 바람 드는 한 마디 말도 웃음도 커다란 의미 작은 눈빛도 쓸쓸한 뒷모습도 힘겨운 약속,0,1,-2,2,0
24,부드럽게 무드 있게 따뜻하게 꼭 안아주시오 매일 한 번씩 사용하시오부드러운 눈 마주칠 땐 미소 지어서 그녀를 웃게 뭐 야말을 거시오 그날 아침엔 먼저 일어나서 재즈 젠틀 키스 켜기 널 바라봐 너무 지칠 땐 소주 두 병 들고 솔직하게 그녀의 집 두드리시오 가끔 한 번씩 무작정 떠나가시오 하늘 바람 숨 쉬게 해줘 가끔 한 번씩 무작정 키스해 주시 오이 유 없이 너에게 빠진 그날처럼 잘 때는 나긋하게 조용하게 눈물 말해주시오 매일 너무 고마워 그날 아침엔 먼저 일어나서를 청소하십시오 썸 널 깨우고 바래다줄 땐 발걸음 천천히 나직하게 그녀에게 고백하시오 여자 앞에선 이성적이지만 이상하게 앞에선 감정이 앞서널 사용하기엔 너무나 아까워 마냥 바라보기엔 넌 날 미치게 해 영원히 널 사용하고 싶어온 마이 딸 마이 여자 부드럽게 무드 있게 따뜻하게 꼭 안아주시오 매일 사용하시오 잘 때는 나긋하게 조용하게 눈물 말해주시오 너무 고마워 아름다운 소녀 놓치지 마시오,0,1,6,1,7
25,팝콘이 춤춘대 팝 팝 튀어 오른다 처음 그녀와 영화를 보러 온 맘도 춤춘다란 소심한 남자 넌 무얼 좋아할까 고민 끝에 고른 메뉴 캐러멜 팝콘 영화를 볼까요 로맨스 가득한 영화는 두근두근 팝팝팝 하늘로 하얗게 날아올라 하늘 높이 팝팝팝 맘도 부풀어 올라달콤한 느낌이 좋아따뜻한 느낌이 좋알 팝 소심한 남자 넌 표정일까 눈에는 영화 대신 가득한 너의 옆모습 영화를 본대도 로맨스가 펼쳐질 같아 두근두근 팝팝팝 하늘로 하얗게 날아올라 하늘 높이 맘도 부풀어 올라달콤한 느낌이 좋아따뜻한 팝팝팝우연히 팝콘에 손을 뻗은 순간 따스한 온기가 느껴져 서로 잡았던 두 손을 놓지 않았죠 심장이 터질 같아 눈물을 쏟을 같아 당신과 영원회 하늘로 하얗게 날아올라 하늘 높이 부풀어 올라달콤한 좋아따뜻한 좋아팝팝팝팝팝팝 날아올라고,0,1,2,4,6
26,어쩌면 너를 만나고 사랑한 건 운명 같은 일이었지 신기하지 해를 만난 새벽처럼 긴 겨울 끝의 봄날처럼 너에게 이끌려 꼭 영화 속의 주인공처럼 의존할 수 너의 눈을 보면 알 같아 너라면 기댈 수 있어 다시 꿈을 꿔 깊은 밤 당신이 빛을 비치면 어쩌다 걷다가 힘이 날 일으켜주던 한 사람 나에게 빛을 비추는 사람도 눈이 붉게 물들 나를 안아준 너에게 있잖아 내가 달라지는 것만 같아 마음을 알 수 있어 세상이 변해가 오늘 밤 당신이 빛을 비치면 가끔 서운하다 해도 괜찮을 거야 내겐 무엇도 필요 없어 당신이 당신의 비추면 아기 알잖아 운명 같은 사랑 더디게 흘러가도 기억해 기적처럼 이뤄질 거야 별처럼 하늘에 별들처럼 너를 영원히 비춰줄 거야 세상이 변해가 오늘 밤 비치면 너의 눈을 보면 알 같아 너라면 기댈 있어 다시 꿈을 꿔 깊은 비추면,0,1,-1,1,0
27,넌 밝은 빛이 있어 우리는 은하수를 걷고 있어 너와 발을 맞춰 걷기 시작한 그날 후로 매일 괜히 어깨가 으쓱해지고 뭘 해도 있게 돼 머리에 들어와 나를 간지럽히고 있니 입꼬리가 올라가 내려오질 않잖아 여자 당신은 나의 밝은 빛입니다 빛나도 너를 빛나게 할래 오늘 밤 당신의 밝은 빛입니다 넌 빛나기만 해줘 소녀는 질문 답변이 없습니다 서로에게 정답이야 우리들의 관계를 의심하지 만난 앞에선 절대 돌아서지 않아새까만 밤하늘의 별을 모아 모아 너를 눈부시게 할래 베이비 당신은 나의 나의 당신은 것입니다레 눈 속에 비친 얼굴 속엔 반짝이는 미소뿐 세상에 빛나는 무엇보다 너야 너야 매력은 끝도 없이 몰아쳐 러블리한 허리케인 쉽게 널 벗어날 수가 없어 빠져들게 돼넌 가슴에 들어와 온도를 높이고 있어 심장이 요동쳐 진정을 못 하잖아 여자 스타 라이트입니다 세상을 다 푸른빛으로 오늘 밤 걸어,0,1,5,7,12
28,나른한 햇살에 눈을 떠 보면 이제 어디로 가야 할지 모르겠어 변함없는 하루 그대로인 그냥 이렇게 살아가도 되는 걸까 내가 할 수 있기 가라 곁에 언제나 네가 있어준다면 내가 할 수 있기 가라 괜찮을 거야 이제 내게 다가와 처음엔 그냥 왠지 불안하고 알면서 속아주고 이게 연륜이지 오늘은 여기까지 정도면 되고 이게 적당하고 상대만 바뀔 뿐 건조하고 근데 언젠가부터 가슴이 흠 뭣이 신경이 쓰이더니 두근두근하더니 가슴이 막 터질듯한 설렘에 내가 할 수 있기 가라 난생처음 사랑하는 사람처럼 소풍 전날 밤새 잠 못 드는 아이처럼 항상 자식 걱정하는 엄마처럼 텅 빈 집에 홀로 남은 강아지처럼 눈을 감지 말아요 그대로가 좋아요 이제 그만 연인이 되라 연인이 되라지 금 네가 누구든 어디서 뭘 하든 괜찮아요 사랑이 되어주세요 가슴이 막 터질듯한 설렘에 안되고든 안 되겠거든 안 되거든 안 되겠거든 없이는 안되거든 없이는 되거든 없이는 안되겠거든 창밖의 사람들 나완 상관없이 다들 어디론가 바쁘게만 흘러가고 가끔 의미 없이 떠나려 해도 곁에 있을 네가 싫어서 곁에 언제나 있어준다면 괜찮을 거야 내게 다가와 처음 사랑하는 사람처럼 잠 못 드는 아이처럼 엄마처럼 강아지처럼 처음 사랑하는 사람처럼 잠 못 드는 아이처럼 엄마처럼 강아지처럼,0,1,-1,3,2
29,느닷없이 갑자기 말해볼까 덜컥 사랑에 빠졌다고 세상 모든 기쁨 나와 할 사람 그게 너라면 좋겠다고 이상해 내가 너만 보면 가슴이 떨려스쳐 지날 샴푸 향기에 귓가에 종소리가 들려 아직도 한 번 제대로 한번 맘 털어놓지 못했지만 요즘 부쩍 자주 마주쳐 왠지 좋은 일이 생길 느낌 느닷없이 갑자기 말해볼까 덜컥 사랑에 빠졌다고 세상 모든 기쁨 나와 할 사람 그게 너라면 좋겠다고 눈치 못 채 벌써 며칠째 뒷자리에 앉은 나를 너에 뒤에 들키지 않게 사랑한다 속삭인 나를 실순척 한번 모른 척 한번 손잡아 보고 싶은 거야 나의 손에 너의 향기가 깊이 새겨질 수 있게 느닷없이 갑자기 말해볼까 덜컥 사랑에 빠졌다고 세상 모든 기쁨 나와 할 사람 그게 너라면 좋겠다고 널 바라보는 내가 서있잖아가까운 곳에서 이렇게 서있잖아들려줄게 있어 보여줄게 있어 한 걸음 한 걸음씩 다가갈게 사랑해 사랑해라고 속삮일께세상에서 가장 아름다운 프러포즈 네게 선물할게 다가와 가까이 입술을 대신해 가슴이 하는 말 들을 수 있게 사랑해 사랑해 말도 안 될 만큼 너무 옆에 너만 있으면 돼 왠지 어설퍼 보이는 나이지만 힘껏 널 안아주고 싶어 달아나버리는 용기지만 네가 사랑이 되어줄래 것이 달라질 하루하루 너와 단둘이 하고 싶어내 손목을 꼭 잡은 하나만 가장 소중히 아낄 거야,0,1,11,1,12
30,마와레마 와레메리고라모오케시테 토마라나이요니우고키다시타메로디 도샤부리노 고고오맛떼마치니토비다소오코코로니후루아메니카사오쿠레타키미또맛삐라토요코무이테혼네와우라하라데모 소노마마데이이오타가이사마다카라메구리아에타키세키가당신은 나를 새롭게 느끼게합니다나미다노이로오카에타그리고 새로운 브랜드를 사랑하고 싶다이키가토마루쿠라이노아마이쿠치즈케오시요우요히토코토모이라나이사토비키리노이마오유우키오쿠레타키미니테레테루바아이쟈나이카라코토바요 리모혼키나 시라누마니오토시테타치이사나카케라오스키마나쿠다키요세하다데타시카메아우오츄노미에나이요루당신은 나의 빛나는 별입니다카마와나이 키미가미에루그리고 당신의 빛나는 스타가되고 싶습니다마와레마와레 메리고라운모오 케시테토마라나이요니우고키다시타메로디 토메도나쿠타노시쿠테야루세나이호도 세츠나쿠테손나아사니우마레루보쿠나리노 사랑 노래타메이키노마에니코코니오이데요나는 당신을 보호하고 싶습니다코코노하카나사오요와사오키미노료쿠오 별노호시쿠주니낫떼모나는 모든 것을 반대 할 수 있습니다스베테오우루오스당신의 달콤한 영혼코노우타니타쿠시 마모로오모든 연인들에게우마레타테노 사랑 송마 요콘나니모치카이키미오우시나우난떼소우생각할 수 없습니다쿠리카에스마이니치노카이소우요리이마노타이온 이키가토마루쿠라이노아마이쿠치즈케오시요우요히토코토모이라나이사토비키리노이마오유우키오쿠레타키미니테레테루바아이쟈나이카라코토바요 리모혼키나,0,1,7,2,9
31,당신이 자신을 바다 한가운데에 갇혀 있다면 당신이 어둠 속에서 잃어버린 것을 발견하고 당신은 우리가 우리가 만든 것을 당신을 안내할 빛이 될 것입니다 가난한 사람들의 친구들을 도와달라고 부름을 받았습니다 셋째 거기에 있을 것이고 내가 필요할 당신을 네처럼 믿을 수 있습니다 두 사람과 당신은 거기에 있을 것입니다 그것이 친구들이 해야 할 일이기 때문입니다 당신이 던지고 당신은 돌릴 수 없고 잠들지 않을 것입니다 옆에 노래를 부를 정말로 정말로 의미하는지 잊어버린 경우 우리가 친구들을 돕기 위해 부름을 받는 것을 상기시켜 나를 하나처럼 믿을 수 있습니다 셋째 거기에 있을 것이고 내가 필요할 당신을 네처럼 믿을 있습니다 두 사람과 그것이 친구들이 해야 할 일이기 때문입니다 울 항상 어깨가 거야 절대 놓지 않을 거야 작별 인사를 하지 마십시오 셋째 것이고 내가 필요할 네처럼 두 사람과 그것이 친구들이 해야 할 일이기 때문입니다 오는 나를 있어 있기,0,1,1,10,11
32,그녀가 그녀의 옷을 느끼는 방식을 좋아한다 사랑스러운 그녀는 예쁘다 그녀는 남자 친구를 얻었습니다 여자가 더럽게 나이가 나이가 아니에요 모르겠어요 우리가 그것을 통해 그것을 만들었는지 모르겠어 모른다 내가 모른다 그녀가 그녀의 입술을 물은 방식을 좋아한다 너무 사랑스럽습니다 그녀가 그랬을 그녀 가이에 맞았기를 원한다 살 젊어 나와서 나만을 보자 그녀는 나를 가르쳐 속임수를 가지고 있다고 말했다 모르겠어요 모르겠어요 우리가 그것을 만들었는지 모르겠다 우리가 만들었는지 모르겠다 모르겠다 당신이 사랑스럽다고 생각합니다 당신이 사랑스럽다고 생각합니다 당신이 사랑스럽다고 생각합니다 아름답다고 사랑스러운 너무 사랑스럽다 내가 모른다,0,1,2,1,3
33,두 사람은 가자 눈독 들지 마요 나만 바라봐 주세요 손 한번 잡을게요 제발 돈 나를 두려워합니다 아찔한 느낌 한자리 비워 주세요 이리 봐도 섹시한 저리 봐도 섹시한 살살 녹아 녹아 우짜면 좋노 어떡해야 하니 두 눈 뜨고 봅시다 울적한 날엔 나에게 키스해줘요 달콤해 달콤해 입맞춤 가슴 떨려 행복한 날처럼 너에게 뽀뽀해줄게 뽀뽀 달콤해 솜사탕 너야 남의 눈치 신경 마요 밥 한 끼 사줘요 가슴에 안아줘요 엄마 엄마 여기서 그만 아직은 서둘지 마요 이리 봐도 깜찍 저리 깜찍 살살 녹아 우짜면 좋노 어떡해야 하니 커플 완벽해요 울적한 날엔 나에게 키스해줘요 입맞춤 가슴 떨려 행복한 날처럼 너에게 뽀뽀해줄게 솜사탕 당신과 시원한 내게 약속 하나만 할게요 나만을 아껴 그런 사람이 되어줘요 그것을 할 수 행복한 날처럼 너에게 뽀뽀해줄게 자기야 자기야 노래를 사랑합니다 날,0,1,0,3,3
34,힘을 내라고 말해줄래 눈을 반짝여 날 일으켜줄래 사람들은 원하지 빨리 많이 평범한 소녀인 걸 바람은 자유로운데 모르겠어 다들 어디론지 힘을 왔잖아 이것쯤은 별거 아냐 세상을 뒤집자 하도 무지 알 수 없는 것뿐인 복잡한 지구가 재밌는 이유는 하나네 당신입니다 사랑한다고 말해줄래지친 널 감싸고 웃어줄래 사람들은 원하지 빨리 많이 평범한 소녀인 걸 하늘은 저리도 파란데 모르겠어 다들 어디로 가하지만 힘을 왔잖아 이것쯤은 별거 아냐 세상을 뒤집자 하도 무지 알 수 없는 것뿐인 복잡한 지구가 재밌는 이유는 너나는 당신이 당신이 있는 방식으로 당신을 좋아합니다 네가 나타난 뒤 모던 달라졌어 이제부터 다시 시작해 좋았어 왔잖아 이것쯤은 별거 아냐 세상은 뒤집혔어 도무지 알 수 없는 것뿐인 복잡한 지구가 재밌는 이유는 당신의 사랑에 대해 예입니다 도무지 재미는,0,1,5,-8,-3
35,몇십 서로 달리 살아온 달라도 한참 달라 너무 피곤해 영화도 멜로 너는 행동 피자 너는 순두부 우린 통한 있어 김밥 김밥을 좋아하잖아 언제나 김과 밥은 붙어산다고 너무나 부러워했지 잘 말아줘 잘 눌러줘 밥알이 김에 달라붙는 것처럼 너에게 붙어 있을래 날 안아줘 날 안아줘 옆구리 터져 버린 김밥처럼 가슴 터질 때까지 예전에 김밥 속에 단무지 요새 김치에 치즈 참치가 세상이 변하니까 김밥도 변해 우리의 사랑도 변해 잘 말아줘 눌러줘 밥알이 김에 달라붙는 것처럼 너에게 붙어 있을래 날 안아줘 옆구리 터져 버린 김밥처럼 가슴 터지게 해낼 사랑해 널 사랑해 세상이 우릴 갈라 놓을 때까지 영원히 사랑할 꺼야 끝까지 붙어있을래,0,1,3,3,6
36,언제부터 사랑이었는지 알아채는 요령 없나요 맘이 변해서 사랑하게 되는지 나만 훔쳐보고 싶은데 사랑하면 달라진다는데 알아채는 요령 없나요 말을 숨기고 애태우게 하는지 그만 내게 가르쳐줘요 매일 단장하는 그대의 부지런함 나완 무관한가요 그런가요 몰라보게 착해진 마음씨에 다들 놀라요 사랑하나요 나도 그댈 사랑해 그대보다 오래오래 평생 웃게 해줄게 둘이서 산다면 맘이 변해서 사랑하게 되는지 그만 내게 가르쳐줘요 괜히 토라지는 어설픈 연기가 내겐 묘한 즐거움 귀여워요 아무 상관없는 걸 맞춰보는 건 아마도 사랑하나요 나도 그댈 사랑해 그대보다 오래오래 평생 웃게 해줄게 둘이서 산다면 나도 그댈 사랑해 그대보다 많이 많이 평생 보살펴줄게 둘이서 산다면  많이 많이  이뻐해 줄게 산다면,0,1,1,0,1
37,그냥 미친 말을 할 수 있을까 평생 평생 얼굴에 일련의 문이 있었고 갑자기 나는에 부딪쳤다 원인은 자신의 장소를 찾기 위해 충만한 생명을 찾고 있었을 것입니다 아마도 파티가 말하거나 초콜릿 퐁듀 버트와 당신과 당신의 자리를 발견한 것을 발견했습니다 당신과 당신과 문을 열어 두는 문은 우리가 서로를 끝내는 것이 미친 것임을 의미합니다 작별 인사 작별 인사 과거의 고통은 과거의 고통을 느낄 필요가 없다고 생각할 필요가 없다 미친 듯이 말해봐,0,1,-5,0,-5
38,당신은 내가 당신에게 모든 것을 것이라는 것을 알고 있습니다 지금 당신에게 사랑이를 채우고 있다고 믿습니다 기억은 우리를 거기에 데려갈 것입니다 너무 슬프게도 우리는 절대 분리할 것입니다 지금 당신의 영혼에 들어가는 것을 알고 있습니다 당신에게 모든 것입니다 내가 당신의 삶을 주고 싶다는 알면 내가 기억하는 말을 듣고 기억이 우리를 거기에 데려갈 것이라고 말하는 듣고 당신을 그리워했을 너무 슬프게도 우리는 결코 분리할 당신의 영혼에 들어가는 알고 모든 줘 당신이 인생을 주실 것인가 당신이 말하는 듣고 싶을 기억이 우리를 거기에 데려갈 것이라고 말하는 당신을 그리워했을 너무 슬프게도 우리는 결코 분리되지 않을,0,1,1,0,1
39,당신의 정의는 당신이 나에게 당신이 말하는 것을 느끼게 만드는 것은 당신이 말하는 것을 진정으로 느끼게 하는 것을 느끼게 하는 것은 진정으로 그것을 만들고 나에게 너무 어려워서 당신에게 친절한 곳이든 콜드 로브는 강한 곳에서 강한 상태가 될 옛날의 어깨가 든다 당신은 물이 물을 흘릴 때마다 마른 물과 나의 갈라진다 사랑의 느낌을 주는 마약이 되어야 한다는 사랑은 내가 느낌을 주는 약물이 되어야 합니다 없어내 가에 집착하는 것은 당신의 칩이 다운로드를 둘러볼 것입니다 너무 기뻐요 너무 기뻐요 기뻐요,0,1,4,-2,2
40,너무 오래전에 깨어난 파란색의 느낌이 들었습니다 내가 당신을 자신을 부르고 애호가를 하고 부를 수 있습니까 당신을 부르기 위해 전화할 수 있습니까 눈이 너를 향해 웃으면 서있는 별에서 사람이 없고 사랑이 없다는 것을 알았다는 내가 식으로 느끼지 않았다 내가 당신이 긴장했을 것인지 확실히 당신이 긴장했을 것입니다 당신을이라고 부를 수 있습니까 연인을 당신에게 유일한 소녀와 유일한 소녀는 당신을 부를 있습니다 세상을 운영하는 유일한 사람은 자신이라고 부르고 연인이라고 운영하는 사람 자신이라고 부르고 연인이라고 세상을 운영하는 사람입니다,0,1,0,-2,-2
41,서로를 느껴가면서 조금씩 서로 알아가면서 언젠가는 어쩌면 둘이 그래요 친구들 우리가 친구 사일 넘어서 둘이 영원히 하기로 했다며 하고 알고 싶다나만 이렇게 느낀 거냐고 아님 마음도 마음처럼 영원히 할 꿈을 꾸는지 내가 한다 영원히 하겠다는 말 그래요 너와 있을 때마다 조심스럽게 마음속으로 당신과 인생을 보내고 싶어요 꿈을 꾸며 그래요 소중한 맹세를 할 곁에 내가 나의 곁엔 네가 있기를 손을 잡고 걸어가면서 서로에게 발을 맞춰보면서 할 수 있는지 느껴봐 알아야 합니다 나만 이렇게 느낀 거냐고 아님 너도 마음처럼 함께할 꿈을 꾸는지 내가 한다 하겠다는 말 너와 있을 때마다 조심스럽게 나의 마음속으로 꾸며 소중한 맹세를 곁에 나의 곁엔 네가 있기를 이제 시작한 사랑 아직은 모든 이르지만 나도 모르게 꾸는 꿈 한다 나도 모로게 꾸는 꿈,0,1,4,2,6
42,다시 누워난 그댈 헤치지 않아요 뒤로 물러서 그댈 볼게요 당신이 날 사랑한다고 수 있을 만큼만 사랑을 줘요 수 있을 만큼만 기쁨을 줘요 너무 과하지도 않게 부담주지 않을게 뒤로 누워 있으면 다시 누워 있습니다 너의 그림자 되어 늘 곁에 있을게 넌 옆에 붙어 누가 봐도 부럽게 꿈속에서도 너만 그려이런 맘 넌 아는지 뒤로 누워 있으십시오 천천히 걸어 있으십시오 넘어지지 말고 백 레이를 다시 레이블로 오라 백 레이를 말해줘 사랑에 빠지기 그댈 알면 알수록 궁금해 눈에 안 보이면 있는 건 아닐까 걱정돼 수 있을 만큼만 사랑을 줘요 기쁨을 너무 과하지도 않게 부담주지 않을게 있으면 있습니다 너의 그림자 되어 늘 곁에 있을게 넌 옆에 붙어 누가 봐도 부럽게 꿈속에서도 너만 그려이런 맘 아는지 백 레이를 놓으십시오 천천히 걸어 놓으십시오 넘어지지 말고 누워서 오백 사랑하자 베이비 사랑해 질 가란 인사를 서로 건네고 아쉬워 잡은 두 손을 붙잡고 분만 아주 잠시만 옆에 있어줄래 밤이 끝나기 전까지만 너의 그림자 되어 늘 곁에 있을게 붙어 누가 봐도 부럽게 꿈속에서도 너만 그려이런 맘 아는지 있으십시오 천천히 걸어 넘어지지 말고 누워서,0,1,2,-1,1
43,잠이 오는 잠에 나른해지고 눈이 무거워 무거운 눈꺼풀이 싫어다 좋은데 한가지 안 좋은 것은 눈뜰 수가 없네 눈을 뜰 수가 없네 봄이 봄이 그대와 함께라 좋아라 봄이 그대와 함께라 좋아라 오면은 산에 들에 진달래 피고 햇볕은 쨍쨍 모래알은 반짝거리고 다 좋은데 한 가지 안 좋은 것은 눈뜰 수가 없네 눈을 뜰 그대와 함께라 좋아라 좋아하다 좋은데 한 가지 안 좋은 것은 눈뜰 눈을 뜰 그대,0,1,2,-1,1
44,다들 고백하나요 멜로디론 솔 정도 높이 얘기하면 된단 말이 얼핏 본 같은데 사랑을 글로 배운 남자가 나선배의 충고도 소용없었고 그린라이트 같은 건 남의 얘기한데 이걸 어째요 놓치면 안 될 같은 사람이 앞에 꿈처럼 있네요 이거 어쩜 한없이 차올라 관심 없는 척 못 본 척 몰래 힐끗 보는 이거 어쩜 눈길이 간 사랑이란 말은 아직 이르지만 꼭 그렇게 될 같아두근거리는 맘 그대는 알까요 이거 어쩜 한없이 차올라 관심 없는 척 못 본 몰래 힐끗 보는 눈길이 간 사랑이란 말은 아직 이르지만 꼭 그렇게 될 같아 오해하진 말아줘 그대가 한번 한 번 한 번 한 번 봐어떡하면 좋죠 해야 하죠 관심 없는 못 몰래 힐끗 보는 눈길이 간 사랑이란 말은 아직 이르지만 꼭 그렇게 같아 두리번 두리번 두리번 조심스레 다가가 나와 연애할래요,0,1,6,4,10
45,널 보낸 아침엔 구겨진 양치질 라디오 들으면 모두가 이별 노래 쓸쓸히 노을에 외로이 다림질 어느새 눈물이 주르륵 주르륵 여보세요 잘 있나요 내게 돌아와요 사랑해요 보고파요 너무 그리워요 펀치 아무 말 못 한 마음 바쁜 아침 지하철 한가운데 눈물이 주르륵 부끄러워 고개를 돌려도 떠오르는 얼굴 정말로 우리가 이렇게 끝난 거느니가 없는 밤 하루도 네가 없이 지내기 싫다는 걸 알면서 그냥 날 보냈어내 마음도 모르는 바보 같은 널 아직도 좋아해 사랑 안의 여든 둘만이 타는 기차 많은 연인들은 그려 아주 비슷하게 영화 속 주인공들은 꿈꿔 바래 서로에게 멈추질 못함에 사이를 상처 내를 위해 날려 서로 자존심은 버려돌고 도는 이곳에서 롤러코스터 안에서 인스턴트 낭만적인 바닥 모닝콜 울리면 다가와 입맞춤 초콜릿 파르 페그보다 달콤한 너와 본 화면이 가득한 러브 신 오늘도 내일도 행복한 날 미안해요 고마워요 이제 잘할게요 사랑해요 안아줘요 입 맞춰 주세요 펀치 아무 말 못 한 마음 너를 위해 커피를 끓여야 지 사랑을 한 아름 눈물도 넣어어 제의 마음 복수를 해야지 정말로 우리가 다시 함껜 거니 너의 미소가 어여쁜 너의 미소 하나가 어이없이 사르르 마음을 녹여요 사랑해요 이제는 두 번 다시 싸우지 말아요 당신의 눈에서 볼 수 있습니다 아직은 몰라 둘이 될지 짐작이 아닌 직감이 맞는다면 다시 수 많은 고난들 사일 가로막아 배로 남아 그러다가 가짜 이별 번 맞아 펀치 사랑의 증거물 준비물 높이 쌓아가는 고층 건물에 멈추길 바라 엘리베이터를 타고 멈추십시오 사랑 가득한 낭만적인 바닥 층에 사랑 가득한 당신을 위한 낭만적인 바닥 당신을 위한,0,1,1,-1,0
46,배드민턴 치자고 꼬셔 커피 한잔하자고 불러 동네 한 번 걷자고 꼬셔 넌 한 번도 안 된다는 말이 없었지 꽃송이가 꽃송이가 그래그래 피었네 꽃송이가 꽃 한 송이가 그래그래 피었구나 거리에 사람들 수많은 사람 길에 사람들 네게 특별한 건지 그게 어려운 거야 그게 어려운 거라 그게 어려운 거야 맛있는 거 먹자고 꼬셔 영화 보러 가자고 불러 단대 호수 걷자고 넌 번도 안 된다는 말이 없었지 그래그래 피었네 꽃 송이가 피었구나 거리에 사람들 수많은 사람 길에 네게 특별한 건지 거야 거라 하모니카 솔로 피었네 꽃 송이가 피었구나 거리에 수많은 사람 길에 네게 특별한 건지 거라,0,1,1,0,1
47,두 눈에 나의 사랑을 담으러 가요 맘에 행복이 오늘부터 채워지길 며칠째 비가 그치길 기다렸죠 오늘에서야 맘 전하러 가요사랑한다는 말 흔한 말이지만 오늘 하루를 아껴둔 말이죠 그대가 예쁜 미소를 지을 때마다 서둘러 말하고 싶었지만 참아왔죠 비 온 뒤 개인 날이라 더욱 선명해요 오늘 그대는 너무 아름다워요 사랑한다는 말 흔한 말이지만 그대 꺼내지 못하는 말이죠 그댈 사랑해요 다시 태어나도 사랑을 믿습니다 사랑은 그대뿐이죠 그댈 사랑해요 다시 태어나도 사랑을 믿습니다 삶의 이유 그대죠,0,1,7,8,15
48,달이 차고 마음도 차고 이대로 담아 두기엔 너무 안타까워 너를 향해 가는데 달은 내게 오라 손짓하고 귓속에 얘길 하네 지금 순간이 순간이야 제일 마음에 드는 옷을 입고 노란 꽃 한 송이를 손에 들고 널 바라보다 그만 나도 모르게 웃어버렸네 이게 아닌데 마음은 이게 아닌데 널 위해 준비한 오백 가지 멋진 말이 남았는데 사랑한다는 흔한 말이 아니야 그보단 로맨틱하고 달콤한 말을 준비했단 말아 숨이 차고 밤공기도 차고도 눈을 감아야만 모습이 보여 걸을 수가 없는데 구름 위를 걷는다는 말이 과장이 아니란 걸 알게 됐어널 알게 된 후부터 나의 모든 건다 달라졌어 이게 아닌데 마음은 널 위해 준비한 오백 가지 멋진 남았는데 사랑한다는 흔한 아니야 그보단 로맨틱하고 달콤한 말을 준비했단 말이야 나를 봐줘요 말을 들어봐 줘요 아무리 생각을 하고 해도 믿어지지 않을 만큼 사랑해,0,1,2,3,5
49,사랑을 할 거야 이제는 좋아하게 될 거야 지나버린 시간들이 다시 되돌아오면 이제는 사랑하게 될 거야 달콤했던 추억들이 영원히 아름답도록 소중했던 그날들은 지나도 아름다운 사랑을 할 이제는 좋아하게 될 지나버린 시간들이 다시 되돌아오면 사랑하게 달콤했던 추억들이 영원히 아름답도록 소중했던 그날들은 지나도 아름다운 사랑을 할 지나버린 다시 되돌려줘내게로 줘 너와 나의 달콤한 추억 추억할 수 있도록 그럴 수만 있다면 너와 사랑하게 돼 너와 그대와 나잖아 영원한 마음을 네게 줄게 떠나갈래 푸른 하늘을 영원히 날래 하나뿐인 맘에 갈래 가지고 영원한 사랑할래 나와 좋아하게 이제 이제 손을 잡아 우리의 미래 바라봐 시간들이 되돌아오면 달콤했던 추억들이 아름답도록 소중했던 그날들은 지나도 아름다운,0,1,5,-1,4
50,나에게 첫사랑이란 걸 이제야 널 찾게 된 걸 말해봐환하게 웃으며 내게 와줄래 걱정 그래그래 당신을 너무 사랑하기 아기 문을 열고 들어왔을 깜짝 놀랐어 눈을 의심했어 믿을 수 없다 대박 해프닝 꼬맹이가 너란 걸 말도 안 되는 몰라보게 여자가 된 핑크 색깔 운동화는 아찔한 하이힐로 단발머리 교복 치만 생머리의 미니스커트 말해봐 애가 타는 맘 그래그래그래그래그래 네가 말해줘 너만 보면 그래그래그래그래그래 나에게 첫사랑이란 이제야 널 찾게 된 아기 와줄래 지금부터 우린 그래그래그래그래 그래알고 있니 소녀 베이비 사랑 심장은 두근 반 세근 반 오네 두 뺨은 달아오른 난로 이렇게 다시 만날 꿈에도 몰랐던 거야 기억해 너의 말투 향기 그것 빼곤 무지 달라 오핑크 색깔 운동화는 아찔한 하이힐로 단발머리 교복 치만 생머리의 미니스커트 말해봐 애가 타는 맘 그래그래그래그래그래 네가 말해줘 너만 보면 그래그래 그래그래그래 나에게 첫사랑이란 이제야 널 찾게 아기 와줄래 지금부터 우린 해바라기 반 어린아이가 어느새 향수 뿌릴 나이가 되어서는 미모에 물이 올라 예쁜 신민아도 저리 가라네 어디서 뭘 하고 이제 나타난 거야 아기작은 소녀가 숙녀가 됐어 언제나 변함없어 네게 약속할게 이제는 절대 당신을 놔두지 않을 것입니다 애가 타는 맘 네가 말해줘 너만 보면 지금부터 우린 그래그래그래그래,0,1,1,-3,-2
51,처음으로 사랑한다 말하던 날 살며시 농담처럼 흘리던 말 못 알아들은 걸까 딴청을 피우는 걸까 괜히 어색해진 나를 보며 웃던 짓궂은 넌지시 나의 맘을 열었던 날 친구의 얘기처럼 돌려 한 말 알면서 그런 건지 날 놀리려는 건지 멋진 친굴 뒀노라며 샐쭉 토라진 사랑한다는 말 내겐 그렇게 쉽지 않은 사랑해요 너무 흔해서 하기 싫은 나도 모르게 늘 있을 땐 항상 입에서 맴도는 사랑한다는 내겐 눈으로 하고 싶은 사랑해 맘으로 하고 싶은 말나 아끼고 아껴서 너에게만 하고 싶은 시처럼 읊어볼까 편지로 적어볼까 그냥 너의 얼굴 그려놓고 끝내 못하는 사랑한다는 내겐 그렇게 쉽지 않은 사랑해요 너무 흔해서 하기 싫은 나도 모르게 늘 있을 땐 항상 입에서 맴도는 눈으로 사랑해 맘으로 언제나 이렇게 너에게 귀 기울이면 말하지 않아도 들을 수 있는 말이 꼭 너에게만 해보고,0,1,0,-3,-3
52,눈을 뜨면 오늘은 왠지 기분이 벽에 걸린 너의 웃음처럼 지난밤에 꿈속엔 네가 있던 같아 노래를 불러보네 응어리는 오늘따라 너무 눈부시기만 해 목소리로 내게 말을 걸어와 오늘 같은 날이면 우연히 만날 같아 기대하며 걸어가 당신과 사랑에 빠졌습니다 눈을 뜨면 오늘은 왠지 기분이 지난밤에 늦은 전화처럼 잠에 취한 목소린 귓가에 남아있어 나를 기다리게 해 응머린 오늘따라 마음에 안 들기만 해 뭘 좋아할까 괜히 고민도 하고 오늘 같은 날이면 시간이 더디기만 전화를 해볼까 당신과 사랑에 빠졌습니다 어디쯤 오는 걸까 당신이 사랑에 빠지지 않는다 당신이 나를 웃을 느끼는지 모르겠다 아침부터 오늘은 왠지 느낌이 곁에 있는 너의 웃음처럼 따뜻한 목소린 내게 말을 걸어와 설레는 시간들 응어리는 오늘따라 너무 눈부시기만 누구나 다들 우릴 보는 같아 오늘 같은 날이면 시간이 빠르기만 너와 둘이 걸어가 당신과 빠졌습니다 당신은 당신이 저에게 미소를 지을 내가 느끼는지 모릅니다  당신이 돌아올 때마다 나에게 미소를 지을 때마다 돌아올 때마다 당신은 나에게 미소를 지을 돌아올 나를 사랑한다고 말해 수 있습니까,0,1,3,2,5
53,우린 제법 잘 어울려요 그대가 보이네요 오늘도 같은 시간이죠 언제나 젖은 머리로 날 스쳐가죠 살짝 미소 지은 건가요 날 알아챈 건가요 아침을 닮은 그대 향기가 날 사로잡죠난 궁금한 많죠 그대 이름 그대의 목소리 온종일 상상해요 그대 곁에 서두르진 않을 거예요 한 걸음 한 걸음씩 그대가 나를 느끼게 사랑을 시작할까요 내일 아침 어쩌면 말할지도 모르죠 한 번 만나 볼래요 물기 어린 나무 사이로 햇살이 부서지는 거리 투명한 얼굴이 왠지 보여요 기분 좋은 일이 있나요 가벼워 보이는 발걸음 살며시 부는 바람을 타고난 다가가죠 망설였었지만 오늘은 꼭 얘기할래요 눈이 예쁘다고 좋아한다고 서투르고 어색하지만 천천히 알아가요 그렇게 시작해봐요 거 봐요 웃을 거면서 마음을 알면서 잘 해낼 수 있겠죠 우린 제법 잘 어울려요 서두르진 않을 거예요 걸음 걸음씩 그대가 나를 느끼게 사랑을 시작할까요 곁엔 언제나 내가 있어줄게요 변치 않을 거예요 우린 제법 어울려요,0,1,15,5,20
54,세상 사람들 정답을 알긴 할까 힘든 일은 한 번에 일어날까 나에게 실망한 하루 눈물이 보이기 싫어 의미 없이 밤 하늘만 바라봐작게 열어둔 문틈 사이로 슬픔 보다 큰 외로움이 다가와 날 수고했어 오늘도 너의 슬픔에 관심 없대 도난 늘 응원해 수고했어 오늘도 빛이 있다고 분명 있다고 믿었던 길마저 흐릿해져 점점 날 수고했어 오늘도 너의 슬픔에 관심 없대 도난 늘 응원해 너의 슬픔에 관심 없대 도난 늘 응원해,0,1,-5,0,-5
55,꽤 오래된 스니커즈 허름한 편안함 널 만나러 가는 길은 설렘 걸음이 빨라져 음 너와 둘이서 걸으면 말아 왠지 좋은 데로 가는 기분이야 어디라도 좋은 걸 바람이 분다 웃는다 햇살은 부서진다 공기가 달다 좋다 청춘은 빛난다 반짝여라 젊은 날 반짝여라 사랑 늘 거닐던 거리 익숙한 다정함 고개 돌려보면 옆얼굴 나도 모르게 웃곤 하음 너의 얘기를 들으면 말이야 왠지 좋은 일이 생길 같아져 언제라도 걸 바람이 분다 웃는다 햇살은 부서진다 공기가 달다 좋다 청춘은 빛난다 반짝여라 젊은 날 사랑 만세 멋진 날이야 멋진 날이야 멋진 일이야 일이야 너와 있는 오늘이 푸르게 반짝여 손잡아 볼까 가만히 라라라라라라라 입 맞춰 볼까 가만히 라라라라라라라 젊은 날 청춘 바람이 분다 웃는다 햇살은 부서진다 공기가 달다 좋다 청춘은 빛난다 사랑 꽤 오래된 스니커즈 허름한 편안함 널 만나러 가는 길은 맑음 오늘이 기다려,0,1,13,3,16
56,내게 왔던 너의 얼굴을 기억해멈춰있던 맘을 밉게도 고장 가슴을 너의 환한 미소가 쉽게도 연 거야 그렇게 내가 너의 사람이 된 거야 못났던 추억들이 기억조차 안 나나를 꼭 잡은 손이 봄처럼 따뜻해서 이제 꿈처럼 맘은 그대 곁에 가만히 멈춰 성요한 순간도 깨지 않는 끝없는 꿈을 꿔요 이제 숨처럼 곁에 항상 쉬며 그렇게 있어주면 당신보다 나은 것을 잘하는 것보다 나은 것은 없습니다 이제 꿈처럼 맘은 그대 품에 가만히 안겨있죠 한순간도 깨지 않는 끝없는 꿈을 가죠 숨처럼 곁에 항상 쉬며 그렇게 있어주면 나은 것보다 것보다 것을 것을 잘하는,0,1,3,-2,1
57,썸 위업 릴 보이 긱스 가끔씩 나도 모르게 짜증이나 너를 향한 맘은 변하지 않았는데 내가 이상한 걸까 힘들게 지내고 있었어 텅 빈 방 멍하니 뒤척이다 티브이에는 어제 본 같은 드라마 잠이 때까지 한 번도 울리지 않는 핸드폰을 들고 요즘 거인 거 아닌 거 같은 너니 거인 거 아닌 같은 나이게 사이인 건지 사실 헷갈려 무뚝뚝하게 굴지나 연인인 연인 아닌 연인 나만 볼 애매하게 날 대하는 때로는 친구 같다는 말이 괜히 요즘 듣기 싫어졌어 매일 아침 너의 문자에 눈을 뜨고 하루 끝에는 목소리에 잠들고 파주 말에는 많은 사람 속에서 보란 듯이 널 끌어안고 싶어 요즘 거인 너니 때로는 친구 같다는 말이 괜히 듣기 싫어졌어 별로야 별로야 근데 너뿐이야 너뿐이야 분명하게 내게 선을 그어줘 뒤로 빼지 말고 날 사랑한다 고백해 줘 여전히친구인척 연인인 척 행동하는 모습을 전부다 돌이켜 생각할수록 너의 진심이 궁금해지는 걸 소녀 못해 무엇도 어쩌면 기적을 바라지 숫자 카드 맞추기 놀이 확실한 표현을 원하지만 너의 미소 띤 표정에 잊어버리지 너니 순진한 척 웃지만 말고 그만 해 솔직하게 굴어봐 티 맘속에 날 놔두고 한 눈 팔지 마 너야말로 다 알면서 딴청 피우지 마피 곤하게 힘 빼지 말고 어서 말해줘 사랑한단 말이야,0,1,1,-1,0
58,알고 있지 오늘따라 그대가 이러는지 얼굴은 빨개지고 눈빛도 이상하고 집에 안 가고 가만있어 오늘 같은 밤을 내내 기다렸어 투박한 두 손에 온몸을 맡겨줘요 할 있어요 쓰다 쓰다 쓰다 다담 해볼까요 토닥토닥 토닥토닥 토다닥디다리디독 해드릴까요 쓸데없던 나의 손이 용도일 줄이야 외로워 미칠 때마다 불러줘요 맙소사 그대 그대 나의 귓가에 귓가에 들리는 목소리 다 알았어요를 보든 뭘 보든 식사 중이든 뭘 먹든 운전 중이든 언제라도 다담 해볼까요 토닥토닥 토다닥디다리디독 해드릴까요 쓸데 없던 나의 손이 용도일 줄이야 외로워 미칠 때마다 불러줘요 다담 해볼까요토닥토닥토닥토닥토다닥디다리디독 해드릴까요 오갈 데 없던 나에게도 날이 올 줄이야 외로워 미칠 때마다 밤이 그대 두 볼이 빨개질 불러줘요,0,1,-2,-2,-4
59,내가 하고 싶은 것은 내가 당신을 행복하게 만드는 것뿐입니다 내가 하고 싶은 일은 당신을 행복하게 만드는 것뿐입니다 하고 싶은 일은 당신을 행복하게 만드는 것입니다 거짓말을 한다고 말하면 당신의 숨어있는 것을 보여 주지만 이것이 사랑이라면 당신에게 죽는 것을 지켜보는 것을 지켜보는 것은 것입니다 어쩌면 당신은 말을 들을 수 없지만 근처에 당신이 당신의 이론에서 나를 구해 당신의 이론에서 나를 구해주었습니다 저평가에 저평가를 외치게 합니다 진실에서 멀지 않을 수도 있습니다 일은 것뿐만 아니라 일이 것뿐입니다 것입니다 할 수 없다 당신은 결코 잘 아는 알고 있습니다 마음을 고치지 마십시오 저평가를 받아들이려면 진실에서 멀리 떨어져 있을 수 없을 아마 파란색에서 볼트를 알지 못했을 당신은 때릴 절대 정리하지 않을 은 절대 실망시키지 않을 절대 포기하지,0,1,-1,2,1
60,말해줘 말해줘아니야 아니야 넌 늦었어 절대 절대 선한 말을 하지 않는 절대 아니야 아니야 너를 지울래 네가 내게 이러면 안 되지 오락가락 그녀와 날 오가다니 너는 목소리 그녀인 알고 다정하게 전화받았던 거야 이럴 수가 내게 한말과 똑같아 농담 섞인 얘기까지 언제부터야 이럴 수 있니 널 믿기를 바라니 너와 이별을 작별을 하긴 싫어 내겐 소중한 너였으니까 나도 내가 싫지만 이번엔 용서할까 다시 다시 고민고민해 봤어 한 번이 두 번이 될 거짓말 너를 너를 잊어잊어 잊을래 사랑이 내게 오겠지 하나라고 믿고 있던 언제나 나를 믿고 있던 너에게 되돌릴 수 없던 후회 베이비 베이비 어서 울고 싶고 부르고 싶고 잡고 싶은 근데 멀어지는 잡으려고 애를 쓰는 나의 맘 왜왜 도대체 맘을 몰라 그렇게 지금 당신이 무엇을 할지 말해줘 당신이 주위에 놀 시간을 돌려주는데 소년을 놀릴게요 잠깐만 내게로 와바라봐 돌아봐 베이비 버넌 억울한 거야 너는 가버리겠다고 가지 마 어디부터 어디까지가 너였니 지금도 모르겠어내가 필요하단 말 나뿐이란 말 그녀도 나처럼 믿었니 너의 변명을 이유를 듣기 싫어 너무 화가 눈물이 나와 그냥 모두가 장난이라고 웃으며 네가 말해준다면 좋겠어 너와 이별을 작별을 하긴 싫어내겐 소중한 너였으니까 나도 내가 싫지만 이번엔 용서할까 얘기는 사랑은 여기까지 이대로 모든 걸 끝내내 맘 돌리려고 하지 마 너라면 용서하겠니 말해줘 말해줘아니야 넌 늦었어 결코 작별 인사를 하지 않는 절자는 절자 절자는 절자 없습니다 지울래이 뭐야 뭐야 꿈에도 잠시도 널 안 볼래 모든 모든 사랑 네가 가져가새로운 사랑이 올 거야,0,1,-5,4,-1
61,모든 그대를 우울하게 만드는 날이면 노래를 불러보게 아직은 가슴에 불꽃이 남은 대여 지지 말고 싸워주게 라 라 라 후회는 하늘에 날리고 라라라라 라라라라 친구여 새롭게 태어나게 비굴한 인생은 그대에게는 어울리지 않는다네 당당히 고개를 들게 친구여 지금이 시작이라네 마음에 가득히 꽃피우고 라라라라 친구여 마음껏 웃어보게 하하하하하 하하하하하 빛나는 그대 두 눈동자 속에 푸른 바다가 있네 파도의 노래를 듣게 마음이 부르는 노래 안녕 안녕 안녕히 다시는 울지 않아 내일은 새롭게 태어나리 하하하하하 사람들의 시선에 맘 쓸 없네 용기 없는 자들의 비겁한 눈초 리에라 마음에 꽃피우면 내일이 찬란히 빛나고 가슴을 열어두게 태양은 가슴에서 빛나게,0,1,-1,-2,-3
62,파란 바람이 불어 괜히 설레던 날 하얗게 빛나던 너를 보게 됐어 오오오오 스쳐지나 갔지만 스쳐지나 갔지만 까만 너의 눈 속에 까만 너의 눈 속에 너를 바라보는 모습이 있어 오오오오 당신을 뵙겠습니다 꼭 보게 될 거야 내게 주문을 걸었으니 그렇게 그렇게 널 만날 거야 내가 당신을 볼 수 있을 것이다오오오 오오오 찾게 될 거야 너는 마법에 빠진 그렇게 꼭 널 찾을 매일 너의 꿈속에 나를 보게 될 놀라지는 말아 우연이 아니야 오오오오 아한 순간이었지만 한순간이었지만 마음 가득히 마음 가득히 까만 눈에 비친 모습이 있어온 당신을 만나는 것을 보고 있을 것입니다 내게 주문을 걸었으니 널 만날 내가 볼 수 있을 것이다오오오 오오오 찾게 너는 마법에 빠진 거 아오 꼭 찾을 오오오 보고 있는 것입니다 찾게 너는 마법에 빠진 거 아오 찾을,0,1,1,-6,-5
63,이건 비밀이야 아무에게도 고백하지 않았던 이야기를 들려주면 큰 눈으로 너는 묻지 와우 와우나 실은 말이야 아득한 미래로부터 날아왔어쏟아질 듯이 빼곡한 별들 사이를 지나 플라이 플라이 플라이 있지 그곳도 사실 바보들 투성이야 매우 반짝이는 건 지금 지금이 하루 지금 눈부셔 아름다워 불꽃놀이는 끝나지 않을 거야 뭐든지 흐린 날이면 거짓말처럼 무섭게 깜깜했지 새침데기 태양은 뜨겁기는커녕 피콕블루 블루 블루 뭐든지 매일매일 제멋대로인 바람결을 땋아서 만든 나침반이 가리킨 그곳에서 발견이 그게 당신입니다 있지 저런 건 자그만 돌멩이야 빛이 건 있잖아 인생은 시원합니다 시원합니다 시간은 많아 이대로면 아마 영원히 살 수 있지 않을까 안녕 나의 주인공 너를 만나러 짜잔 우아하게 등장 하루 지금 눈부셔 아름다워나는 확실히 알아 오늘의 불꽃놀이는 끝나지 않을 거야 우우우 우우우더 놀라운 지금부터야,0,1,0,2,2
64,유난히 고요하던 밤 하늘을 바라보다가 유성처럼 떨어지는 별을 봤지 떨어지는 별을 보고 가슴속의 소원을 빌면 영화처럼 현실이 된다는 얘기 예쁜 여자 친구와 빨간 차도 갖고 싶었지만 너무나 원했던 것은 누구도 모를 거야 덩크 슛 한번 할 수 있다면 평생 단 한 번만이라도 짜릿한 기분을 느낄까 주문을 외워보자 야발라바히기야 야발라바히기야주문을 외워보자 야발라바히기야모하이마모 하여 이루라 꿈을 구웠던 것일까 주위엔 없는데 발 옆엔 주홍색 공 덜렁 덩크 슛 한 번 할 수 있다면 멋질까 하늘을 날 듯이 주문을 외워보자 야발라바히기야 야발라바히기야한번 될 때까지 오예 발라봐 하기야 모하이마모하이루라,0,1,1,1,2
65,내가 미친 햇빛을 말하려고 합니다 여기서 당신은 휴식을 취할 수 있습니다 내가 돈처럼 공기로 갈 수 있는 뜨거운 공기 풍선 그건 그렇고 아기를 돌보아야 합니다 지붕이 없는 방처럼 느껴지면 행복하게 손뼉을 칩니다 당신이 행복하다고 느끼면 행복한 박수를 진실이기 당신이 당신에게 행복이 무엇인지 알면 행복한 박수 당신이 그렇게 느껴지면 행복한 박수 여기서 하고 싶은 일은 나쁜 소식을 하고 있습니다를 뒤로 잡아난 괜찮아 여기서 시간을 낭비하십시오 내가 지붕이 없는 방처럼 느껴지면 행복하게 손뼉을 칩니다 행복하다고 느끼면 박수를 진실이기 당신에게 행복이 무엇인지 알면 박수 그렇게 행복하게 할 수 없는 일을 할 없습니다 아래로 지붕이 방처럼 행복하기 행복하다고 느끼면 박수를 진실이기 당신에게 행복이 무엇인지 알면,0,1,4,-4,0
66,반짝 눈부신 날 짠하고 나타날 같아 방금 짓궂은 표정 문득 머리 위로 차가운 공기가 흐르다 인사를 할 시작하는 여행자여 안녕 다시 만날 그대로 내가 사랑한 너의 말투 너의 웃음 그대로 생각해보면 똑같은 풍경이 하늘과 바람 복잡한 도시오 그대여 눈을 감으면 늘 여기서 널 기다리고 있을 테니까 행운을 빌어줘요 웃음을 보여줘요 눈물은 흘리지 않을게 굿바이 뒤돌아 서지 마요 쉼 없이 달려가요 노래가 멈추지 않도록 수많은 이야기 끝없는 모험만이 그대와 길 안녕 고마웠어짧았던 너와 나의 계절 끝은 하나의 시작 잔뜩 배낭을 멘 작은 어깨를 두드리다 떠나야 할 숨 가쁜 시간의 강을 건너엇갈린 축의 바람이 분다오 그대 작은 별이 되기를 망설였던 나의 서툰 노래 할 수 있어 행운을 빌어줘요 웃음을 보여줘요 눈물은 흘리지 않을게 굿바이 뒤돌아 서지 마요 쉼 없이 달려가요 노래가 멈추지 않도록 수많은 이야기 끝없는 모험만이 그대와 함께이길 행운을 빌어요 빛나기 시작한 별세 차게 부는 바람 눈물은 흘리지 않을게 굿바이 오랜 시간이 흘러쓰러질 벅찬 날이 서툰 노래가 닿기를 긴 여행의 날들 끝없는 행운만이 그대와 함께이길,0,1,1,1,2
67,두근거렸지 누군가 나의 뒤를 쫓고 있었고 검은 절벽 끝 발 디딜 곳 없었지 목이 메어 간절히 이름을 되뇌었을 귓가에 울리는 그대의 뜨거운 목소리 그게 나의 구원이었어 마른하늘을 달려 그대에게 안길 수만 있으면 몸 부서진대도 설혹 너무 태양 가까이 날아 두 다리 녹아내린다고 해도 맘 그대 마음속으로 영원토록 달려갈 거야 내가 미웠지 이것밖에 안 돼 보였고 오랜 꿈들이 공허한 어린 날의 착각 같았지 울먹임을 참고 남몰래 이름을 속삭였을 귓가에 울리는 그대의 뜨거운 목소리 그게 나의 희망이었어 마른하늘을 달려나 그대에게 안길 수만 있으면 몸 부서진대도 설 혹 너무 태양 가까이 날아도 다리 녹아내린다고 해도 맘 그대 마음속으로 영원토록 달려갈 거야 허약한 영혼에 힘을 날개를 달수 있다면 마른하늘을 달려나 그대에게 안길 수만 있으면 몸 부서진대도 설 혹 너무 태양 가까이 날아도 다리 녹아내린다고 해도 맘 그대 마음속으로 영원토록 달려갈 거야,0,1,-4,3,-1
68,한 번도 너를 잊어본 적 없어 그대만을 생각했는 걸 그런 너는 뭐야 날 잊었던 거야 지금 눈에선 눈물이 흘러 배신감 느껴널 찾아갈까 생각했어난 잘 모르겠어 세상이 돌고 있는 지금 눈에는 너밖에 뭐 할 말이 없어 갈 수도 없어 눈물도 느낌도 없어네 앞에 있는 날 바라봐이렇게 널 위해 살아있는 날 약속된 시간이 왔어요 그대 앞에 있어요 두려움에 울고 있지만 눈물을 닦아주었어요 손잡았죠 일어날 거야 해준 그대에게 행복을 눈 감고 그댈 그려요 맘속 그댈 찾았죠 나를 밝혀주는 빛이 보여 영원한 행복을 놓칠 순 없죠 그대 보이나요 나를 불러줘요 그대 곁에 있을 거야 너를 사랑해 함께해요 그대와 영원히 한 번도 너를 잊어 본적 그대만을 생각했는 걸 몰라 몰라 그런 너는 뭐야 뭐야 잊었던 지금 눈에선 눈물이 흘러 배신감 느껴 약속된 시간이 왔어요 앞에 있어요 두려움에 울고 있지만 눈물을 닦아주었어요 손잡았죠 일어날 해준 그대에게 행복을 눈 감고 그댈 그려요 맘속 찾았죠 나를 밝혀주는 빛이 보여 영원한 놓칠 순 없죠 보이나요 불러줘요 곁에 있을 사랑해 함께해요 그대와 영원히 눈 감고 그려요 맘속 찾았죠 밝혀주는 빛이 보여 영원한 놓칠 순 없죠 보이나요 불러줘요 언제라도 마음을 열어 보아요 앞엔 내가 있어요 곁에 있을 사랑해 함께해요 그대와 영원히,0,1,2,3,5
69,생각해보세요 내가 별로라는 외모 갖고 있는 너라고 많이 안 좋아하는 버릇도 모조리 다 갖추고 있어 어쩜 스치기만 해도 엄청나게 싫은 얼굴로 널 쳐다봤어 네가 여자친구 없는 이율 알겠어 애들보다 수준 떨어져 며칠 뒤에 어느새 나도 모르게 거짓말처럼 당신은 나의 부입니다 내게 사랑을 줘 한 입만 맛있는 사랑을 할 거야 아이스크림보다 달콤한 부 부언제나 너만 사랑하고파 그냥 그냥 곁에만 있고파 아무아무것도 필요 없는 건 부의 부 거 괜히 콧대 높고 쓸데없이 눈만 높아서 나를 지나만 가는 남자도 모조리 다 점수를 매겨이러네 저러네 말하고 꼼꼼하게 흠을 잡아도 외로웠어내가 남자친구 없는 이율 알겠어 애들보다 너무 재기만 했어하지만 며칠 뒤에 어느새 나도 모르게 거짓말처럼 당신은 나의 부입니다 내게 사랑을 줘 한 입만 맛있는 할 거야 아이스크림보다 달콤한 부 부언제나 너만 사랑하고파 그냥 곁에만 있고파 아무아무것도 필요 건 부의 부햇살이 좋은 날에 살짝 바람 부는 날 에단 둘이 단둘이 손을 꼭 잡고 걷고 싶은 간절하니깐 너무나 신기해 당신은 나의입니다 하나만 물어보고 싶어 맘과 맘이 같다면 지금부터 나를 불러줘 부언제나 너만 사랑하고파 곁에만 있고파 아무아무것도 필요 건 부의,0,1,5,-1,4
70,숨길 수 없죠 그대 눈 속에 많이도 웃네요 맘을 말해줄게요 떨리는 순간 빛나는 오늘 밤 많이 기다려온 말을 참아왔죠 그대에게 모자란 나라 서늘 곁에만 그렇게 있어줘요 처음 같지 않아도 괜찮아요 그보다 그대를 아낄게요 눈물도 없을 만큼 상처도 지울 만큼 실 수도 없을 만큼 사랑할게요 마음 언제부턴지 알지도 못해요 누가 알겠어요 자꾸만 나도 모르게 그대로 맘은 물들었나 봐요 외롭던 날에 그대의 목소리는 나를 불러 봄을 선물했죠는 곁에만 그렇게 있어줘요 처음 같지 않아도 괜찮아요 그보다 그대를 아낄게요 눈물도 없을 상처도 지울 실 수도 사랑할게요 가끔은 지쳐가겠죠 때로는 무뎌지겠죠 오늘 밤우리 오늘 밤 기억해요 괜찮아요 그날의 소중한 우리들을 늘 곁에만 그렇게 있어줘요 처음 같지 않아도 그보다 그대를 아낄게요 눈물도 상처도 지울 실 수도 사랑할게요,0,1,-2,-6,-8
71,입술 끝에 맺혀있는 말 너만 보면 하고 싶은 말 너무 소중해 아껴두려고 참고 참는 말 할 수 있어 행복한 발음조차 달콤한 말이 제일 좋은 날 제일 멋지게 네게 해주고 싶은 너를 사랑해 사랑해 사랑한다 한 번 두 번을 말해도 모자라서 아끼지 못해 숨기지 못해솔직한 맘을 고백을 해 너만이 너만이 전부인 너를 보고 안아도 벅찬 말할 때마다 다시 설레서 쉬운 적 없던 너를 사랑해 울다가도 웃게 하는 웃다가 울게 하는 말이 아주 먼 훗날 너의 귓가에 하고 눈 감고 싶은 사랑한다 한번 두 번을 말해도 모자라서 아끼지 못해 숨기지 못해솔직한 맘을 고백을 해 너만이 전부인 보고 안아도 벅찬 말할 때마다 다시 설레서 쉬운 적 없던 네가 다가온다 나를 본다 가슴이 뛰어온다 매일 봐도 건 기적일까 계속된 꿈인 걸까 널 다시 물어도 대답은 똑같은데 돌려 말하고 꾸며 볼래도 결국에 맘은 거야 전부인 보고 안아도 눈물이 네가 내게 온 거니 믿을 수 없을 만큼,0,1,8,0,8
72,침대에서 뛰어 내려와 커튼을 열어 아침을 들이켜 내가 원하는 방식으로 할래 강아지와 아침 인사 커피 한 잔 사소한 차이를 느끼는 나만의 작은 행복 들어볼래 독특한 라이프 스타일 바다 건너가지 않아도 내게는 여행 스타일이야 떠나자 떠나자 떠나자 어디든 가벼운 일상을 여행하자 어디라도 달려가는 상상 오늘을 즐겨봐 매일 기분 오미 독특한 라이프 스타일 마음이야 오미 독특한 라이프 스타일 매일 기분 오미 스타일이야 원한다면 언제든지 자유롭게 훌쩍 떠나 마주한 바람에 손을 내밀어봐 스타일자유로운 사고방식 남다르게 오늘을 즐겨봐 내가 만들어 새롭게 세련된 지금이 보다 상큼하게 전혀 곳에 있지 않아도 언제나 새로운 만남이 안녕 안녕 어디든 가벼운 일상을 여행하자 어디라도 달려가는 상상 오늘을 즐겨봐 매일 기분 마음이야 독특화 스타일이야 발을 올라가는 아름다운 하루 새 신발을 신고 발을 디뎌 늘 맘이 가는 대로 해도 괜찮아 뭐래도 그래나는 나를 믿어 허락하다 간나를 반기는 세상으로 왼손엔 핸들 오른손은 음악을 키 워모도 나를 알 수 있도록 내일이 없다는 생명을 살게 될 거야 마음이야,0,1,4,5,9
73,생각해보면 항상 곁에 있었는데 내가 촉이 많이 부족한 걸까 너에게 딱히 매력을 느끼진 못했어 솔직히 네게 아무 감정도 없었어 너무 멀리 가지 말아 줘 너의 두 볼에 입 맞출 수 있겠지 자세히 볼수록 볼수록 예뻐 시간이 갈수록 갈수록 갈수록 예뻐내 눈엔 누구보다 예뻐 여태까지 몰랐을까 알면 알수록 예뻐볼수록 볼수록 볼수록갈수록 날이 예뻐 알수록 알수록 세상 누구보다 지금 늦지 않았을까 너에게 가고 있어 매일 괜찮은 사람 찾고 있었는데 등잔 밑이 어둡다고 얘기들 하지 이렇게 예쁜 너를 알아보지 못했던 멍청한 나를 한 번만 용서해줘 너무 멀리 가지 말아 줘 너를 품에 안을 수 있겠지 자세히 시간이 예뻐내 눈엔 누구보다 여태까지 몰랐을까 알면 너무 앞으론 나만 바라봐 알겠지 천사 같은 마음도 정말로 정말로 자세히 시간이갈수록 예뻐내 눈엔 여태까지 몰랐을까 여태껏 알면 예뻐볼수록 볼수록갈수록 날이 세상 지금 늦지 않았을까 너에게 가고 있어,0,1,-1,0,-1
74,내가 맘을 몰랐어 미안해난 네가 미안해할 까봐 아님 우리가 변하게 될 까봐 두려운 맘을 어쩌지 못하고 맘 들킬까 부끄러운 아니야 혹시라도 거절할 까봐가 아니야 어쩌면 어쩌면 그냥 지켜주고픈 맘일지 몰라 같은 크기로 무게로 맘을 저울질할 순 없잖아어쩌면 어쩌면 우린 그냥 좋은 사이인지도 몰라 내가 어리석었다 해도 좋아내 맘이 부족하다 해도 좋아어쩌면 네가 먼저 말하길 바랐는지 몰라 모르겠다 말하지만 닮아버린 우릴 인연인 걸까 두려워 날 믿어숨겨왔었던 마음에 솔직해 같은 크기로 무게로 저울질할 순 없잖아어쩌면 우린 기다려온 사랑일지도 같은 크기로 무게로 저울질할 순 없잖아어쩌면 우린 그냥 좋은 사인지도 모르겠지만 할 수 없나 네게만 들키고 싶은 맘 사랑하는 사이인지도,0,1,-2,0,-2
75,아주아주 오래전부터 내가 널 만나던 순간부터 너에게서 배운 있어 사랑이 건지 알게 됐어바뀐 것도 있는 같아 누군가를 기다리는 싫어하던 일인데 이렇게 웃고 있잖아널 스쳐온 바람 내게 불어올 때면 두 눈을 감아네가 느껴질 때면 오늘은 표정으로 날 설레게 할지 그런 상상만으로도 하늘을 날아라 라라 라라라 라라라 라라라 널 사랑해 사랑해 사랑해라 널 사랑해 아주아주 오래전부터 내가 만나던 순간부터 잃은 있어 주변에 친구들이 사라졌어바뀐 것도 있는 같아 틈만 나면 피우던 담배 좋아하던 일인데 이렇게 참고 있잖아널 스쳐온 바람 내게 불어올 때면 두 눈을 감아네가 느껴질 너를 그리면서 너를 노래로 부르다 보면 어느샌가 넌 내게 다가와날 안아주는 걸라 나라 사랑해라 사랑해더운 맘 식히는 바람이 되겠어추운 맘 녹이는 태양이 돼주겠어 너를 사랑하고 너의 행복도 사랑하니까내가 행복해진 이유도 하나니까 사랑해라,0,1,6,4,10
76,커피 우윳빛 얼굴 웃을 때마다 날 녹이는 하트 모양 같은 가슴 뛰는 입술에 입술이 다가가 한껏 마음을 주면 살짝 손 잡아나를 안아 주는 너야 솜털같이 부드러운 목소리로 귓가에 달콤히 사랑한다고 말해주면 너무 좋아나도 네가 좋아내 자기야 여보야 사랑아 너를 생각하면 어쩌면 꿈을 꾸는 같아내 자기야 여보야 하나뿐인 사람 나를 지켜줘 나를 빛나게 해줘요 사랑해요 사랑해요 가끔 토라질 때도 너의 따뜻한 눈 볼 때면 맘 상했나 울었었나 하는 나야 천사같이 다정한 목소리로 달래주듯이 예쁜 표정 지어 때면 너무 진심을 보여주는 자기야 여보야 사랑아 너를 생각하면 어쩌면 꿈을 꾸는 같아내 하나뿐인 사람 나를 지켜줘 빛나게 해줘요 사랑해요 곁에 있어도 내게 너는 꿈같아보는데도 보고 싶단 말들을 알 같아날 꿈꾸게 하는 사람이 세상 누구보다도 사랑스러워 감사해 함께라서 행복해 사랑아 너를 생각하면 어쩌면 꿈을 꾸는 같아내 하나뿐인 사람 지켜줘 빛나게 해줘요,0,1,13,3,16
77,당신의 나라엔 어둠이 내려도 조금도 무섭지 않네요 작은 별들 이곳으로 우릴 밝혀주죠 당신의 세상에는 천둥이 쳐도 하나도 겁나지 않네요 아름드리나무 커다란 키로 우릴 감싸주죠 그대를 믿고 있지만 자꾸만 떨리는 걸요 아직 손을 놓지 말아요 내가 눈뜰 때까지 너무도 아름다워요 초록빛 세상은 당신의 나라엔 어둠이 내려도 조금도 무섭지 않네요 작은 별들 이곳에 내려 우릴 밝혀주죠 내가 그곳에 가면 모두들 반겨줄까요 놀라지 않도록 나도 노력할게요 그대만 허락한다면 이곳에 남을게요 세상에는 천둥이 쳐도 하나도 겁나지 아름드리나무 커다란 키로 감싸주죠 나라엔 어둠이 내려도 조금도 무섭지 작은 별들 이곳으로 밝혀 주죠,0,1,2,0,2
78,귀여워 귀여워 웃을 귀여워 너무 귀여운 나만의 연인 그대 멋있어 멋있어 너무 멋있어서 가슴이 콩닥콩닥 뛰는 걸 두려워 두려워 너의 두 눈빛 빠져 버릴 거 같아 요즘 수영 배워 섹시해 섹시해 너의 쇄골뼈 키스해 주고 싶은 마음 둘만의 기념일 둘만의 냉장고 둘만의 사진들 비밀 거리 속삭임 와인 잔 커플룩 추억 얘기 이런저런 시시콜콜 반짝반짝 길들여진 이래저래 알퐁달퐁 샤방샤방 익숙해진 우릴 맞이했던 해변가에 옛 유행 노랠 흥얼거려 우릴 축하했던 바람 소리가 우릴 고조시켜 긴장돼 긴장돼 너의 모습들 그을린 구릿 피부 품에 안겨 샤방해 샤방해 목소리 컬러링으로 담고 싶은 이맘 기념일 냉장고 사진들 비밀 거리 속삭임 와인 잔 커플룩 추억 얘기 이런저런 시시콜콜 반짝반짝 길들여진 이래저래 알퐁달퐁 샤방샤방 익숙해진 맞이했던 해변가에 옛 유행 개그를 하며 축하했던 바닷소리가 고조시켜 라라라 라라라 기다릴게 달려와줘 달려갈게 기다려줘,0,1,4,6,10
79,매일 레몬티처럼 달콤한 입술 너에게만 주는 나의 선물 모르게 품 안에서 너와 하고 싶어도 언제까지 아침 햇살 가득한 오늘 널 만날 생각에 눈 뜨고 오마이 걸 네가 예쁘다던 옷 입고네 앞에 있는 나를 그려 너와 걷는 길에 발걸음 맞추다가 다가와네 눈빛에 마법에 취해 너의 입술에 살짝 레몬티처럼 달콤한 입술 너에게만 주는 나의 선물 모르게 품 안에서 너와 하고 싶어 언제까지나 너의 자기야 너의 여자가 되고 싶어 그늘 안에 날 숨긴 모든 멈추어 버린 순간 오마이 불 밝게 비추는 햇살도 환하게 웃어 날 향하고 시원한 바람에 날 실어 실어나의 미소에 너를 실어 다가와 사랑을 느끼면서 둘만의 특별한 키스 레몬티처럼 달콤한 입술 너에게만 주는 나의 선물 모르게 품 안에서 하고 싶어온 언제까지 위에 작은 떨림 부드러운 햇살 느낌 가슴속 깊이 사랑이 꿈결처럼 다가와 매일 싶어온 언제까지 매일 사랑 네게만 주고 싶어 언제나 곁에서 이렇게 영원히 사랑 꿈속에서도 영원히 아기가 되고 여자가 되고,0,1,10,-6,4
80,사랑해 저절로 네게 눈이 네가 입은 옷 무늬가 눈에 띄는 것도 아닌데 온종일 일을 하고 있는 중에도 사람 괜찮단 말이야 행동 하나하나에 내가 들렸다 놓였다 해 이리 자주 웃는 사람이 아닌데 돌아보면 당한 것도 많아 모든 하나하나 다 싫지만은 않아 사랑해 사랑해요 널 보는 날이면 둘만 만나는 날이 아닌데도 너에게만 잘 보이려고 막 사랑해 사랑해요 널 보는 날이면 둘만 만나는 날이 아닌데도 막 설레고 그런다니깐요 행동 하나하나에 내가 들렸다 놓였다 해 이리 자주 웃는 사람이 아닌데 돌아 보면 받은 많아서 포기할 수 없었어요 써요 나만 마시는 사랑이 넘쳐요 그대 잔에 따라주고 싶은데 당신이 내가 당신을 사랑한다고 말하기를 기다리고 있습니다 사랑해요 널 보는 날이면 둘만 만나는 날이 아닌데도 너에게만 잘 보이려고 막 설레고 그런다니깐요 사라 해 설레고 그런다니깐요,0,1,4,-2,2
81,라라라라 랄라라 너에겐 모든 걸 말해주고만 싶어져 어릴 적 나의 얘기와 지금의 생활들 품에 기대어 깊은 밤을 지날 기차를 타고 태양이 뜨는 바다에 갈 거야 너에게 주고 싶은 세 가지 빛바랜 나의 일기장 작은 나의 얘기까지 말하고 싶은 거야 너에게 주고 싶은 세 가지 바다로 가는 기차표 수줍게 전해 주고픈 너의 생일 첫 키스 가끔 날 보는 너의 맑은 눈이 말해 볼에 입 맞추고픈 너의 마음을 네게는 무엇도 부끄러울 것이 없어 다가올 생일에 키스할 거야 너에게 주고 세 가지 빛바랜 일기장 작은 얘기까지 말하고 바다로 가는 기차표 수줍게 전해주고픈 생일 첫 키스 빛바랜 일기장 작은 얘기까지 말하고 바다로 가는 기차표 수줍게 전해 주고픈 생일 첫 키스,0,1,2,1,3
82,아침에 눈을 뜨면 제일 먼저 생각이 생각이 얼굴이 생각이 거울을 바라보니 못생겼네 못생겼어 널 갖기엔 못생겼어 쿵쿵 대는 가슴이 말해 소릴 들어봐 살며시 라라라 멋진 음악 같아 아름다워하나 넷너무 많은 걸 하늘땅만큼 사랑해 라라라 말해볼게 내가 널 지켜줄게 달달한 솜사탕이네 맘처럼 구름 같아 구름 같아 맘처럼 구름 같아내 가슴 왼쪽에는 하루 종일 네가 있어 네가 있어 잠잘 때도 네가 있어 워쿵쿵쿵 대는 가슴이 말해 소릴 들어봐 살며시 라라라 멋진 음악 아름다워 넷너무 많은 걸 하늘땅만큼 사랑해 말해볼게 내가 널 지켜줄게 내가 꼭 안아줄게 평생을 다 바쳐서 너만을 사랑할게 워쿵쿵쿵 대는 가슴이 말해 하늘땅만큼 사랑해 말해볼게 지켜줄게 음 음 음 평생 사랑할게,0,1,5,-1,4
83,보다가도 웃어 샤워를 하다가도 웃어 내가 도대체 나에게 짓을 한 거니 온종일 웃는 병에 걸렸어 하늘이 저렇게 예뻤니 햇살이 저렇게 좋았니 대체 나에게 도대체 나에게 짓을 한 거니 사랑이란 원래 거니 당신은 나의 영화배우입니다 저만치서 네가 보이면 세상은 영화 속 같아 어쩜 그렇게도 환하게 웃을까느린처럼 멋지게 당신은 나의 노래 스타입니가 다니가 불러주는 이름 듣기 좋은 노래 같은 걸 항상 이렇게 날 사랑해줘 내가 너보다 많이 예뻐할 게나 내가 혹시나 영화의 주인공이라 고민할 만큼 행복에 웃어내가 이리 행복에 겨워도 되는 걸까 상관없어 일단은 너와 함께니까 어색할 때마다 늘 씽긋 쑥스러울 때마다 찡긋 대체 어디서 어디서 그렇게 예쁜 짓을 배웠니 남자들 원래 너처럼 귀엽니 당신은 스타입니다 하루 종일 너와 있으면 세상은 속 같아 때론 드라마처럼 로맨틱한 너와 코미디처럼 즐거운 나의 라디오 스타입니가 다니가 들려주는 얘기 들참 듣기 좋은 노래 같은 걸 항상 이렇게 날 사랑해줘 너보다 많이 예뻐할게 잘 생각이 않다 널 알기 전에 어땠는지긴 일요일 오후엔 무얼 했는지 잠 안 오는 밤엔 무얼 떠올렸는지나 자고 깨고 웃나 영화배우입니다 저만치서 네가 보이면 세상은 영화 속 같아 어쩜 그렇게도 환하게 웃을까느린처럼 멋지게 네가 불러주는 이름 듣기 좋은 같은 걸 항상 이렇게 날 사랑해줘 너보다 많이 예뻐할게,0,1,13,3,16
84,입안에서 바람 맛이 달콤한 아침 새하얀 이불 위로 닿는 햇살이 설레는 전화 벨 소리 그대인 가요 설탕 한 스푼 담긴 소리 안녕 안녕 봄이 와이 거리 위에 봄이 나의 가슴속에 이리 들뜨나 몰라오 팝콘 같은 꽃잎이 높이 날아요 사랑한다 말하면 녹아요 오늘 같은 바람이 불면 하루 종일 미치겠어 그대가 아른아른 거려서 향기로운 봄바람이 나풀거리고도 볼에 앉은 햇살마저 완벽한 걸 요새 하얗게 춤을 추는 꽃잎을 보며 그대와 둘이 걷다 보면 봄이 와이 거리 위에 와우리 사이에 설렘이 피어올라요 팝콘 같은 꽃잎이 높이 날아요 사랑한다 말하면 녹아요 오늘 바람이 불면 하루 종일 미치겠어 그대가 아른아른 거려서 꿈에서 봤던 거리가 여기인가요 그대와 나란히 걷는 모든 곳이 아름다워 있잖아요 그대를 볼 때마다 놀라 아름다울 수 없는 그대여 따사로운 봄빛에 사랑이 녹아요 살랑대는 바람에 사랑이 불어요 오늘 바람이 불면 제일 먼저 떠올라요 그대만 팝콘 꽃잎이 높이 날아요 사랑한다 말하면 하루 종일 미치겠어 그대가 아른아른 거려서 나의 봄이죠,0,1,7,4,11
85,떨리는 맘 고마운 맘 가득히 담아서 젤 예쁜 포장 속에 전하고 싶은데 아닐 거야 웃을 거야 엉뚱한 상상 매일 미루는 바보 같잖게 늘 웃던 모습 네가 맘 훔친 거 정말로 너무 말도 안 되는데 베이비 베이비 베이비 제발 그대가 안에 너무도 깊이 들어와 보일까 수줍은 고백 살며시 다가가 작은 목소리로 가까이 너만 들리게 말해줄 답답한 미안한 전해 매일 쌓여가는 선물 전하고 싶은데 아닐 거야 싫을 그냥 날 편한 친구 이상은 절대 아냐 어째 늘 웃는 모습 훔치고 싶어 정말로 너무 들려주고 싶어 제발 그대가 안에 너무도 깊이 들어와 보일까 수줍은 고백 살며시 다가가 부드러운 눈웃음으로 너의 맘에 스며갈 사실 너도 알 걸 다가가지 못하는 날 어느샌가 나에게 다가오고 있는 걸 포근한 품으로 날 꼭 안아 줘 어울워 제발 그대가 안에 너무도 깊이 들어와 보일까 수줍은 고백 살며시 다가가 작은 목소리로 가까이 너만 들리게 말해줄 내가 그대 소중한 사랑만으로 가득히 채워 놓고 싶은 걸요 이제는 그대의 누구도 부럽지 않을 가장 예쁜 여자친구야,0,1,8,2,10
86,안녕하세요 원더 랜드의 소녀 찾으러 갈까 뭔가 특별한 무도 회장에 한 단 계발을 맞춰봐 설레는 맘에 몸을 맡겨도 돼웃어 자연스럽게 빙글빙글 돌아 뭐 어때즐거워하는 네가 있기에 서로의 곁에 기대봐 아침이 밝아 와도 오늘도 내일 도난 너와 함께해 베이비 당신은 나의 행운의 스타입니다 날 웃게 한 한 사람 널 향해 피어난 향기로운 꽃녀 하나만 가까이 곁에 있어준다면 아기 아기 완전히 신세계 우리가 찾아낸 꿈 아껴온 너의 가슴에 타오른 아직 아직 이른 계속해 나를 불러줄래 빛이 길 너만을 향해 지금 까만 밤 빛을 내며 이끌어줘 수행원 하늘의 별을 너에게로 수행원 행운의 단 서로 겹쳐보는 마음과 영혼 시선이 마주쳤을 비밀스레 키스를 할 누구도 부럽지 않아 하늘에 밝게 빛나는 별처럼 영원히 너만을 환하게 비출게 베이비 당신은 나의 행운의 스타입니다 곁의 단 사람 널 향해 춤추는 마음은 꽃 영원토록 이렇게 나와 있어준다면 아기 완전히 신세계 너만을 이유 모를 벽에 부딪혀도 이겨낼 수 있을 거야 분명 그때는 달라진 모습을 만나게 될 거야 베이비 당신은 나의 스타입니다 날 웃게 사람 널 피어난 향기로운 꽃녀 하나만 가까이 곁에 있어준다면 완전히 신세계 우리가 찾아낸 꿈 우리만의 천국 우리가 찾아낸 꿈,0,1,9,-4,5
87,외로운 날들이여 다 안녕 마음속에 눈물들도 이제는 안녕 어제의 너는 바람을 타고 멀리 후회도 없이 미련 없이 날아가 굿바이 오오 영원히 워오오거울에 비친 너의 모습이 슬퍼 늘 웃음 짓던 예전의 넌 어디에 있니 파란 하늘 눈부신 별들도 다 너를 위해 있잖니 안에 일은 없던 아픈 기억 버려야 할 눈물짓지 마 새로운 오늘을 맞이할 준비를 해봐 오오 외로운 날들이여 다 안녕 마음속에 눈물들도 이제는 어제의 너는 바람을 타고 멀리 후회도 없이 미련 날아가 굿바이 오오 영원히 워오오슬프게 내린 비는 꽃을 피우고 너의 눈물은 예쁜 사랑을 피울 거야 슬퍼하지 마 새로운 오늘을 맞이할 준비를 해봐 햇살 가득한 날들이여 긴 잠에서 날 깨워준 아침이여 오너의 유리처럼 맑은 미소가 세상을 환히 웃음 짓게 할 거야 외로운 마음속에 눈물들도 이제는 어제의 너는 바람을 타고 멀리 후회도 미련 날아가 햇살 가득한 긴 잠에서 날 깨워준 아침이여 오너의 유리처럼 맑은 미소가 세상을 환히 웃음 짓게 할 거야,0,1,0,0,0
88,아침 일찍 일어나 조깅 저녁 여섯시 후론 금식 이제부터 달라질래 새로운 모습을 보여줄래 처음으로 길러본 손톱 외출할 땐 굽 높은 하이힐 그댈 위해 변할 거야 동생 아닌 예쁜 사람으로 동생 아닌 예쁜 연인으로 맞습니다 어린애처럼 대하는 그대가 미워 오래된 사이라 해도 어릴 적 모습 지울 수 없나요 나도 여자랍니다 그대 곁에 있을 때면 부드럽고 약해지는 마음 누구를 사랑한다면 다 그렇잖아 꼭 갖고 싶어 그대의 마음눈을 크게 뜨고 다시 봐요 멀리서 찾지 말아 줘 그대 사랑은 전화할 땐 자기야 애칭 토라질 땐 눈 웃음 애교 좋을 거야 새로울 거야 그대 나의 연인이 된다면 어린애처럼 대하는 그대가 미워 오래된 사이라 해도 어릴 적 모습 지울 수 없나요 나도 여자랍니다 곁에 있을 때면 부드럽고 약해지는 마음 누구를 사랑한다면 다 그렇잖아 꼭 갖고 싶어 그대의 마음눈을 크게 뜨고 다시 봐요 멀리서 찾지 말아 줘 사랑은 힘이 때면 기대고 싶은 한사람 내게는 그대뿐인걸 내가 잘못해도 그댄 내편 돼줄 거죠 그댈 사랑합니다 높은 하늘만큼 너무 오래 애태우지 말고 비워둔 대자리로 빨리 돌아와 말하고 싶어 오랫동안 숨겨왔던 나의 비밀 하루에 하나씩 꺼내 매일 전할게 사랑해,0,1,8,0,8
89,마시멜로 말랑말랑 말랑말랑해넌 특별해 완벽해 비교 분석해봐도 애들과는 다르지 달라 달라 소년 한심해 부족해 너에게서 떨어져 오바마 보기만 하는 바보지 내가 이럴까 너만 생각하 다라 랄라 랄라라 날아올라 어떡해 뚜벅뚜벅 네가 걸어와 불라 불라 얘기를 하지 말을 해도 들리지가 않아 째깍째깍 시간이 멈추다 마시멜로 마시멜로 달콤해서 너무 사랑이란 걸 까말랑 말랑말랑해 너무너무나 말랑해 소녀 여자 아기 소녀 박수 준비된 소녀 박수 젤리처럼 통통해 쿠키처럼 촉촉해 소년 소년 아기 소심해 고민해 너를 떠올릴 때면 얼굴이 새빨게지는 아이인 걸 내가 이럴까 너만 상상하다라랄라랄라라 날아올라 어떡해 두근두근 네가 다가와사귀자고 대시를 하지 어떡해 너의 목소리만 듣고 싶어 가만가만 다 쉿마쉬멜로우 달콤해서 너무 사랑이란 걸 까말랑 말랑말랑해 너무너무나 말랑해 여자 아기 박수 준비된 젤리처럼 통통해 쿠키처럼 촉촉해 꿈을 꿨나 눈을 뜨니까 거짓말처럼 다 사라져난 만날 거야 다시 잘 거야 몰라 달콤해서 너무 사랑이란 까말랑 말랑말랑해 너무너무나 말랑해 여자 준비된 젤리처럼 통통해 쿠키처럼 촉촉해 보이 마르 슈 멜로우,0,1,-3,8,5
90,하나는 하나의 셌나의 잠을 깨운 매일 반복되는 소리 오늘도 가슴 떨려오는 나의 질주 운임 좋은 행운의 날 이요 매일 원해 오늘도 달릴 거야 하이웨이 오랜 기다림은 안녕아 아우야 아우야 아우 아아 언제라도 좋아시원한 월에 노랫소리 상쾌한 바람과 귓가를 간지럽히는 바람은 좋은 행운의 날 이요 매일 원해 오늘도 달릴 거야 하이웨이 오랜 기다림은 안녕아 아우야 아우 아파 운이 좋은 행운의 날 이요 원해 달릴 거야 하이웨이 오랜 기다림은 안녕 행운을 빕니다 안녕하나 두 개는 두,0,1,5,3,8
91,툭하면 아침 빈속 커피 부지런하면 좋잖아웃으면서 대답은 해도 지키지 못할 약속 툭하면 건너뛰는 식사 뺄 살이 있니 이대로도 예쁘다 해도 못 믿겠다는 표정 넘어지지 마세요 있어도 고민하지 말고 점점 서로 걱정만 해내가 당신과 사랑에 빠질 덜렁대는 너의 습관 주변 사람 많은 성격 넌 순수해 너무 순진 해이 험한 세상 살래 넘어지지 마세요 있어도 당신의 말을 속삭입니다 고민하지 말고 점점 서로 걱정만 해 내게 기대 자정에 당신의 사랑을 속삭이십시오 점점 생각만 해내가 당신의 팔에 당신을 사랑하고 당신이 당신이 사랑한다고 말하고 싶을 당신은 당신이 사랑에 대해 말하는 것을 원한다고 말합니다 사랑을 느낍니다 지금 당신을 생각합니다 지금 당신을 생각하지만 꿈속에서 당신은 나를 걱정하고 팔에 나를 알고 있고 사랑에 대해 말하는 것을 원한다고 말해줘,0,1,3,1,4
92,말해야 하는데 앞에 서면 아무 말 못 하는 내가 미워져 용기를 내야 해 후회하지 않게 조금씩 너에게 다가가날 고백해야 해 오래된 친구인 널 좋아하게 됐나 봐아무렇지 않은 널 대해도 마음은 늘 떨렸어 미소 짓는 너를 보면 사이가 어색할까 두려워아무런 말 하지 못한 채 돌아서면 눈물만 흘렸어 말해야 하는데 앞에 서면 아무 말 못 하는 내가 미워져 용기를 내야 해 후회하지 않게 조금씩 너에게 다가가날 고백해야 처음 너를 만났던 날 기억할 순 없지만 그런 친구로 생각했고 지금과는 달랐어 미소 짓는 너를 보면 사이가 어색할까 두려워 하루 종일 망설이다 헤어지면 눈물만 흘렸어 말하고 싶은데 사랑한다고 아무 못 하는 내가 너무 미워 용기를 내야 후회하지 않게 조금씩 너에게 다가가날 고백할 거야 고백할 거야 사랑한다고 너무 미워 고백할 거야,0,1,0,4,4
93,아침에 눈을 뜨면 생각이 창밖을 바라보다네 생각이 그렇게 멍하니 하루가 흘러가 너도 날 가끔씩은 떠 올릴까 생각이 어느새 주변의 모든 건 익숙한 향기로 너에게 물들어 화초에 꽃이 피어네 예쁜 걸 볼 때마다 취향은 아니지만 네가 좋아하는 노랫말 하루 종일 흥얼거려 사랑이 내게도 찾아왔나 어느새 주변의 모든 건 처음 보는 색으로 맘처럼 피어나푸르던 하늘에 무지갯빛이 나갈라 진 골목길도 모네의 그림 같아이렇게 변한 나를 내가 봐도 우습기만 어쩔 수 없나 하루 종일 바보처럼 그렇게 멍하니 하루가 흘러가 아침에 눈을 뜨면 양치를 하다가도 그렇게 멍하니 하루가 흘러가 너도 날 가끔 떠올릴까네 화초에 꽃이 피어네 커피를 마시다가 이렇게 변한 나를 내가 봐도 우습기만 어쩔 수 없나 봐온 종일 바보처럼 나네 나오,0,1,5,0,5
94,하늘을 닮은 너의 눈빛이 나를 비춰 당신은 햇빛과 같습니다 바라보고 있는데도 아기를 그리워하고 집에 데려가고 싶어 보내기 싫은 걸 오늘 너와 베이비 사랑 아기 아기 사랑 사랑 사랑이건 사랑을 사랑하십시오 너야 아기 모든 순간이 이것은 내가 당신과 사랑에 빠질 때입니다 사랑해 시도 때도 없이 그냥 막 항상화를 내는 모습조차 너는 너무 귀여워라고 말하면 화내겠지 체리처럼 탐스러운 입술이 날 유혹해는 당신을 집으로 데려갑니다 오늘 밤 너는 사랑을 훔쳤다 입건 사랑을 사랑하십시오 너야 모든 순간이 이것은 내가 당신과 사랑에 빠지는 때입니다 내게 힘이 돼준 널 사랑해 때론 나도 힘들어 위로받고 싶어져 아무 말 없이 뒤에서 안아주던 내가 가장 좋아하고 잘 하는 걸 나보다도 아껴줘서 그것은 마법처럼 일어났습니다 네가 옆에서 계속 최고 같대서 원한 것이 됐어 빼면 다 재로 변하겠지 당신과 있을 최선을 다하고 있습니다 넌 마음이 하얀색이라서 다 널 귀여워만 당신은 모든 것보다 똑똑합니다 넌 이상형 감사하지 너와 하는 매일이 이건 사랑에 빠지면 사랑이건 사랑하십시오 너야 순간이 이것은 빠질 때입니다 사랑해 시도 때도 없이 그냥 막 항상 네게 빠지는 순간,0,1,5,-1,4
95,오왜 표정이 안 하늘이 노랗게 변해 다시 날 보고 웃어주면 세상은 다시 파랗게 번져 어디서 적색경보 울려 꼼짝 말고 서서 눈치 살펴 그러다 민트빛 미소에 세상은 물들어가 눈이 마주친 순간 나의 심장은 다시 뛰고 눈 속 내가 빛을 찾아가 내가 잘 못 본 걸까 너의 손이 닿는 순간 주변 모든 것이 물들어 하얗게 차갑게만 얼던 세상에 눈이 멀어가던 순간 당신은 인생을 화려하게 만들고 당신이 마법 같은 같아요 당신이 훌륭하다고 생각합니다 너로 인해 맘은 화려한 까맣게 어둡기만 하던 세상에 눈을 감으려던 당신은 인생을 화려하게 만들고 스펙트럼 킥 드럼을 볼 수 있습니다 보다 쿵쿵대는 심장이 네게 미끄럼 타듯 내가 가장 좋아하는 컬러 핑크가 되라 내게 너란 색을 덮자 무지 티 위 무지개를 덮어 노을 진 바다 위색을 입혀 네가 담은 풍경은 무엇보다 따스해 지금 널 느끼고 온 바람을 마주해 눈이 마주친 나의 심장은 뛰고 눈 속 빛을 찾아가 잘 못 본 걸까 너의 손이 닿는 주변 모든 것이 물들어 하얗게 차갑게만 얼던 세상에 멀어가던 당신은 인생을 화려하게 만들고 당신이 마법 같은 같아요 훌륭하다고 생각합니다 너로 인해 맘은 화려한 까맣게 어둡기만 하던 눈을 감으려던 잘 못 본 걸까 너의 손을 잡은 세상 모든 것이 물들어 이렇게 초록 향기 짙은 두 손을 마주 잡은 손이 닿는 주변 물들어하얗게 차갑게만 얼던 멀어가던 만듭니다 너로 인해 맘은 화려한 까맣게 어둡기만 하던 눈을 감으려던 만들어 만듭니다,0,1,7,0,7
96,당신은 내가 당신을 사랑한다는 것을 알고 있습니다 사랑해 나도 친절한 입술 다정한 말투 언제나 감싸는 들나는 변화가 없다 그날처럼 변함이 없네 꿀 같던 한여름밤 생생히 다 기억해 우리는 힙합을 좋아했고 한쪽씩 투팍을 나눠 들었네 병처럼 혈액형을 믿어 거울을 보는 같아 거울이 필요하지 않습니다 너와 만난 건 짜인 각본처럼 싹 예술이었어 인정 달고 나처럼 우린 달구나 덥지만 깍지 낀 손 수줍게 입에서 널 맛보다 얼음처럼 녹여 녹여서 씻겨줄게 당신은 내가 당신을 사랑한다는 것을 알고 있습니다 사랑해 나도 친절한 입술 다정한 말투 언제나 감싸는 들여보세요 어디야 그냥 집에 있어 날씨도 좋은데 한강은 준비 안됐어도 전부다 괜찮아알잖아 제일 좋아하는 조립 맨얼굴 반진 셔츠 선글라스 모든 커플 눈치 없는 한 쌍 나가신다 당신은 문제를 원하지 않습니다 한 손에 추로스 딴 손 아이스크림 이러니 살을 뺄 수 없지 투덜대지만 당신이 그것을 사랑한다는 것을 압니다 달고 나처럼 우린 달구나 덥지만깍지 낀 손 수줍게 입에서 널 맛보다 얼음처럼 녹여 녹여서 씻겨줄게 내가 당신을 알고 있습니다 사랑해 나도 친절한 입술 다정한 말투 언제나 감싸는 팔들 가자 가자 가자 생일 기념일 발렌타인 크리스마스 새해 복 많이 받으세요 다시 여름 처음 같아 앞으로 계속 반복돼도 좋을 사진을 참조하십시오 이맘 즈음 맥주 한잔하며 찍은 우린 이렇게 될 알았을까 사진 속 행복하게 웃고 있는 그런 널 보며 행복하게 웃고 있는 날 달고 나처럼 달구나 덥지만 깍지 낀 수줍게 입에서 맛보다 얼음처럼 녹여 녹여서 씻겨줄게,0,1,7,-1,6
97,나와 있을 땐 음악을 꺼 나와 대화를 해줘 달링 핸들처럼 요리조리 끌고 가지는 말아요 너와 있을 음악은 분위기 살해 키스하기 전의 간식 아무것도 넌 모르면서 그냥 나를 믿고를 따르십시오 안에 맥주 대신 나의 사랑을 남아 서로의 옆자린 서로만이 앉아만 사랑 나와 있을 시선 고정 나만 바라 보라고요 운전은 나를 위한하게 코너링 미소는 숨겨진 카드 사랑한단 말의 디저트라고 백미러의 시선은 널 지키기 위한 눈빛 당신은 나를 믿습니다 항상 곁에 있어줘요 항상 곁에 있을게요 항상 품에 잠들어요 품에 잠들게요 트렁크 안에 맥주 대신 나의 사랑을 남아 서로의 옆자린 서로만이 앉아만 사랑 너를 원해 너를 원해 너를 원해 만나 요다음에 꼭 만나 꽃다발을 준비할게 만나 요다음에 꼭,0,1,1,0,1
98,안녕 쉽지 않죠 바쁘죠 이렇게까지 해야 싶죠 바라는 더럽게 많죠그렇죠쉬고 싶죠 시끄럽죠 성가 시죠 집에 가고 싶죠 집게 있는데도 집에 가고 싶을 거야 그럴 땐 노래를 초콜릿처럼 꺼내 먹어요 피곤해도 아침 점심밥 챙겨 먹어요 이따 내가 칭찬해줄게요 보고 싶어 많이 좋아해요 많이 안아주고 싶어요 사랑 사랑 비슷한 걸 어쩌면 사랑해요 배고플 땐 노래를 아침 사과처럼 꺼내 먹어요 피곤해도 아침 점심밥 챙겨 이따 밤에 잠도 잘 올 거예요 힘들어요 아름다워서 알아봐 줘요 나를 흘려보내지 마요 나를 사랑해줘요 날 날 놓치지 마요,0,1,7,-4,3
99,안녕 소녀 안녕하세요 오늘 기분 어때요 이렇게 만나게 돼서 설레요 먼저 편하게 앉으면 돼요 앉아 여자 이완 걸 긴장할 필요 없죠 니와 함께라면 이제 시작해 볼까요 당신의 이름은 무엇입니까 그댈 알고 싶죠 자연스러운 척해도 아닌 척해도 사실 준비 많이 해왔죠 당신은 너무 보인다 그대도 알고 있죠 자연스러운 척해도 아닌 사실 그대가 좋은걸요 인터뷰 인터뷰 인터뷰를 시작합시다 묻고 싶은 너무 많은 걸 사실 그대의 모든 다 궁금해요 먼저 눈 맞춰볼까요 세상에 너무 아름다워 표현할 말이 없죠 할까요 그렇게 웃는 거 예뻐요 당신의 이름은 무엇입니까 그댈 알고 싶죠 자연스러운 아닌 준비 많이 해왔죠 당신은 보인다 그대도 있죠 그대가 좋은걸요 실례가 좋을 텐데 불편하지 않았다면 좋을 텐데 내가 싫지 않다면 내가 궁금하다면 베이비 질문 하자 그댈 싶죠 준비 많이 해왔죠당신은 보인다 그대도 있죠 그대가 당신의 이름은 무엇입니까 해왔죠 당신은 좋은걸요 인터뷰 인터뷰를 시작합시다,0,1,6,-7,-1
100,상쾌한 기분이죠 하늘이 좋아요 오늘은 바람 내음도 향기롭네요 좋은 일이라도 생길 같은 오랜만에 기분 좋은 날이죠 매일 같은 자리에 사람이 있네요 오늘따라 나를 바라보네요 주문이라도 외운 것처럼 사람이 나를 향해 오네 요거 봐요 내가 그랬잖아요 오늘은 기분 좋은 일들만 생길 거라고 어쩐지 햇살조차 눈부신 사랑하기 날이죠 당신은 사랑입니다 당신의 포옹에 당신의 키스를 생각하는 것은 나에게 모든 것을 의미합니다 유난히 바람조차 달콤한 사랑하기 날이죠 사람이 웃네요 나를 보고 웃네요 이렇게 환한 미소도 오랜만이죠 그동안 상상했었던 많은 일들이 마법처럼 내게 일어나네 요거 봐요 내가 그랬잖아요 오늘은 기분 일들만 생길 거라고 어쩐지 햇살조차 눈부신 사랑하기 당신은 사랑입니다 당신의 포옹에 키스를 생각하는 것은 나에게 모든 것을 의미합니다 유난히 바람조차 달콤한 걸렸나 봐요 행복 바이런스에 모든 것이 예쁘게만 보이 직도 망설이고 있나요 지금 그대 손을 내밀어 요거 내가 그랬잖아요 일들만 거라고 뭐든지 상상하기만 하면 다 이뤄질 수 있는 그런 당신은 사랑입니다 포옹에 키스를 생각하는 것은 나에게 것을 의미합니다 믿어요 날 눈을 뜨면 다 예쁘게만 보일 거예요 그날이,0,1,11,2,13
101,이슬비가 내리는 오늘은 사랑하는 그대의 생일날 온종일 그대를 생각하면서 무엇을 할까 고민했죠 가까운 책방에 들러서 예쁜 시집에 맘 담았죠 그다음엔 근처 꽃집으로 가서 빨간 장미 한송일 샀죠 내려오는 비를 맞으며 그대에게 가는 길 너무 상쾌해 품 속에는 장미 한 송이 책 한 권과 그댈 위한 깊은 사랑 아름다운 그대를 만난 건 하느님께 감사드릴 우연 작은 맘 알아주는 그대가 있기에 세상이 행복해 가까운 책방에 들러서 예쁜 시집에 맘 담았죠 그다음엔 근처 꽃집으로 가서 빨간 장미 한 송일 샀죠 내려오는 비를 맞으며 그대에게 가는 길 너무 상쾌해 품 속에는 송이 책 권과 그댈 위한 깊은 사랑 아름다운 그대를 만난 건 하느님께 감사드릴 우연 작은 알아주는 그대가 있기에 세상이 행복해 너무너무나 행복해 생일 축하합니다,0,1,8,-1,7
102,좋아해 너무 달지 않은 라떼비 갠 거리로 가볍게 나서는 산책 번이나 본 로맨틱 코미디 보기 좋아해 차가운 녹차 맛 아이스크림 문득 떠나는 하루짜리 짧은 여행 햇살 좋은 날 무심코 들어선 미술관 너의 곁 지낼까 정신없이 살다가도 거짓말처럼 막 보고 싶고 너의 곁에선 하루가 짧았었는데 기억하니 언제나 둘이던 그리운 시간들 돌아가고 싶은 한때 떠올리다 보면 어느새 웃곤 해좋은 일들만 너의 옆에 가득하기를 바랄게 널 좋아해 널 널 미안해 너를 지켜주지 못해 끝까지 사랑해주지도 못해 미안해 맘 나도 모르겠어 이제 끝난 건데 대체 아직도 가슴이 안에 네가 가득한데 다시 돌아가는 것은 안돼널 피하네 그게 진심은 아닌데 피하네 미안해 아직 너를 좋아해어떻게 지낼까 정신없이 살다가도 거짓말처럼 막 보고 싶고 곁에선 하루가 짧았었는데 기억하니 언제나 둘이던 그리운 시간들 돌아가고 싶은 한때 떠올리다 보면 어느새 웃곤 해좋은 일들만 옆에 가득하기를 바랄게 한참이 지나도 변하지 않는 것이 있나 함께한 시간들이 생각 나니가 알던 있나 목소리 날 흔들어 놓나 자꾸만 코 끝이 찡해 오네 너를 기다리나 봐난 기다리나 지낼까 정신없이 살다가도 거짓말처럼 막 보고 싶고 곁에선 하루가 짧았었는데 기억하니 언제나 둘이던 그리운 시간들 돌아가고 싶은 한때 떠올리다 보면 어느새 웃곤 해좋은 일들만 옆에 가득하기를 바랄게,0,1,5,-1,4
103,오늘도 슬쩍슬쩍 바라만 보고 있네 벌써 번째인지 몰라 사랑에 빠진 같아 사랑에 빠져 버렸어 이번엔 같아 같아 같아진지 놀리 면안 돼요 두근거리는 가슴 진지해요 사랑에 빠진 딸기야 날 웃음 질 수 있게 해줘요 조금씩 살금살금 주문을 걸고 있네 날 돌아볼지도 몰라 상상만으로는 안돼 상상은 안 돼 그건 안 돼 오늘은 말해볼 거야 말해볼 거야 진짜 고백할 거야 진지해요 놀라지 말아요 빨개지는 볼 진지해요 빠진 딸기야 날 웃음 질 수 있게 해줘요 딸기야 웃음 질 수 있게 해 줘요,0,1,0,-5,-5
104,방 가득 채우며환희 웃던 맷데이먼그의 신작 영화도뉴스거리 아니지첨엔 잘 몰랐었던너의 환한 미소가이미 나의 마음 속을온통 사로잡은 걸 는 나의 슈퍼 슈퍼 스타입니다나를 비춰 주는 걸당신은 슈팅 슈팅 슈팅 스타입니다내가 쏘아 올린 별 중가장 빛나는 별당신은 빛나고 있습니다내 마음 속의 별듣기 싫었던시끄러운 너바나이젠 나도 모르게자꾸 흥얼거려져첨엔 많이 달랐던너와 나의 취향들이젠 늘 해도마냥 즐겁기만 해 는 슈퍼 스타입니다나를 비춰 주는 걸당신은 스타입니다내가 쏘아 올린 별 중가장 빛나는 별당신은 스타드 레밍을 빛나고 있습니다꿈꿔오던 별 나를 비춰주는 걸당신은 스타입니다내가 쏘아 올린 중가장 빛나는 별놀라운내 마음 속의,0,1,3,-3,0
105,나와 와서 사랑하는 나와 오세요 그대 곁에 없을 때면 숨 쉬는 호흡 소리까지다 생각 나도 눈을 감고 열을 세면 어둠 속에서 불꽃처럼 떠올라 아기가 손을 잡아 나와 깍지 껴요 아기가 손을 잡아 도망가지 마요 너와 와서 사랑하는 오세요 작은 손잡고 걸을 때면 놀이동산에 기뻐서 들뜬 애 같아 그대와 짧은 밤을 새우면 뜨는 태양을 피해서 달아나고 파내 아기가 손을 잡아 깍지 껴요 제발 도망가지 마요 너와 와서 사랑하는 세 요시 간의 흐름 속에서 열정은 녹슬겠죠 사랑은 빛나고 아름다울 거예요 그대 내게 던지는 미소 이성과 본능의 끝없는 시소네가 딴 남자에 관심 가질 때면 화가 입에선 삐 소리의 음 죄송합니다 도망가지 마나에게서 멀리 걸어가지 마세요 내가 살게 두 잔의 진 토닉 짠해 우리의 플라토닉 사랑 오늘따라 예뻐난 너만 보면 웃음이 헤퍼져 매끈한 몸매 눈에 밥 주네 널 가졌으니 이미 갑부네 넌 느낌 눈이 고와 넌 나의 아이돌스타 당신은 보아보다 낫습니다 심장에 불이 붙어 이성은 코마 상태 지금 초만 키스해보아 오세요,0,1,3,-2,1
106,괜히 눈뜨면 오늘도 그대 나에게 남겨둔 흔적들 뚜룻뚜잠에 취한 귓가에 들리는 그대의 노랫소리 졸린 두 눈을 비비면 어느새 내게 다가온 그대 향기 뚜룻뚜같은 아침 같은 하늘 아래서 여전한 얼굴로 여기요 너와 들려온 세상의 모든 소리가 내게 남아 이렇게 벅차게 빛나는 사랑이었음을 알죠에 직 게으른 열두시 왠지 때늦게 비치는 오후 햇살 뚜룻뚜달콤하게 귓가에 흐르던 그날의 속삭임 여기요 너와 들려온 세상의 모든 소리가 내게 남아 이렇게 벅차게 빛나는 사랑이었음을 기억하지 않을 먼 발자국이라도 타는 노을 메아리처럼 노래가 널 부르네 오너와 들려온 세상의 모든 소리가 남아 이렇게 벅차게 빛나는 사랑이었음을 알죠 랄라 라라 랄라 라 랄랄라라 라 라라라라 랄라 랄랄라 랄랄라 랄랄라 랄 랄랄라라 라라라라 라라 라 랄랄라라 라라라라 랄,0,1,3,5,8
107,일요일 싱그런 햇살이 응창 넘어 테이블 위로 따뜻이 내려앉아 오늘 너무도 기다린 약속인 걸요 사랑스러운 향긋한 커피와 응부드런 아침 담아 너만을 위해 베이비 낯익음에 안 하던 콧노래가 마음 가볍게 사랑에 빠진 것만 같아요 즐거워 맘은 짜릿하죠 그대 웃음과 장난들 떠올릴 때면 외롭지 않아이런 기분을 노래하죠 노래가 들리나요 동화 속 주인공처럼 그게 나인 것처럼 행복을 노래하죠 모든 일만 귀에 익은 발소리 느낌만으로도 그대 알 수 있는 걸 맘 그대도 알고 있는지 궁금해 사랑스러운 날 향한 눈웃음 오늘도 청바지에 하얀 운동화 베이비 가슴 뛰게 하는 얼굴은 아닌데 웃음이 사랑에 빠진 것만 같아요 즐거워 맘은 짜릿하죠 그대 웃음과 장난들 떠올릴 때면 외롭지 않아이런 기분을 노래하죠 노래가 들리나요 동화 속 주인공처럼 그게 나인 것처럼 행복을 평생 마주할 맛있는 매일 아침 따뜻하게 해줄게요 그대만을 맘은 짜릿하죠 웃음과 장난들 떠올릴 때면 외롭지 않아이런 기분을 노래가 들리나요 동화 속 주인공처럼 그게 나인 것처럼 행복을 매일,0,1,7,3,10
108,설레는 바람결에 가벼운 발걸음 너무 기분 응한 멋을 내고서 거릴 거닐어어때 근사하잖니 잘 지금뿐이야 나를 바라봐봐 당신이 저를 제발 원한다고 말해주세요 내게로 아무 생각 하지 말고 느끼는 그대로 머뭇거리니 가까이 다가 와봐니 맘을 보여줘 제발 제발 하얀 셔츠를 입고 환히 웃는 널 보면 너무 기분 음 조금은 어색해도 그건 문제가 안돼 눈이 가는 걸 잘 널 향한 맘을 보여줄게 당신이 저를 원한다고 말해주세요 내게로 아무 생각 하지 말고 느끼는 그대로 머뭇거리니 가까이 다가와 바니 맘을 보여줘 저를 내게로 아무 생각 하지 말고 느끼는 그대로 머뭇거리니 가까이 다가 와봐니 보여줘 다가 와봐니,0,1,4,-3,1
109,그대와 둘이서 어딘가 남쪽 끝섬에서 쨍쨍한 태양에 불타고 시원한 바람에 춤추고 야자나무 그늘 밑에서 뽀뽀하고 싶소 소나기가 지나갔으면 무지개색 칵테일 건배 달콤한 향에 취하고 라디오 소리에 숨 쉬고 그대 허벅지에 엎드려 낮잠 자고 싶소 얼음 장수 아저씨 안녕 핑크색 구름 빙글빙글 빛나는 향기의 그대와 예쁜 포즈로 사진 한 컷 시계가 멈춘 낙원에서 눈을 감고 싶소 네온사인들 눈이 부셔 별빛은 보이지도 않네 도대체 어디서 꿈꾸나요 빌딩 숲속 허수아비 그대와 둘이서 어딘가 남쪽 끝섬에서 쨍쨍한 태양에 불타고 시원한 바람에 춤추고 야자나무 그늘 밑에서 뽀뽀하고,0,1,3,5,8
110,눈부신 눈부신 햇살을 닮았죠 맘에 찾아온 나만의 그대는 그래요 그댈 생각하면 언제나 힘든 하룬 행복으로 느껴지니까 맘이 보이질 않나요 이제는 내게 기대봐요 그대가 쉴 그늘이 돼줄게요 사랑 제발 사랑 말해줘 제발 사랑을 가지 마 삶의 마지막까지 그댈 사랑할게요 그대의 환한 미소로 내게 대답해줘 간 주 중 맘이 보이질 않나요 이제는 내게 기대봐요 그대가 쉴 그늘이 돼줄게요 사랑 제발 말해줘 사랑을 가지 마 삶의 마지막까지 그댈 사랑할게요 그대의 환한 미소로 대답해줘 말해줘 사랑을 가지 마 무엇도 두렵지 않아 그대만 있다면 그대의 환한 미소로 받아줘 나의,0,1,5,-1,4
111,내가 이러죠정말 이상하죠그대가 없인하루가 너무 길어요날 사랑한 사람은많이 있었지만언제나 내겐귀찮은 일이었는데사랑을 받는것만익숙했던 나그대 내게 뭘했길래내가 달라질까나조차 궁금하지만난 사랑에 빠졌죠나밖에 모르던그 못된 내가나보다 그댈 생각해요한사람에게만이렇게 하려고그랬나봐요아껴둔 맘을받아요나 어제는 말예요관심도 없었던남자 옷들을고르는 날 발견했죠꼭 배우지 않아도사랑은 이렇게날 바꾸네요그대만 생각하게사랑을 받는것만익숙했던 나이젠 주고 싶어그대에게만은그대도 나와 같나요난 사랑에 빠졌죠나밖에 모르던그 못된 내가 나보다그댈 생각해요한 사람에게만이렇게 하려고그랬나봐요아껴둔 맘을받아요이별이나 말은 없겠죠 나에겐 첫사랑인데혹시 사랑이 깨지면이젠 다시는 사랑을못하게 될지도난 몰라요 난사랑에 빠졌죠 사랑에 나밖에 모르던 그러던 내가그 못된 내가나보다 그댈 생각해요그래요그대에게만 그대에게만 이러려고 그랬나요 오아껴둔 맘을 받아요난 빠졌죠나밖에 모르던 나보다 그댈 생각해요,0,1,2,1,3
112,나를 나를 나를 날 바라봐 바라봐 바라봐 너를 본 마음속에 사랑이 본능이 고백 빨리 하라 해 주위를 둘러싼 수많은 경쟁자 당신을 위한 군인입니다 멘트 장전 발사하기 전에 제군들 입 풀었나 완전 간장콩장콩장장 간 공장장 준비 다 아침이 깨는 소리 아침 바람들은 저물어가는 달빛은 가자 여물 어가는 꿈꾸고 굿나이트 헤이 헤이 베이비 그건 새 데이 새로운 느낌이야 이건 아무래도 이거는 이거는 확실한 비율 당신이 정말로 당신을 원한다는 것을 확실히 정말이야 널 좋아하는데 빨갛게 익은 얼굴이 그걸 증명해 날 딸기처럼 상큼한 사람 어리바리한 그대 주위 사람들은 다 이기주의 밤낮을 걸으며 널 지켜줄 나와 달리 그들은 차 키를 과시하지만 나쁜 사람 자다가 일어나 잠꼬대로도 널 찾네 아침이 깨는 소리 아침 바람들은 조화를 이룹니다 저물어가는 달빛은 여물 어가는 로맨스 꿈꾸고 가는 거니 당신이 거기에 있을 거야 네가있는 거리 아직 사이 서먹해도 그래도는 해봐야지 나라도 여야 합니다 정말이야 좋아하는데 빨갛게 익은 얼굴이 그걸 증명해 처음이야 기분 멈추질 못하겠어 막 넘쳐 누가 잠가놓은 입은 오물쪼물 안 열려 부름에 뒤를 돌아보는 두 눈을 보니 맘을 전할 수 있다면 사실은 좋아하는데 확실해 모던 걸 담은 눈빛이 그걸 증명해 정말이야 빨갛게 익은 얼굴이 여야 합니다,0,1,6,2,8
113,온종일 정신없이 바쁘다가도 틈만 나면 네가 생각나 언제부터 안에 살았니 많이 웃게 돼 어느새 너의 모든 것들이 편해지나 부드러운 미소도 나지막한 목소리도 아직은 얘기할 수 없지만 있잖아 네가 사랑이란 말하긴 어설플지 몰라도 아주 솔직히 그냥 네가 친구들 속에 너와 함께일 때면 조심스레 행복해지고 어쩌다가 옆에 앉으면 세상을 다 가진 기분이 드는 걸 우연히 눈만 마주쳐도 괜스레 발끝만 보게 되고 조금씩 마음이 너에게 가고 있는 걸 세상에 두 사람 너랑 나만 몰랐나 잘 할지는 몰라도 곁에 서고 싶어 하루하루 점점 커져가는 느낌 날 보다 그냥 손잡을 때는 어떨까 둘이 입 맞춘다면 아직은 얘기할 수 없지만 있잖아 사랑이란 말하긴 어설플지 몰라도 아주 솔직히 그냥,0,1,6,-2,4
114,언제나 거침없던 내가 조금씩 눈치를 보고 있어 겉으론 관심 없는 척 차가운 도시의 남자인 척 애써 외면하고 낯선 말투로 널 만나왔어 영화가 아니잖아 드라마의 남자가 아니잖아 이제 맘과 다르게 널 대할 순 없어 네가 솔직한 맘 들어봐 줄래 연애할까나 오랫동안 솔로여서 연애가 서툴지 모르지만 전 남자친구보다 네가 만난 모든 남자보다 가장 널 사랑할 연애할까 내가 머뭇거리는 너에게 쏟아지는 남자들의 관심 가득한 눈빛 친절한 태도 미치겠어애써 외면할까 생각도 했지만 아니요 그럴 순 없어 남자가 아니잖아 이렇게 허무하게 돌아선다면 이제 맘과 다르게 대할 순 없어 네가 솔직한 맘 들어봐 줄래 연애할까나 오랫동안 솔로여서 연애가 서툴지 모르지만 전 남자친구보다 만난 모든 남자보다 가장 사랑할 연애할까 연애할까나 오랫동안 솔로여서 연애가 서툴지 모르지만 전 남자친구보다 만난 모든 남자보다 가장 사랑할 키스할까사랑해이런 달콤한 말 매일 해주고 싶은데 용기 있는 남자 되어 꼭 너를 가지고 싶은데 곁에 있어줄래 시간이 없거나 눈이 높아진 것만은 아닌 거 같아 홀로 누군지도 모를 한 여자의 포로가 되어 나를 기다려 왔어 지금 그게 너라고 말하고 있어 아까 했던 얘기 한 번 해도 될까 키스할까 사랑해 달콤한 말 매일 해주고 싶은데 용기 있는 남자 되어 꼭 너를 가지고 곁에 있어줄래 연애할까,0,1,4,0,4
115,안녕하세요 처음 뵙겠습니다 생각보다 너무 예쁘세요 말씀 많이 들었어요 좋은 사람 요즘 찾는다고 반가워요 처음 뵙겠습니다 생각보다 너무 멋지네요 저도 얘기 들었어요 외로움 타신다고 괜찮은 인연이 될 느낌 그대도 느끼나요 뱃속 가득 나비가 날아든 짜릿한 기분을 내일도 모레도 만나봐요 많이 그댈 알고 싶죠 궁금하고 너무 들뜨네요 아마도 그대가 좋아질 숙면했나요 좋은 꿈 꿨나요 마침 오늘 별일 없는 참에 커피 한잔 살까 되면 만날까요 잘 잤어요 날씨 좋네요 저도 오늘 딱히 별일 없어 무얼 할까 고민했죠 지금 만나요 괜찮은 인연이 될 느낌 그대도 느끼나요 뱃속 가득 나비가 날아든 짜릿한 기분을 내일도 모레도 만나봐요 많이 그댈 알고 싶죠 궁금하고 들뜨네요 아마도 그대가 좋아질 어쩌면 그댈 만나기 위해 그동안에 아픈 사랑을 연습처럼 해 온 같아 고마워요 우리는 너무나 잘 맞아요 느낌 그대도 느끼겠죠에 세상이 둘을 위한 공원과 같은 기분 부디 천천히 천천히 알아가요 애태워 애태워 매일 처음처럼 처음 만나는 사람인 것처럼 언제나 설레게 노력해요,0,1,8,-1,7
116,느낌이 오잖아 떨리고 있잖아 언제까지 눈치만 볼 거니 맘을 말해봐 딴청 피우지 말란 말이야 맘 가는 그대로 지금 손을 잡아 어서 손을 잡아 우연히 고개를 돌릴 때마다 눈이 마주치는 건 며칠 밤 내내 꿈속에 나타나 밤새 나를 괴롭히는 건 많은 빈자리 하필 옆자릴 고르는 건 나도 모르게 어느새 실없는 웃음 흘리고 있다는 말 다 했지 뭐 얘기 할까 느낌이 오잖아 떨리고 있잖아 언제까지 눈치만 볼 거니 맘을 말해봐 딴청 피우지 말란 말이야 맘 가는 그대로 지금 손을 잡아 핸드폰 진동에 심장이 덜컥 내려앉는다는 나도 모르게 어느새 짓궂은 말투 듣고 싶은 걸 어떡해 멀리 걸어온다 눈이 마주친다 언제까지 넌 모른척할 거니 사랑이 온 거야 너와 말이야 네가 못 견딜 만큼 그거면 된 거야 더는 생각하지 말란 맘 가는 그대로 느낌이 오잖아 떨리고 있잖아 눈치만 볼 맘을 말해봐 딴청 피우지 지금 그냥,0,1,-2,2,0
117,당신은 너무 달콤합니다 언제나 입가에만 맴돌던 말 저만치 걸어가는 뒷모습 볼 때면 너도 나처럼 마음이 아프니 궁금해 이제 늘 아쉬워하고 때론 미워했는지를 널 사랑했던 거야 감출 수 없어 말을 전해줘 나비 까만 밤 쏟아지던 불꽃놀이 아래 너의 반짝이던 눈을 잊지 못해 어른이었다면 입맞춤할 텐데 나비 우릴 데려가 줘 앨 처음 봤던 순간 같은 자리에 서로 눈 마주쳤던 순간 빠져버렸지 말을 전해줘 나비 마음이 고장 버렸으면 생각이 멈춰버렸으면 해 널 생각하면 이렇게 눈물이 날까 이제 깨달았어 늘 아쉬워하고 때론 미워했는지를 널 사랑했던 거야 감출 수 없어 말을 전해줘 우릴 데려가 줘 앨 처음 봤던 순간 같은 자리에 서로 눈 마주쳤던 빠져버렸지,0,1,-2,1,-1
118,외로운 사람들의 마음을 열어줄 거야 메마른 가슴속을 적셔줄 멜로디 슬픔의 기억들에 기쁨을 채워줄 거야 넘치는 음악 속의 리듬을 바람이 살짝 잠을 깨운 꽃잎에 좋아해 말 한마디를 담아서 어젯밤 꼬박 새운 나의 노래에 사랑의 마법을 걸어보네 꿈 꿔왔던 소망과 꼭 간직해온 사랑을 모두가 느낄 수 있도록 마음을 담아 노래할 거야 너를 위한 노래를 예외로운 사람들의 마음을 열어 메마른 가슴속을 적셔줄 멜로디 슬픔의 기억들에 기쁨을 채워줄 넘치는 음악 속의 리듬을 자꾸만 두근 설레는 가슴에 좋아해 말 한마디를 못할 땐 바람에 살짝 띄어 보내 줄게요 사랑의 마법을 담은 노래난 꿈 꿔왔던 소망과 꼭 간직해온 사랑을 모두가 느낄 수 있도록 담아 노래할 너를 위한 노래를 예외로운 사람들의 열어 메마른 가슴속을 적셔줄 멜로디 슬픔의 기억들에 기쁨을 채워줄 넘치는 음악 속의 리듬을 비 갠 오후의 햇살처럼 마음 포근히 감싸줄게 먼 곳에 있어도 들려줄게 노래는 너와 외로운 열어,0,1,7,-4,3
119,외로웠던 너는 내게 왔지만 기다렸었던 걸 너는 몰랐었지 이제까지 바랬었던 순간만이 나를 기뻐하게 했었던 거예요 기억하고 있진 않나요 꿈같은 순간 바라는 건 없었지만 혼자만 좋았다면 너를 보내고 망설이지 않았겠지 힘들어도 내게 다가와 없이는 내가 없잖아 매일 보고 있어도 널 볼 수 없지만 이제는 알아 느끼는 있어나는 너를 닮아가 장난스러운 너는 상관없지만 언제부터 두근 걸렸었어 사랑이란 가면은 벅차지만 나를 기쁘게 만들어 주는 거예요 기억하고 있진 않나요 꿈같은 순간 바라는 없었지만 혼자만 좋았다면 너를 보내고 망설이지 않았겠지 힘들어도 내게 다가와 없이는 네가 없잖아 매일 보고 있어도 널 볼 수 없지만 이제는 알아 느끼는 있어나는 닮아가힘들어도 다가와 없이는 네가 없잖아 매일 보고 있어도 널 볼 수 없지만 이제는 알아 느끼는 있어나는 닮아가,0,1,4,6,10
120,좋을 텐데 너의 손 꼭 잡고 그냥 길을 걸었으면 내겐 너뿐인 걸 네가 알았으면 좋을 텐데 전 만난 남자 얘기 오늘만 해도 벌써 번째니 그에게 전화가 왔었다며 조금은 얼굴을 붉히는 집에 돌아오는 길은 포근 한 달빛마저 슬퍼 보여 마음이 아파 나를 위로해줄 네가 있다면 좋을 텐데 너의 손 꼭 잡고 그냥 길을 걸었으면 내겐 너뿐인 걸 네가 알았으면 괜찮은 사람인지 아닌지 한번 본 적도 없는 내가 알아 그에게 선물을 받았다며 유난히 행복해 보이는 집에 돌아오는 길은 포근 한 달빛마저 슬퍼 보여 마음이 아파 나를 위로해줄 있다면 아닌 사람 얘기에 때론 화도 내어 봤으면 너의 곁에 내가 있었으면 모르겠니 애써 지켜온 우정마저 놓칠 것만 같아 기다리던 망설이던 그런 손 꼭 잡고 그냥 길을 걸었으면 내겐 너뿐인 걸 알았으면 아닌 사람 얘기에 때론 화도 내어봤으면 곁에 내가 있었으면 아닌 사람 얘기에 때론화도 내어봤으면,0,1,-2,7,5
121,사람을 만나는 거니 물을 좋은 사람을 만나게 된 거지 대답 해 자랑하고픈 다 말을 하고픈 기분에 친구들을 모아 시간을 떠들기만 해내 사랑은 너오 베이비 베이비 루 루보 베이비 루 루브 눈을 감아도 느껴지는 너오 루 루보 루브 하루에도 열두 번 보고 싶다고 하며 전화기를 바쁘게 하는 너나를 사랑해 줘서 고마워 내가 너보다 내가 너보다 사랑해 사랑해 바보 같아도 유치해 보여도 행복해 행복해 주고픈 다 해주고 싶은 마음에 적어 놓은 것들언제 다 해주나 걱정 대내 사랑은 너오 루보 루브 눈을 감아도 느껴지는 하루에도 열두 번 보고 싶다고 하며 전화기를 바쁘게 하는 너나를 줘서 고마워내 왼쪽에 오른쪽에 영원히 두고 싶은 건 너야 당신이 필요합니다 당신은 당신을 원한다 당신을 원한다 언제까지나 사랑은 눈을 감아도 느껴지는 사랑할 땐 꼭 필요한 레시피 유통 기한이 안 적힌 진실 사랑이란 특별한 요리,0,1,1,-1,0
122,엄마야 어떡하면 그녈 다시 돌아오게 할 수 있는지 내게 가르쳐줘 제발 그녀 없는 세상이 너무 두려워 드디어 내게도 운명 같은 사랑이 찾아온 거라고 매일을 들떴었는지 모를 거야 태어나 맨 처음 기도했어 이번엔 이별이지 않게 영원한 사랑을 지킬 수 있게 한 번만 도와주길 그댄 떠나려 해 사랑을 찾아내가 잘못했는지 알지도 못하는데 엄마야 이번만은 뜻대로 너만은 보낼 수가 없어 제발 믿게 해줘 내게 세상에 사랑이 있다는 것을 엄마야 이번만은 잊지 못해 다시는 사랑 못할 거야 나의 모든 것을 걸어 처음으로 사랑을 했어태어나 맨 처음 기도했어 이번엔 이별이지 않게 영원한 지킬 수 있게 한 번만 도와주길 그댄 떠나려 해 찾아내가 잘못했는지 알지도 못하는데 이번만은 뜻대로 너만은 보낼 수가 없어 제발 믿게 해줘 내게 세상에 사랑이 있다는 것을 잊지 못해 다시는 사랑 못할 거야 나의 모든 걸어 처음으로 했어 발 떠나가지 마 그대 없는 내가 아냐돌아와줘 곁으로 뜻대로 너만은 보낼 수가 없어 믿게 해줘 세상에 있다는 잊지 못해 다시는 사랑 못할 나의 모든 걸어 처음으로 했어,0,1,1,-5,-4
123,새로운 방법 항상 나은 늘 사라졌습니다 우린 너무 철 없이 거품처럼 들떴지 서로를 겉핥기 식으로 공부하면서 요점을 다 놓쳤지 우린 소속감 따윈 못 느끼면서 빠른 속도감을 즐기면서 감정을 다 허비해 약간의 허탈함도 느끼면서 그게 너무 좋았나 그런 가벼움이 좋았나 열정이 너무 사나워 냉정한 감각이 졸았나 감정이 낮잠처럼 나른해질 때쯤 깨달았어 사랑이 떠나갔다는 걸 사랑은 그렇게 순간의 전기처럼 찾아와 머물고 사라져 먼지처럼 우린 쉽게다 태워버렸나 봐보고 싶어요 연기처럼 흩어지네 사랑은 우릴 스치고 가버렸지 열정은 빨리도 타버렸지 이별하는 순간조차 참을 수없이 가벼웠지다 지난 혼자서 잠드는 무서웠었나 아님 텅 빈 방에서 눈 뜨는 두려웠었나 부끄러웠었나 벌거벗은 영혼을 보여주는 우습기도 해서로의 몸은 스스럼없이 보여주는데 홀로 지새우는 밤 좁은 방구석이 끝없는 사막같이 느껴져 하나의 사랑이 휴지통으로 장의 사진들과 구겨져 사랑은 그렇게 순간의 전기처럼 찾아와 머물고 사라져 먼지처럼 쉽게다 태워버렸나 봐보고 싶어요 연기처럼 흩어지네 뜬금없이 생각나겠지 술잔을 입술에 기댈 때면 보일 듯하다 흩어지는 취한 듯이 아련한 기억들 늦은 밤 술에 잔뜩 취해 이불 속을 뒤척거려치워버린 번호 혹시나 해서 전화기를 뒤적거려 사랑조차 새로운 방법인 사라졌습니다 내겐 미련만이 남았어 그렇게 순간의 전기처럼 찾아와 머물고 사라져 먼지처럼 쉽게다 태워버렸나 봐보고 싶어요 연기처럼 흩어지네,0,1,1,-3,-2
124,바람이 좋다 날 어루만져 준다도 슬금슬금 맘속 불을 지펴 발 길을 옮긴다 낯선 길이 많다 어딜 따라갈 까이 끌리는 대로 닿는 대로 가보면 알겠지 새로운 세상을 향한 설렘 꿀 같은 달콤함에 또다시 천국의 문을 연다네 이끌려 미지의 길을 걸어가고 있어 천국의 문을 열면 만나게 될까 너의 답을 진짜 답을 찾고 싶어갈 길이 멀디 여정이 좋다 두근두근 설렘 속 불안함이 묘하게 섞인다 같은 길은 없다 나를 볼가 펼쳐지는 대로 있는 가보면 알겠지 오랜 방황에 만난 떨림 꿈같은 포근함에 또다시 천국의 문을 연다네 이끌려 미지의 길을 걸어가고 있어 열면 만나게 될까 너의 답을 진짜 찾고 싶어나의 진짜 찾고 싶어의 길의 끝에 서면 나란히 옆에 서면 자라난 날 나를 기대해봐도 될까 너에게 속한 세상이란 기분 기분일까 또다시 빛을 본다나를 이끌어 미지의 걸어가고 있어 열면 만나게 너의 싶어 연다네 이끌려미지의 싶어,0,1,3,4,7
125,네가 맛있었다고 했던 살구빛 샐러드 맛있어서 먹고 싶어 네가 좋아했던 것들을 나에게 자그마한 행복들 달력 안 기념일들로 채워지네 채워지네 네가 좋아했던 살구빛 샐러드 그날은 샐러드 기념일 우후나 좋아하던 멜로디언 소리 그날은 멜로디 기념일 라라라나 예뻤었다고 했던 조그만 고양이 귀여워서 보고 싶어 좋아했던 것들을 나에게 자그마한 고양이들 방에 한가득하게 채워지네 살구빛 그날은 기념일 좋아하던 멜로디언 소리 멜로디 라라라나 좋아하던 멜로디언 소리 멜로디 라라라나,0,1,4,-3,1
126,마주치는 눈빛에 아기 아기 왠지 어색해 대체 고개를 숙여봐도 너의 발끝에 맘이 설레 두근대 두근대 두근대네 발이 조금씩 내게로 천천히 한 걸음걸음 가까워지잖아숨길 수 없어진 맘은 커져만 가는데 어서 어서 살며시 고개 들어 너를 보면도 볼에 살짝 입 맞춰줘 당신은 당신이 하시겠습니까 혼자서 아주 오래 바라왔던 동화 같은 그런 순간이 당신은 당신을 하시겠습니까 오늘은 꼭 생기길 기도해 볼래한 발 두 발 뛰는 맘 발끝이 닿을 같아나 어떡해야 해 머릿속이 새하얗게 돼 괜스레 장난스레 한 발 물러서 멈춰 서면 넌 다가와 다가와 다가와 점점 커지는 심장의 발걸음 어쩌면 네게 들릴 것만 같아한 가까이 너에게 먼저 다가갈까 어서 살며시 고개 들어 너를 보면도 볼에 살짝 입 맞춰줘 당신은 당신이 하시겠습니까 혼자서 아주 오래 바라왔던 동화 같은 그런 순간이 당신을 오늘은 꼭 생기길 기도해 볼래 소년이 당신이 소년이 될 것인가 망설이지 말아 줘 사랑 갑자기 고개 숙여 나를 향해도 볼에 살짝 입 맞춘 놀라서 들어 너를 보면 아무 말 없이 안아줄래 품에 포근하게 어쩐지 맘이 간지러워한 쪽 발이 하늘로 날아 당신을 마음도 오를 같아 수줍게 간직했던 가슴속비밀 오늘은 이뤄지길 기도해 볼래,0,1,1,3,4
127,어깨동무까진 괜찮아 치마 손잡는 건 위험해 잘 자란 메세 진 괜찮아그래도 자냐는 메세 진 안 돼심심할 연락해 커피 한 잔은 알았어늦은 술 한 잔은 안 돼가끔 전화는 영상통화는 고맙지 만 사양할 아무래도 어색해서 못해 사이엔 둘만 모르게 그어진 선 같은 있나 친구라 하기엔 가까운 같은데 우린 선 위에 있나 봐넘어와 소년 넘어와 소녀 어색해지면 어쩌지 뻘쭘해지면 어쩌지 넘어와 소년 넘어와 소녀 눈 감고 다가가 볼까 살짝 기대는 어깨 거기까지는 사실 지금도 좋은데 다가와도 알았어멀어질까 걱정돼 아직 준비 안 된 같아 사이엔 둘만 모르게 그어진 선 같은 있나 친구라 하기엔 가까운 같은데 우린 위에 사이엔 둘만 모르게 그어진 같은 친구라 하기엔 가까운 같은데 우린 위에 봐넘어와 소년 소녀 어색해지면 어쩌지 뻘쭘해지면 눈 감고 다가가 볼까,0,1,3,-1,2
128,햇살이 가득 그댈 향한 가벼운 발걸음 콧노래 부르며 쇼윈도에 비친 모습을 한번 점검해 시간은 충분해 오늘 그대와 얘기를 나눌까 어딜 가볼까 저기에 그녀가 보이네요 오늘은 너무 기분 좋은 날 미소가 가득 나도 모르게 웃음이 그녈 생각하면 지금 모습 그녀 맘에 들지 않을까 신경 쓰여 오늘 그대와 팔짱을 끼면 어떨까 손잡아 볼까 저기에 그녀가 보이네요 오늘은 너무 기분 좋은 날 하늘 위를 기분이 걸까 오글댄 너무 새콤달콤 마음은 두근두근 기분이 분홍빛 장미를 닮은 아름다운 그녀의 모습 오늘은 어떨까 상상만으로 터져버릴 듯한 기분 어쩌면 오늘 그대와 얘기를 나눌까 어딜 가볼까 저기에 그녀가 보이네요 나를 향해 손을 흔드네요 눈앞에 좋은 날,0,1,5,0,5
129,세상에서 가장 행복한 말 더욱 듣고픈 말 고마운 말 날 살리는 사랑해 그댈 쑥스러워 평생 못하는 더욱 하고픈 미안한 눈물 사랑해 그댈 사랑해 마음은 굴뚝인데 핑계 핑계로 미뤄뒀지 말이야 말아내 진심은 말이야 너를 나에겐 누구보다 소중한 사람 언제나 곁에 있어서 깜빡 잊고 살지만 지금 눈물 고마운 사람 언제나 그렇게 있어줘 그대 기쁜 맘을 알아줘멋쩍어서 내내 감추는 맘 지금 열고픈 맘 든든한 맘 따뜻한 그댈 마음은 안 툴툴거리고 짜증 냈지 말이야 말아내 진심은 너를 나에겐 누구보다 소중한 사람 언제나 곁에 있어서 깜빡 잊고 살지만 지금 눈물 고마운 그렇게 있어줘 그대 기쁜 맘을 알아줘 이것저것 재지 않아도 별다른 이유 찾지 않아도 날 믿어줄 날 감싸줄 지켜줄 힘이 돼 나의 좋은 너를 사랑 해이 세상 누구보다 소중한 곁에 있어서 깜빡 잊고 살지만 그렇게 있어줘 그대 기쁜 맘을 알아줘,0,1,8,1,9
130,아기 사랑은 결코 그렇게 좋았다는 느낌이 들지 않고 당신이 나를 붙잡고 있는 것처럼 의심의 여지가 없다 당신을 사랑하고 생명을 사랑하고를 사랑합니다는 결코 그렇게 당신이 나를 붙잡는 것처럼 의심의 여지 가라면 의심의 여지가 없을 것입니다 사랑하는 생명 바빌로프 미친 바 빌 로브는 결코 그렇게 굿바이 바 빌로우 느낌이 절대 느껴지지 않았다고 느꼈다 밤이 될 거야를 기다릴 수 없다 은 좋은 느낌이 너무 선한 너무 좋다고 느꼈습니다,0,1,3,4,7
131,오늘 밤 날 바래다주는 길 내내 내가 변했다고 말하지 널 생각하지 않는다고 너는 투덜대지 언제나 넌 사랑이 설렘이니 내겐 사랑은 익숙함 너를 떠올리는 시간을 따로 두진 않아 늘 널 생각해 널 생각해바쁜 하루의 순간순간 순간도 네가 보여 보여줄 순 없지만 조금은 너도 느끼잖아 늘 생각해 매일 생각해 잠이 들어 꿈꾸는 순간도 앞에 웃는 그런 너를 기억나 내가 처음 고백했던 그날 멋진 이벤트도 없었지만 날 받아준 가슴에 늘 지금처럼 생각해바쁜 하루의 순간순간 순간도 네가 보여 보여줄 순 없지만 조금은 너도 느끼잖아 매일 잠이 들어 꿈꾸는 앞에 웃는 그런 너를 함께한 순간순간 순간이 소중해서 말로 다 할 수는 없지만 조금씩 네게 보여줄게 매일 생각해이른 아침잠에서 깨어나 세상에서 가장 행복한 앞에 웃는 그런 보며 사랑해,0,1,9,2,11
132,그냥 사랑에 빠지고 싶어 모든 것만남이란 상상만으로도눈부신 낭만의 시작한 잔의 진한 설레임에향기가 온 몸으로 퍼지는환상의 시간슬며시 두 볼이 붉어진연인들이 단풍 잎새 처럼 느껴질쓸쓸함이란 씨앗에 핀사랑들이 무르익는 계절의 소식마음에 번지는 흥분과또 넘치는 기쁨에뿜어지는 눈물들이며칠을 잠을 깨워또 깨워 밤 새워애 태워 해 봐도그리움 못 채워그저 끄적 편지만 글자보고 싶은 사람의 얼굴만자꾸 떠 오르네 떠 오르네그냥 쓰고 싶어 보다 외로움 보다둘의 행복함 워 어어어낮과 밤은 사라지는사랑의 기적그래 요열과 성과 진심으로 전한사랑의 결과는기분 좋은 변화로믿음이라는 굳은 살이 박히고더 아끼고픈 욕심에 푹 빠지고살기좋은 삶이란 이야기만지나칠 만큼 입에 맴돌아달콤한 말 보다사소함을 챙길 때맺는 두 사람의 교감아주 자주아픈 말을 낳는질투가 주는 실수는비뚤어진 입을 길 들여이해하기 인정하기를기억하고 실천하길넓은 가슴이 즐겨 먹는사랑은 맛있어달 빛 젖은 햇살 머금은세상의 선물 워 어어어지켜줄께 아껴줄께영원의 주문당신은 나를 새롭게 느끼게합니다값진 사랑 반쪽을 갈라서로 나누어언제나 가슴에 품고서모든 순간 함께해웃음이 번지고행복함은 넘치고 기쁨도 커지고모두가 지금이 노래를 부릅니다사랑은 맛있어달 빛 젖은 햇살 머금은세상의 선물 워 어어어지켜줄께 아껴줄께영원의 주문당신은 나를 새롭게 느끼게합니다값진 사랑 반쪽을 갈라서로 나누어언제나 가슴에 품고서모든 순간 함께해,0,1,12,-6,6
133,장난스러운 너의 속삭임 마음을 알아차린 신기루 같은 사랑의 유혹 당신이 사랑의 신의 신의 신의 신들이라면 마법의 이상한 유혹입니다 너에게 나를 가둬둘 수 있도록 당신이 사랑하는 사랑의 신을 신경 쓰지 않으면 사랑이 진실하게 되도록 널 향한 나의 소원이란 사랑이란 걸 그대만의 기적이란 훔쳐볼 순 없는지 우리가 사랑에 있는지 모르겠습니다 달콤한 사랑이여 그대는 신잔인한 사랑이여 그대는 신나 아닌 사람에게도 늘 보란 눈길 주더니 어느새 너의 황금화살에 순간에 당신이 신을 신경 쓰지 않으면 사랑에 깊은 사랑 너에게 나를 가둬둘 수 있도록 신을 신경 쓰지 않으면 사랑이 촉발되도록 하자 널 향한 나의 소원이란 사랑이란 걸 그대만의 기적이란 훔쳐볼 순 없는지 우리가 사랑에 있는지 모르겠습니다 달콤한 사랑이여 그대는 신잔인한 신 달콤한 신잔인한 신은 내가 사랑하는 사랑하는가 너에게 나를 가둬둘 수 있도록 사랑하는 사랑이 진실하게 되도록 널 향한 나의 소원이란 사랑이란 걸 진짜가 되도록 진실하게 장난스러운 너의 속삭임 마음을 알아차린 신기루 같은 유혹 마법의 이상한 유혹이라면 마법의 이상한 유혹의 신인을 않는다,0,1,4,3,7
134,뭔가 기분 좋은 일이 생길 것만 같은 기분이야 요즘 만에 사람들이 나를 알아봐 연예인이 된 것만 같아 뜻밖의 인연으로 연애도 되려나 뭔가 대박이 날 같은데 느낌상 무더운 여름도 다 지나갔고 쓸쓸해도 개코 형 말처럼 느낌 너무 오빠 차 뽑았다 라고 말할 수 있는 날도 올 같아 술 담배 욕 커피 다 끊고 도끼 형처럼 살아 볼까 자신감도 부쩍 늘고 잘 될 것만 같은데 주변 사람들은 생각들 그게 기분 탓이래 기분 탓이래 왠지 기분이 탓일 수도 있지만 괜찮아요 바라 왔던 많은 꿈들 다 잘 될 같아 콧노래를 불러 발걸음이 가벼워지는 기분이야 일이든 잘 될 거야 이게 좋은 탓 오늘따라 거울에 비친 얼굴엔 김이 묻었네 잘생김 요즘에는 가장 꽂히는 노랫말 짜증을 내어서 사람들이 나를 보는 시선조차도 많이 변한 것을 느껴 나도 세상을 바라보는 시선도 변했겠지 못해도 아마 도내가 미쳐가는지 잠자는 시간조차 아까운지 궁금해서 물어보면 사람들은 탓이래 왠지 기분이 탓일 수도 있지만 괜찮아요 바라 왔던 많은 꿈들 콧노래를 불러 발걸음이 가벼워지는 기분이야 일이든 거야 이게 좋은 탓한 사주를 믿지는 않지만 올해는 너무 좋대 삼재도 끝났고 막히는 없이 술술 풀린 대 그런 걸 떠나서 나도 이제 훨훨 높이 날아오를 열심히 산 만큼 노래 가사처럼 길이 보이네 힘을 내왠지 기분이 탓일 수도 있지만 괜찮아요 바라 왔던 많은 꿈들 콧노래를 불러 발걸음이 가벼워지는 일이든 거야 이게 탓,0,1,3,4,7
135,그것이 그것이 될 방법입니다코코노로 카타치카와라나이일이 될지에 관계없이코노마마 멀리도시테모이이 나니모이라나이당신이 원한다고 말 해주세요 아시타니낫타라 와스레루요돗카이타노니히키즈루키모치 당신을 위한나제카토마라나이사과 파이 처럼요소토와도라이다케도나카미부드러운 달콤한도코카라 도시요다시 한번 그것은 우주입니다아라모도오이시이머리부터 발끝까지마지오랫동우소쟈나이 개의 컬러 웰 당신은 꽃입니다비진당신은 나와 흔들리고 싶어노 큐방메노쿠모니놋테당신이 나를 생각하는지 저를 데려가주세요오시에테호시이돈나 패션돈나 메이쿠가이이당신이되고 싶어 당신의 사람이됩니다 뿐다레모이라나이당신이 나를 원한다고 말해줘바텐금기 사항이 없습니다바브 아마에루표본하싯테탈출하다시요그냥 둘후타리데 의카기히라쿠최하부산쥬기분 전환시마스국제적인지마쿠츠키날카로운 하모노 이라네고코이리구치당신을 위한 나소레가 이동케쇼 눈물데오치루와도칸도 무소스루키미스코시이죠요조라니마우실크 시폰을 드레스산토라츠키노 확실히 아기를위한 러브 스토리 스타카붓테안전 벨트시테 언젠가는 언젠가는 것이 될 것입니다 오늘 밤 처음으로 사랑을 나누십시오다레모키즈카나이소시테혼토와혼토야바쿠나이나는 당신이 코코노로 카타치카와라나이일이 될지에 관계없이코노마마 멀리시테모이이나니모이라나이그냥 당신이 나에게 홉을 원한다고 말 해주세요 가지고 있습니다 당신은 멈추지 않는다도코사가시테모당신이 알고있는 곳은 어디에도 없습니다히토리노토키노감정 아니오도시테콘나니츠라이노 나를 사랑하지 않는다 오시에테호시이돈나 패션돈나 메이쿠가이이당신이되고 싶어 당신의 유일한 유일한다레모이라나이당신이 말해줘코코노로 카타치카와라나이일이 될지에 관계없이코노마마 멀리도시테모이이 나니모이라나이당신이 말 해주세요,0,1,1,-4,-3
136,혼자라고 느낄 땐 멜로디를 기억해봐라 랄랄라 랄랄라 라 랄랄라라 순간이 그리워질 불러봐라 랄랄라 라 랄랄라라 너랑 걸어 다닐 때면 노래가 들려 너는 내게 젤 반가운 멜로디거든 너랑 걸은 거리마다 그림이 보여 넌 그런 느낌인 거야 재미있는 얘길 해줄까 걸을 때에도 따라다녀 네가 네가 나의 곁을 지키는 같아난 지칠 땐 늘 생각해 그건 휴식이거든 그건 향기롭거든 혼자라고 느낄 땐 멜로디를 기억해봐라 라 랄랄라라 순간이 그리워질 불러봐라 바람의 결 너의 결을 따라난 흘러가고 싶어 너랑 걸어 다닐 한겨울에도 마음이 뜨거워 뜨거워 더운 여름이 거리 위에 소음이 너와 나의 멜로디 우린 멀리 있어도 신호가 안 멀어 흥얼거리는 박자에 너와 발걸음을 맞춰 조용한 공원에선 서로의 목소리를 낮춰 넌 소중해 알아줘나는 항상 당신과 당신의 기억이 될 것입니다 넌 가끔 나를 나를 아이처럼 아이처럼 꿈을 꾸게 해손을 왼쪽으로 오른쪽으로 움직여 자주 나를 아이처럼 막 웃게 만들어 어서 여기로 와서 우리가 간다 혼자라고 느낄 멜로디를 기억해봐라 순간이 그리워질 불러봐라 라랄랄랄라아,0,1,4,-6,-2
137,오늘같이 싱그러운 날 길거리 차도 별로 다니지 않아 문득 지나가다 거울을 보면 오늘 모습은 예뻐 보이네 이따가 널 보면 말을 할까 날씨가 좋다고 뻔한 말이라도 건네볼까 어색한 장난이라도 용감하게 오늘은 널 웃음 짓게 만들 거야 사랑의 오늘같이 햇볕 좋은 날엔 매일 걷던 거리도 지겹지 않아 문득 지나가다 거울을 보면 얼굴도 정도면 잘생겼네 이따가 널 말을 할까 날씨가 좋다고 공원이라도 걷자 할까 짓궂은 장난이라도 용감하게 오늘은 웃음 짓게 만들 거야 나에 선에서 사랑의,0,1,8,1,9
138,사랑에 빠진 순간 너만 보이고 심장은 두근거려 사랑해 사랑해 사랑해 필요 다 가슴에 폭 안겨주긴 길 걷다 뽀뽀해주기 일부러 투정 부리기 귀여운 애교도 살짝 눈으로 맘을 알기 더워도 꼭 붙어 있기 걸을 땐 팔짱 껴 주기 집 앞에 달콤한 키스 당신을 사랑하기 당신이 필요하기 당신을 사랑하기 당신을 사랑하기 당신이 필요합니다 하루만 못 봐도 뽀뽀하고 싶어달콤한 너에게 뽀뽀하고 싶어숨막혀 터질 크게 안아줄게 영원히 그대를 사랑해요 섹시한 여자를 봐도 앞만 보며 걸어가기 늦은 밤 네게 전화해 수백 번 말해 당신이 필요하기 필요합니다 하루만 못 봐도 뽀뽀하고 싶어달콤한 너에게 싶어숨막혀 터질 크게 안아줄게 영원히 그대를 랄라 랄라 랄라 너를 만나면 하루가 즐겁고 너를 만나면 하루가 설레고 너를 만나면 하루가 짧아져 아쉬워 포근해 행복해 공주가 되었고 행복한 여자야,0,1,4,-3,1
139,눈꽃이 내린 버스 정류장에 날 데려다주다 꼭 손을 잡는 때문에나 놀랐어 아주 오래전부터 숨겼던 맘이 들킨 걸 까부는 바람에 실린 우리에게 번진 이것은 사랑입니다 마음에 내려와 사뿐히 내려와네 어깨 위에도 벌써 내린 이름 봄인가 잡은 손 틈 사이 얇아진 외투 사이 어느새 스며들어 우릴 변화시킨 봄이 왔나 첨언 그랬어 편한 친구 혹 동생 같았어 치마를 입고 꾸민 모습에도 놀라지 않았어 뭐가 우릴 지금 이렇게 바꿔 놓은 걸까 아마도 미친 듯이 너를 아기라고 부를 수 있어 마음에 내려와 사뿐히 내려와네 어깨 위에도 벌써 내린 이름 봄인가 잡은 손 틈 사이 얇아진 외투 어느새 스며들어 우릴 변화시켜 오우리 서로에 기대어 잠든 벤치 투명한 하늘에 물든 달콤한 벚꽃 늘 이러면 좋겠다 바꾼 이름 봄봄봄 봄 오늘 사랑해 너를 사랑해 사랑해 널 응넌 봄이 돼줘 항상 꽃이 될게 서로를 녹여주고 열리게 해주면 좋겠다 안 보이던 마음과 마음 마주한 시선 겨우내 숨어있던 꽃이 피었나 봄이 왔나,0,1,2,7,9
140,당신이 내가를 보았던 방식을 기억합니다 우리가 촬영의 끈을 잡았을 기억합니다 우리가 공유 한 것들을 기억하고 우리가 당신을 공유하고 약속을 기억합니다 월과 아버지가 당신이 도둑질을 했다고 생각했을 공유 한 것들을 기억하고 당신을 공유한 약속과 당신을 만들었고 웃음을 우리는 웃음을 월과 내가 기억하는 메이즈에서 미소를 짓는 방식,0,1,0,2,2
141,언제였던 건지 기억나진 않아 머리가 너로 어지럽던 시작 한두 번씩 떠오르던 생각 늘어가서 당황스러운 마음 별일이 아닐 수 있다고 사소한 마음이라고 내가 내게 내게 말을 하는 어색한 걸 사랑인가요 그대 나와 같다면 시작인가요 맘이 그댈 사랑한대요 온 세상이 듣도록 소리치네요 이제야 들리죠 우서 롤 만나기 위해 이제야 사랑 찾았다고 지금 마음을 설명하려 해도 네가 내가 되어 맘을 느끼는 방법뿐인데 이미 안에 있는 걸 안에 네가 있듯이 우린 서로에게 서로에게 이미 길들여진지 몰라 사랑인가요 그대 나와 같다면 시작인가요 맘이 그댈 사랑한대요 온 세상이 듣도록 소리치네요 이제야 들리죠 우서 롤 만나기 위해 사랑 찾았다고 생각해보면 생각해보면 많은 순간 속에 많은 설렘 있었는지 늦은 만큼 잘해 줄게요 할게요 추억이 될 기억만 선물할게요 다신 곁에서 떠나지 마요 짧은 순간조차도 불안한 걸요 내겐 머물러줘요 우글댈 이렇게 많이 그토록 많이 사랑하고 있어요 그대 하나만이 미,0,1,1,2,3
142,말이야 크림 가득 담겨있는 커피 한 잔과 너만 곁에 둘래나른한 날엔 더욱 생각이 드는 그런 나의 위로이니까 나의 위로이니까 햇살 가득 몸에 받아 손을 뻗으면 하늘 위로 느낌도 테지 네가 곁에서 입 맞추면 좋을 거야 머릿속 하얗게 지워져도 좋을 거야 그냥 밤을 새울 수도 있을 거야 볼 거라 진 뺨 아름다워 나와 행복해질 라라라라라라라라라라라라라라라라라 라스 파라 밥 스파 라밥 스파 라밥 스파 라밥 파라 스파쇼 노려 캐러멜은 너보다도 달콤하지만 너만 필요해나른한 날엔 더욱 생각이 드는 그런 나의 위로이니까 햇살 가득 몸에 받아 손을 뻗으면 하늘 위로 느낌도 테지 네가 곁에서 입 맞추면 좋을 머릿속 하얗게 지워져도 그냥 밤을 새울 수도 있을 볼 거라 진 뺨 아름다워 나와 행복해질 우린 맺어질 수밖에 없는 처음부터 우린 하나니까 나와 행복해질 커피 한 잔,0,1,2,-2,0
143,세계의 문제가 무엇인가 은 마마 시가 없는 것처럼 살아남지 않는 것처럼 전 세계가 당신에게 외상을 불러일으킬 것들에 중독된 전 세계에 중독된 것들에 중독되어 테러리즘을 막으려 고 노력하지만 우리는 테러리스트가 미국을 생생하게 얻었습니다 큰 당신이 당신의 자신의 대한 사랑 만 있다면 당신은 공간을 차별하기 위해 공간을 떠나 차별할 때만 해저를 생성할 뿐입니다 운영자 당신은 당신의 마음을 똑바로 통제하고 당신의 영혼을 사랑하기 위해 사랑에 끌려가기 위해 사랑해야 합니다 뺨 아버지 아버지 아버지가 우리에게 위의 지도를 보내도록 도와주세요 사랑 사랑 사랑은 항상 동일하지 않아도 됩니다 항상 변하지 않은 새로운 날은 이상합니다 은 청소년이 젊음으로 죽을 고통을 겪으므로 자신에게 물어보는 것은 정말로 사라 졌기 가이 세상에서 우리가 잘못된 결정을 내린 것에 대해 기뻐서 자신을 존중하지 않는 비전에 대한 비전에만 거부하는,0,1,1,-2,-1
144,내가 거기에 있을 거야 내가 거기 있을 거 내가 거기 있을 거야 그럴 것이다 스피커를 켜 괜찮다고 말하지만 넌 항상 아니라 말하지만 뭐 갑시다니 얼굴에 다 쓰여있어 나에게 거짓말하지 마세요 바보같이 숨기지 마 약한 모습도 약한 약한 모습도 가끔은 괜찮아 대신 포기는 당신은 비트에 나를 느끼는 믿음을 믿지 않는다지 나간 일들은 다 잊고 건너뛰다 어깨를 쭉 펴고 하늘을 찾아보세요 한숨은 쉬지 마 나와 날아가자 믿어봐 날 믿어봐 지금 거기 거야 있을게 옆에 있을게 누구보다 힘이 돼줄게 언제까지나 할게 지금처럼 영원히 거 한 번 센척할 필요 없는데 여린 맘 다 알고 있는데 알아기다리며 애써 봤어 마음에 말해주세요 힘이 들면 내게 말해봐 걱정하지 마세요 걱정하지 마세요 걱정걱정은 멀리멀리 뒤로한 채로 거릴 둬 당신은 비트에서 나를 느끼는 믿음을 믿습니다 힘들었던 기억 건너뛰다 어깨를 쭉 펴고 하늘을 찾아보세요 한숨은 쉬지 마 나와 날아가자 믿어봐 날 지금 있을게 옆에 누구보다 힘이 돼줄게 언제까지나 할게 지금처럼 영원히 것이다 옆에 누구보다 돼줄게 언제까지나 할게 지금처럼 영원히 거 거기에 거예요,0,1,-6,-1,-7
145,당신이 사랑이 되고 싶다면 당신의 별이 되고 싶어 하루에도 번씩 네가 보고 싶어 사랑한다고 하나뿐이라고 예쁘게 안아준다면 야야야 모든 것이 달라질 거야 야야야 넌 항상 나에게 말했었기 친구일 뿐이라고 언제부턴가 넌 조금씩 내게 달라지는 걸 느껴 너의 손길에 들어 있는 느낌들을 네가 알고 싶은 나의 모든 것들을 다 네게 보여줄게 하루에도 번씩 네가 보고 싶어 몰래 내게 다가올래 어색하지 않게 말이야 야야야 당신이 사랑이 되고 싶다면 당신의 별이 모른 척 새침 떼는 나를 이해해줘 사랑한다고 하나뿐이라고 예쁘게 안아준다면 모든 것이 달라질 거야 넌 알고 있는 건지 나의 두근거림을 세상 하나뿐인 너만을 사랑할게 세상 끝 날까지 당신이 사랑이 싶다면 당신의 별이 하루에도 번씩 보고 몰래 내게 다가올래 어색하지 않게 말이야 모른 척 새침 떼는 나를 이해해줘 사랑한다고 하나뿐이라고 예쁘게 안아준다면 너와 부드럽게 웃는 법을 배웠고 너와 다정히 속삭이는 법도 알아 너와 포근히 감싸 안는 법도 알고 너를 것을 바꿔 옛날의 나를 잊겠어 좋은 여자 되겠어 함께하는 어디든 내겐 가장 편한 곳이 됐어 모른 척 새침 떼는 이해해줘 것이 달라질 거야,0,1,9,1,10
146,좋아한다고 말할까 가슴이 뛰는 이유를 온종일 들뜨고 설레는 야릇한 기분 사랑이 시작된 걸까 웃음이 나와 어떡해 뭘 해도 멋져 넌 너무 이뻐 마냥 사랑하게 됐나 사랑하게 됐나 너만 보여 너만 들려 널 기다려 온통 너뿐이야 둘이 있어 행복해 사랑이 너라는 순간이 전부인 것처럼 너에게 빠질래 모든 새롭기만 해 벌써 모든 너로 가득해 어쩌면 네가 처음이야 너뿐인 걸 사랑하게 됐나 너만 보여 들려 널 기다려 온통 너뿐이야 둘이 있어 행복해 사랑이 너라는 순간이 전부인 것처럼 너에게 빠질래,0,1,4,0,4
147,사랑 그게 뭔지 아직도 궁금해나는 사랑에 대해 생각하고 있다고 생각하고 생각할수록 답이 멀어져 만 가는 같아 잘 모르겠어돌고 도는 쳇바퀴에 맞춰지는 퍼즐 게임 보드 그걸 원하는 건 아닐 말이야 왔다 가는 그런 인연 스쳐 가는 많은 우연 아직 기다리고 있어 운명 마음은 널 향한 녹색 빛 녹색 빛 머리는 날 향한 빨간색 라이트 레드 라이트 깜빡이는 신호가 날 서두르게 스쳐가는 인연인가 녹색 빛 라이트 우레 레드 우주 좋은 예감보다 앞서버린 희망 은 사랑에 대한 생각을 생각합니다 똑같은 실수 어김없이 반복해 안에 켜져 버린 빨간불 돌고 도는 쳇바퀴에 지쳐가는 마인드 컨트롤 그걸 원하는 건 아닐 말이야 왔다가는 그런 인연 스쳐가는 많은 우연 아직 기다리고 있어 운명 마음은 널 향한 머리는 날 빨간색 레드 깜빡이는 신호가 서두르게 스쳐가는 인연인가 루 붉은 우에 그린라이트 우에 그린라이트 빛에서 빛에서 빛에서 마음은 널 머리는 빨간색 깜빡이는 신호가 서두르게 인연인가 우레 우주,0,1,3,-4,-1
148,달콤 초콜릿을 입에 물고 키스 한 모금 은빛 에나멜 칼라 손가락엔 별빛 한 스푼 예쁜 꼬리를 달고 너에게 갈게 조금만 기다려 착한 너는 눈이 반짝 빨간 포도주를 좋은 걸로 준비해 줄래 한번 사르라고 하고 마셔 보면 꿈을 꿀만큼 가슴을 열고 심장을 담고 쿠키를 구워줘 착한 너는 입이 활짝 시간은 흐르고 음악은 멈추고 밤도 그리 길지는 않아 새벽이 밝으면 주문도 풀릴 걸 후회할 시간도 모자라 말해나는 당신을 사랑합니다 장미 꽃다발을 백 송이만 준비해 줄래 친구들 슬쩍 보여주면 질투할 만큼너와 걸어갈 때면 어느새 얌전한 고양이 앙큼한 팔짱을 살짝 가끔 비밀스러운 속삭임도 나쁘진 안 지나의 한숨이네 닿을 때면 빨개질 테니네 가슴을 열고 심장을 보이고 마음을 내게 줘내게로 넌 한 발짝 시간은 흐르고 음악은 멈추고 밤도 그리 길지는 않아 새벽이 밝으면 주문도 풀릴 걸 후회할 시간도 모자라 말해나는 당신을 사랑합니다 당신을 사랑합니다 당신이에 있다고 말하면 이에게 갈 수 없다는 말을 마시고 당신이 당신이에 있다고 말하는 곳을 주었다 이에게 주어진 곳 어디든 가서 이야기를 나누고 당신이 있을 수 없다는 것을 이야기하십시오,0,1,2,-2,0
149,아기 웃어요 아기 아기 한번 해보면 쉬운걸요 나쁜 기억은 버려요 지나면 끝인 걸요 첫 키스에 들뜬 그날도 설렌 겨울 여행도 기쁜 생을 소중했던 순간 잊진 말아요 행복하게 행복한 당신을 사랑합니다 늘 하루 한 번 꼭 생각해봐요 행복하게 행복한 당신을 사랑합니다 소중한 추억들 만들어가요 때론 힘들어 울겠죠 한숨이 나오겠죠 아픈 기억은 지워요 다시 털고서 일어나요 꼭 손잡고 했던 약속도 지갑 속 그대 사진도 작은 속삭임도 사랑했던 순간 잊진 말아요 행복하게 행복한 당신을 사랑합니다 늘 하루 한 번 꼭 생각해봐요 소중한 추억들 만들어가요 늘 하루 한 번 생각해봐요 소중한 추억들 만들어가요 그대 맘속에 숨어있던 바램들도 노력하면 되겠죠 조금씩 이뤄질 수 있죠 사랑합니다늘 날 바라보는 따스한 햇살도 하루로 시작해봐요,0,1,2,-1,1
150,매일 똑같은 지루함 속에 널 만나는 걸 기분이 좋아요 너의 눈 속에 언제부턴가 모습이 보이고 있어 어린아이 같은 걸 숨길 수가 없는 걸 두근거림조차 느껴져나는 사랑 받고 싶다 내게 다가와 너의 손을 잡을게 눈에 너를 담으려 나도 몰래 찾아오는 설렘에 당신은 그것을 사랑이라고 부를 수 있습니다 망설이지 마 도망치지 마 늘 곁에 있어줘나는 그것을라고 부를 수 있습니다 나도 몰래 다가오는 설렘에 당신은 그것을이라고 부를 수 있습니다 사랑을 사랑할 사랑이라고 부릅니다 오늘 하루는 아무런 걱정만 너의 날인 당신이 나를 너무 원한다는 앓아 눈빛이 언제부턴가 내게 말하고 있거든 어린아이 같은 숨길 수가 없는 두근거림조차 느껴져나는 사랑 받고 싶다 내게 다가와 손을 잡을게 눈에 너를 담으려나는 그것을라고 나도 몰래 찾아오는 설렘에 당신은 그것을 사랑이라고 망설이지 마 도망치지 늘 곁에 있어줘나는 그것을라고 다가오는 그것들이라고 사랑을 사랑할 부릅니다 모든 변해 상처받을 바엔 혼자가 편해진 심 없는 만남 이별 표정은 태연해하며 떼어냈던 안의 사랑 잠들어있던 사랑을 일깨워준 사람 가벼운 관계 배려 말투에 다운되어 있던 뻔한 일상과 작별할 때야 새로운 사람 인사해 새로운 나날 반가운 아침을 맞이해 오늘은 최고의 날이야 밝은 미소에 일주일을 버텨 일이 바빠도 해 본적 걱정 주말에 가고 싶은 곳이 많아졌어고마워 나의 진짜 모습 알아줘서 너무 행복해 네가 여자라 역시 나와 같은 마음이라는 알아급하게 가지 말자 천천히 느낌 오래 간직하고파 영원히 찾아오는 그것을 망설이지 도망치지 늘 곁에 있어줘나는 다가오는 그것을이라고 사랑할 부릅니다,0,1,8,0,8
151,매일 하늘을 오르내리는 같아널 보고 있을 때면 정말로 우린 커다랗게 사랑하고 있는 거 맞지 그치네 눈엔 너무나 커 보이는데 사람들 눈엔 작아 보인데 일까 너의 마음은 내게 마음 같지 않은 걸까 아름다운 그대에게 영원히 남고 싶어널 지켜주고 싶어아름다운 그대에게 내가 너의 하늘이 되어줄 수 있다고 하이 하이 하얀 아름다운 그대 맘과 같나요 당신과 사랑에 빠졌습니다 하이 하얀 아름다운 우리네 맘속에 번져가네 우리는 너무 아름다워 넌 날 생각해 눈엔 너무나 커 보이는데 사람들 작아 보인데 일까 너의 마음은 내게 마음 같지 않은 걸 꺼내 마음 같은 곳을 보니까 알아 하나뿐인 나만 마음을 바니 말 하나하나에 하루가 결정돼 난내 날개는 앞에서만 반응해 벼랑 끝에 막혀도 너니까 가능해 날개를 펼치면 당신은 나와 날지 않을 것입니다 나에게 사랑을 주지 않을래아름다운 그대에게 영원히 남고 싶어널 지켜주고 싶어아름다운 내가 하늘이되어줄 수 있다고 하얀 그대 맘과 같나요 당신과 사랑에 빠졌습니다 우리네 맘속에 번져가네 우리는 너무 아름다워아름다운 영원히 남고 싶어널 지켜 주고 싶어아름다운 내가 하늘이 되어줄 수 있다고 지켜 주고 너만의 하늘이 되어줄,0,1,5,-1,4
152,그녀가 사랑스럽지 않아 그녀는 훌륭하지 않다 그녀는 분 귀중한 분 사랑을 통해 결코 사랑을 통해 우리가 사랑스럽지 않다고 생각했지만 그녀가 사랑스럽지 않다 천사의 최고의 소년 너무 행복해서 우리가 천국이 되어 축복을 받았습니다 하나님께서 우리를 통해 우리를 행하신 일을 믿을 수 없습니다 인생은 그녀의 이름의 의미 론 디아 의미 론디입니다,0,1,7,3,10
153,뭐라도 말할 있는 것처럼 불러 놓고 분도 못 참고 일어서서 나가고 말걸 안아주기를 대뜸 원한 것도 잊어주기를 대뜸 말한 것도 롤링 될 거야 굴러 갈 거야 사랑이 이리 힘든지 두고 볼 굴러 갈 거야 다 온 같아졌어 됐어 이게 다라면 뭐라 하겠어 너무 많이 됐건 됐건 시간이 됐다 믿어안아주기를 대뜸 원한 것도 잊어주기를 말한 롤링이 될 롤링이 롤링 될 사랑이 이리 힘든지 두고 볼 굴러 갈 다 온 같아 어떨지 모르는 걸 괜히 마음만 너에게 뺏겼나 아냐 아냐 안아주기를 원한 잊어주기를 말한 롤링이 롤링 사랑이 이리 힘든지 두고 볼 다 온 같아 같아,0,1,-1,2,1
154,넌 몰랐겠지만 사랑은 허구입니다 이미 모든 건 다 정해져 있는 걸 그대 넌 운명이야 첨 본 순간부터 시작된 이야기 넌 신데렐라 하나뿐인 왕자는 나잖아 늘 곁에 있을게 웃어줄게 그냥 있으면 돼 이제야 말하는데 널 만난 건 맹세코 절대로 우연히 아니야 이제야 고백하는데 네가 나를 만나기 전부터 여자였어 당신은 나를 느끼게 합니다 사랑은 소설 다 널 위한 소설 진심인 걸 당신은 나를 가져 가게 합니다 시작된 거야 너와 나의 사랑 소설 고백하지만 사랑은 허구입니다 이미 너의 맘을 다 알고 있는 걸 그대 당신은 햇살입니다 잠 못 들게 하는 카페인 어린 왕자 늘 너에게만 기대고 싶은 어디서나 편이 돼줄게 그냥 있으면 돼 이제야 말하는데 널 만난 건 맹세코 절대로 우연히 아니야 고백하는데 네가 만나기 전부터 여자였어 사랑 사랑 달콤한 로맨스 그대와 유치한 이야기 그대와 영원히 너만을 사랑해 말하는데 만난 맹세코 절대로 우연히 아니야 고백하는 데니까 만나기 전부터 여자였어 느끼게 합니다 위한 진심인 가져 가게 시작된 거야 너와 나의 너와 나의,0,1,6,3,9
155,내가 노래를 들려줄게 내가 휘파람 불어줄게 맑은 너의 눈 보며 맨발의 널 보며 마음도 깨끗해져요 우린 너무나 먼 곳에 한참을 달려도 널 만나 행복해졌어 이제 노래를 들려줄게 내가 염소를 선물할게 신발을 신겨줄 벅찬 모습 보며 웃는 너를 마음도 행복해져요 우린 너무나 먼 곳에 떨어져 있지만 널 도와 행복해졌어 이제 노래를 들려줄게 이제 너에게 선물할게,0,1,2,1,3
156,사랑 사랑 사랑 사랑을 주는 사랑보다 사랑해 당신은 너무 산만해요 식으로 느끼기 내가를 만났기 관심을 유지할 수 없고 당신은 사랑을 비난해야 한다 내용은 컨트롤에서 벗어났을 당신의 손에 빠졌고 우리가 어디에 있는지 모르겠다 도망치고 싶다 두 세계가 되십시오 사랑은 영구적인 산만함 완벽한 상호 작용 느낌이 너무 극단적인 식욕을 잃어버린 식욕을 잃어버렸습니다 이것은 컨트롤에서 벗어났고 당신의 손에 떨어졌고 우리가 어디에 있는지 모르겠다 마음을 위해 당신의 사랑은 비가 내린 것보다 큽니다 당신이 꿈에 빠졌고 내가 강하다고 생각했지만 모든 것을 알고 있다고 생각했지만 이것은 컨트롤에서 벗어났습니다 손에 떨어졌고 우리가 어디에 있는지 모르겠다,0,1,1,5,6
157,당신은 맘 모르고 있게죠 떨리는 맘 모르고 있겠죠 그대만 보면 뛰는 가슴 아마 상상도 못하겠죠 오늘도 그댈 멀리서 보았죠 항상 이렇게 주위만 맴돌죠 할 말이 너무도 많지만 그대 앞에선 말 못 하죠 그대를 보면 사랑이 보여요 그대 웃으면 사랑이 웃어요 그대 날 부르면 사랑이 날 불러요 없으면 사랑도 없어요 떠나면 사랑도 떠나요 내게 오면 내게 와요 언젠간 고백할 수 있을까요 내게 그런 용기가 있을까요 마음 전하기도 전에 떠나면 어떡하죠 것인가요 이렇게 가슴 아픈 것인가요 그댈 바라보는 눈에 눈물 고이는 것인가요 그대를 보면 보여요 웃으면 웃어요 날 부르면 불러요 없으면 사랑도 없어요 떠나면 떠나요 오면 와요,0,1,3,3,6
158,지내세요 괜찮아요 감사합니다 오가다 하는 인사말 언제쯤 들을까요 당신을 사랑합니다 당신이 가까이 있어 그것만으로도 꾹 참고 기다려요 사랑해 지내세요 괜찮아요 감사합니다 그대와 나의 암호죠 느낄 수 있잖아요 당신을 사랑합니다 마음이 너무 환해져 가슴이 벅차오네요 사랑은 이런가요 당신을 사랑합니다 고등학교 학년이고 열여덟 풍선처럼 부풀었던 감정 무섭기만 했던 부모님 속이고 큰맘 먹고 갔던 그곳 여름 날 바캉스 기차 안에서 마주쳤던 두근대는 맘 뒤로하고서 그대와 다시 멀어지고 아쉬워 어머 웬일이니 해변가에서 마주친 너와 어쩜 한마디도 건네보지도 못하고 서울로 돌아오고 한 달 두 달 세 달 만화 속 주인공이 되어버렸죠 예전 그대 모습 그리며 다시 보기만을 기대하면서 밤새 별을 보며 기도하면서 당신은 지내세요 감사합니다 오가다 하는 인사말 언제쯤 들을까요 당신이 가까이 있어,0,1,1,3,4
159,금요일에 토요일에 놀고 싶어우 난도모 챠쿠신노첵쿠시테 미테모당신은 나타나지 않을 것입니다우우 콧치카라 카케테모 이이케도내 자존심은 친구가 계속해서 당신에게 좋지 않다고 말하는 방식에 도달합니다 안나야츠 홋토키나볼이 너무 많아요요이 히토니데아우 챤스와 아루시킹요 비노 스카라니키미오 와스레니오도리아카스요 콩야이 노래를 부를게요토도쿠요니세츠나이 메로디니나미다 시나이요니 쿠루니네오도리츠 즈케사세테네 는 다시 오지 않을 것입니다후로아 오못토 아츠쿠히비카세테응아사마데 마와시츠즈케테카에리타쿠 나이카라 토메나이데 쵸쿠츠코레 아스트로시레테루하즈모 이와즈토이후로 계속하츠토죠미미카라 하나레루 코토네 흐름캇소로 절하다쥬단 토츠뉴 아라유루 쿠칸아라유루 슈하스침략 입체 게쥬츠 누구를 말 해주세요로쿠만도루노 휴만내에 진정해소라 토부 쥬탄 입니다슈단클럽을 많이 지키십시오소시아루~보다아후로큐방 도카시테쿠제 미치후사스루 야츠라케토바스 코레 슈캉그것에 낙지하지 않습니다다마라스 나쿠 코토리마키 쿳챠우 후론토 아쿠토이 마이크는 라이브 와이어 와이어 라이브 와이어스 흐름이 라이브 와이어 와이어즈 바닥은 와이어입니다 콘나니 맛테테모키미니 사레루시우우 츠마라나이 칸케나라바내 친구가 친구를 계속 찾아야한다고 말해주지 그래츠메타쿠나쿠테 야사시특별한 는 당신을 정중하게 대합니다닷테 소레가 후츠다시요나카 스기루코로니와키미요리 호카노 스테키나히토토 콩야우리는이 노래를 부를 것입니다소 스나오니요리소 후타리 카라다가칸지루 마마니네오도리츠 즈케사세테네 는 다시 오지 않을 것입니다후로아 오못토아츠쿠 히비카세테응아사마데 마와시츠즈케테카에리타쿠 나이카라 토메나이데 오쿠렌나요내려 가서 바닥 파티로 내려 가서피포 피포 오세요에교세소시테 휘에스타 웨스탄 보니포리에스타 샤츠에리다케 쿄다이~을 체크 해봐스니카노 소자이와니가와나는 시간의 사람입니다키미타치 비리내 연인이 아니라 진처럼샤바다바 살입니다후리스비니 스루제 왁쿠나 사라당신의 스타일은 치즈와 게이입니다다카라 그것은치카마나는 당신의 도시를 통해 입니다쿄와 사타데멍청하고 멍청한오도리츠 즈케사세테네 다시 오지 것입니다후로아 오못토아츠쿠 히비카세테응아사마데 마와시츠즈케테카에리타쿠 나이카라 토메나이데금요일에 토요일에 놀고 싶어카스기루 코로니와키미요리 호카노 스테키나히토토 콩야우리는이 노래를 부를 것입니다소 스나오니요리소 후타리카라다가 칸지루마마니네오도리츠 오못토아츠쿠 히비카세테응아사마데 토메나이데킹요비노 스카라니키미오 와스레니오도리아카스요 콩야이 부를게요토도쿠요니 세츠나이 메로디니나미다 시나이요니 쿠루니네오도리츠 토메나이데,0,1,-2,0,-2
160,언제쯤 그대는 얘길 내게 할는지 매일 헤어지는 건 싫다는 그런 얘기 한 번쯤 그대도 나와 같은 생각하는지 매일 혼자서 상상만 하죠 꿈 들새 하얀 집을 꾸미고 작은 정원을 가꾸는 꿈 그렇게 될 수 있다면 세상 모든 걸 가진 거야 둘이서 찍은 사진을 보며 그대 오길 기다리며 언제나 눈부신 아침을 너의 옆에서 만나는 꿈 한 번쯤 그대도 나와 같은 꿈을 꾸는지 매일 혼자서 상상만 하죠 들새 하얀 집을 꾸미고 작은 정원을 가꾸는 그렇게 될 수 있다면 세상 모든 걸 가진 거야 둘이서 찍은 사진을 보며 그대 오길 기다리며 언제나 눈부신 아침을 너의 옆에서 만나는 꿈가만히 눈 감고 그때를 생각하면 어색하긴 해도 나도 몰래 웃음 지으며 행복해 하죠새하얀 집을 꾸미고 작은 정원을 가꾸는 그렇게 될 수 있다면 세상 모든 걸 가진 거야 둘이서 찍은 사진을 보며 그대 오길 기다리며 영원히 눈부신 아침을 너의 옆에서 맞고 싶어,0,1,-1,0,-1
161,창문을 두드리는 깨끗한 빗소리에 널 만나기 전 설렘이 더해가고 영화를 보러 갈까 어디로든 떠나볼까 투명하게 물든 거리를 걸어볼까 가까이 작은 우산 속에 한쪽 어깨 끝이 다 젖어도 좋은 걸 널 사랑하나 사랑에 빠졌어 기분 좋은 느낌이 변함없길 바라 널 사랑하나 보고 싶어 매일 모닝커피를 너와 들고 싶어 언제나 힘겨울 내게 올 그런 사람 애써 얘기하지 않아도 아는 사람 가끔씩 화를 내고 때론 내가 토라져도 오랜 친구처럼 살며시 나를 꼭 안아줘 조금씩 다가와 나를 보여줄게 은은한 향기처럼 나의 곁에 머물러줘 사랑하나 사랑에 빠졌어 기분 좋은 느낌이 변함없길 바라 보고 싶어 매일 모닝커피를 너와 들고 꿈은 아니겠지 비를 타고 찾아온 수줍은 사랑 너무나 행복해 언제나 투명하게 나만 사랑해줘,0,1,3,-5,-2
162,우린 첨부터 어울리지는 않았죠 단 투기만 하고 속만 태우던 사이였었는데 이상한 건요 어느새 맘이 통해서 곁에 없으면 미칠 것처럼 그댈 보고 싶은 걸 특별한 나만의 님으로 설렘이 가득 찬 선물로 점점 다가서는 그대를 어쩜 좋아요 그대 가슴이 심장이 두근두근 그대만을 사랑해 맘 가득 외치는 말도 눈을 꼭 감고서 떨리는 입술을 내민 날 보면 먼저 안아주는 그댈 꿈꾸고 있죠 그대에 기대어 잠든 척했었던 날 나보다 큰 그대의 심장 소리가 들려 왔죠 숨결도 감출 수 없는 건 꿈에도 원하고 있는 건 세상 무엇보다 소중한 한 사람 그대 가슴이 심장이 두근두근 그대만을 사랑해 맘 가득 외치는 말도 눈을 꼭 감고서 떨리는 입술을 내민 날 보면 먼저 안아주는 그댈 꿈꾸고 있죠에 미 알고 있어요 그대 나와 같단 걸 눈부시게 심장 속에 새겨진 사랑인 걸 영원히 심장이 두근두근 그대만을 사랑해 맘 행복한 말도 활짝 펼쳐서 떨리는 가슴을 내준 그대여 최고의 사랑을 안겨 줄게요,0,1,9,3,12
163,옆에 서십시오 날 바라봐 줘 아직 사랑을 모르지만 옆에 서십시오 날 지켜봐 줘 아직 사랑에 서툴지만 너를 볼수록 기분이 좋아져나도 몰래 노래를 불러 한 송이 장미를 사고 싶어진 모습 신기한데 마음이 너에게 닿는듯해 세상이 아름다워이런 설렘을 너도 느낀다면 부디 조금만 기다려줘함께 사랑하게 만듭니다 너의 환한 미소 가득히 사랑하게 만듭니다 이제 손을 손을 잡아내 옆에 서십시오노를 바라봐 줘 아직 사랑을 모르지만 서십시오노를 지켜봐 사랑에 서툰 같아 너를 알수록 가슴이 떨려와나는 웃고만 있어 너에게 살며시 키스해볼까 맘에 다 가설 까네 마음이 어쩌면 사랑일까 아직은 수줍은데 한 걸음도 다가서지 못한 나의 사랑을 기다려줘함께 사랑하게 만듭니다 너의 환한 미소 가득히 이제 조금씩 조금씩 갈게 서십시오노를 바라봐 가까워지고 싶어내 지켜봐 멋지게 보이고 싶어난 처음엔 몰랐어 누군가 바라보는 아직도 마음 몰라 그대는 그대를 사랑해함께 너의 환한 미소 가득히 이제 손을 잡아내 모르지만 사랑에 서툰 같아,0,1,8,-4,4
164,세상을 몰랐었던 마냥 웃기만 했던 푸른 하늘 닮은 꿈을 가진 키 작은 꼬마가 어느새 담을 넘는다 언덕 위로 좁게 트인 작은 길 어디로 가는 걸까 작은 돌에 그만 넘어져도 일어나 다시 길 걸어보렴 더디면 어디든 한 걸음씩 너무 행복합니다 너의 손을 잡고서 너와 발을 맞추며 가자 우리는 춤을 추고 있습니다 서두르진 마 익숙한 멜로디를 불러봐 후루루 후루루 너를 위한 멜로디 후루루 누구도 상상 못 할 내일이 오겠지 소나기에 자라난 무지개를 빌려다 포켓 속에 가득 꼭 넣어두렴 주문을 외워 괜찮을 거야 한 걸음씩 너무 행복합니다 너의 손을 잡고서 너와 발을 맞추며 가자 우리는 춤을 추고 있습니다 서두르진 마 이제 익숙한 멜로디를 불러봐 너를 위한 멜로디 하늘 아래 누워 쉬어가도 돼 눈을 감아도 보이는 너를 닮은 별 찾아 고맙다는 인사를 건넨다 크게 너야 한걸음 너무 행복합니다 다시 밝아온 아침 머나먼 여행을 떠나자 우리는 속합니다 혼자가 아냐 영원히 위해 불러줄 멜로디로 루루 우릴 위한 멜로디로 루루 지금 앞에 있는 내가 찾던 세상,0,1,3,3,6
165,그대에게 불러주고 싶은 노래들을 틀어놓고 수많은 마음들을 뭐라고 전할까 생각해요 그대에게 들려주고 싶은 이야기는 많은데 수줍은 나를 기다려줘요 이미 지나가 버린 사랑의 기억을 질투해 가끔 잠 못 이루다 가도 결국엔 결국엔 그대는 나에게 늘 새로운 사랑 이예요 그대와 맘이 늘 똑같지 않다 해도 그대는 나에게 늘 새로운 사람이에요 이미 지나가 버린 사랑의 기억을 질투해 가끔 잠 못 이루다 가도 결국엔 그대는 나에게 새로운 사랑 이예요 그대와 맘이 똑같지 않다 해도 사람이에요 해가 떠오를 때부터 해가 질 때까지 달이 떠오를 때부터 잠들 때까지 해가 떠오를 때부터 질 때까지 달이 잠들,0,1,2,-2,0
166,처음 너를 본 순간 정신 차릴 수 없어내 마음을 들킬까 조심조심해 어떡하면 맘을 답답해진 맘을 쫄깃해진 심장이 어쩌면 좋아가까워졌다 점점 멀어져 가는 이상해울다가 웃다 내버려 둬요 언제나 이랬다 저랬다 헷갈려 그녀는 맘을 들어다 놨다 들었다 놨다 들었다 놨다 들어다 들었다 들어다 다시 너를 본 순간 차갑게 대해보려 애써 관심 없는 듯이 외면했지만 너의 눈빛 하나에 너의 손짓 하나에 바짝바짝 말라버려 나의 입술은 멀어져 갔다 다시 다가와 주는 오늘도 울다가 웃다 점점 짜증이 나오 언제나 이랬다저랬다 헷갈려 그녀는 봐들어다 어떡 하면 그녀를 맘속에 가둬 수 있을까 봐들었다,0,1,-1,11,10
167,거짓말처럼 앞에너가 내게 말 걸어줬으면 해넌 아마 모를 거야당신은 나에게 모든 것을 의미합니다넌 생각해소녀 다이빙을하러 가려고 다이빙을 할 때나는 여잔 필요 없어물론 여자들도 내겐 관심 없어내가 못나서 라면그거는 아니고 잘중요한 건난 그냥 마녀에게 시간을 보내고 싶어요넌 대체 생각하는데음 타입이 아기라고 생각하게 해줘머릿속에만 맴돌아나오지 않아 입 밖엔너를 대체 해 그냥 내게 해주세요잠깐만 잠깐만 난너의 수영장에 빠진 같애 괜찮아 괜찮아 괜찮아너의 미소만 보면 다 좋았어요거짓말처럼 앞에너가 내게 말 걸어줬으면 해넌 아마 모를 거야당신은 나에게 모든 것을 의미합니다넌 생각해나는 다이빙을하기 위해 다이빙하기 위해 다이빙하기 위해 다이빙을하기 다이빙을하기 멍청한다 너도 잘 알잖어너의 인스타그램을 보느라밤잠도 안 자고 이러고 있어넌 카페인으로 가득 찬 어항이 밤보다 깊어진 건나의 마음인 싶어기다려 너의 전화거리를 둬 봐도 너무 빡빡합니다무더운 성수기의 콘도멀지도 가깝지도 않은 사이너에게 달려갈게 프론트로내일은 같은 방에서새 아침을 맞으며 말할게 많이 남는 날엔너랑 있고 싶고날이 맑은 날엔 달리고 싶어나쁜 날엔 너랑 쉬고 싶지사실 날씨 따윈 아무 상관 없지같이 있는 마냥 좋지뭐가 가치있는 일인지모르겠지만서도그냥 너에게로깊게 빠질 거야우리는 너와 젊은날의 아까운여름 시간내 마음은 너무 더운해태양인 걸 오늘 밤그렇다면 밤에 뭘 하면 좋을까시원한 너를 향해 빠져야겠어 다이빙을 할,0,1,1,3,4
168,하늘을 빨간 망토의 까만 고양이 꼬리가 달린 옆집 언니 밤마다 가요 꼬리를 무는 엉뚱한 생각 나도 멈췄으면 해 도대체 넌 커서 뭐가 될래 제일 많이 듣는 얘기하지만 알지도 못하는 사람들에게 일일이 설명하고 싶지 않아 진짜 나의 모습 애라는 걸 잔인한 말의 사람들 속에서 상처라면 이미 많이 받은 걸 이대로 난 나를 숨겨 놓을 거야 콧노래를 부르며 걸어가면 세상은 마법의 빛에 쌓이고 어제의 싫은 잊게 되는 걸 이해할 수 없는 세상에서도 이대로라면 행복한 가만히 상상 속에 앉아서 쉬는 날엔 싫은 나를 잊으려고 해 쉬는 날엔 싫은 너를 가리려고 해 달나라로 가는 황금마차 과자로 진집 콜라의 샘 알지도 못하는 사람들에게 일일이 설명하고 싶지 않아 진짜 나의 모습 애라는 잔인한 말의 사람들 속에서 상처라면 이미 많이 받은 이대로 난 나를 숨겨 놓을 거야 콧노래를 부르며 걸어가면 세상은 마법의 빛에 쌓이고 어제의 잊게 되는 걸이해할 수 없는 세상에서도 이대로라면 행복한 가만히 상상 속에 앉아서,0,1,-2,1,-1
169,힘들었겠지 하루가 유난히 길었을 거야 지금 내가 데리러 갈게 지쳐있을 모습에 바뀌는 빨간 신호등에 괜히 맘이 조급해 너를 위해 베이비 너를 위해 베이비 뭐든 다 말해도 돼 내가 다 들어줄게 원인 당신에게 좋습니다 오늘 밤 나와 샴페인 어때좋아하던 카페에 라테는 오키아너하고 싶었던 거 다 얘기해줘 아기는 걱정하지 마세요 당신을 위해 잘할 수 있습니다 피곤할 텐데 졸아도 돼 어차피 차도 막히는 데다와 갈 때쯤 깨워줄게 너를 베이비 아무 말 안 해도 돼 내가 알아줄게 원인 당신에게 좋습니다 오늘 밤 나와 샴페인 어때좋아하던 카페에 라테는 오키아너하고 싶었던 거 얘기해줘 아기는 걱정하지 마세요 당신을 잘할 수 있습니다 지치고 우울하다 느낄 때아닌 꼭 않아도 나를 불러줘 옆에 있을게 연애 바비가 나를 들여보냈다오 늘 밤 나와 샴페인 어때좋아하던 카페에 라테는 오키아너하고 싶었던 거 얘기해줘 아기는 걱정하지 마세요 당신을 잘할 수 있습니다,0,1,-4,-6,-10
170,오늘 유난히 헝클어진 머리 너무나 맘에 안 들어 소개로 만난 새침한 애와 약속했는데 대가 직접 써준 전화번호 야릇한 느낌처럼 들뜨는 마음 진정시킬수록 이상한 웃음만 나네 밉기만 하던 동네 아이들이 이리 귀엽게 보이고 거리는 온통 그대 향기니 그대를 사랑하게 된 걸까 떨렸던 마음은 반기는 그대 웃음에 날아가 버리고 나를 나를 부르는 그대 입술에 입 맞추려고 했지만 용기가 없어 순간을 기다려 왔는지 네가 나를 좋아하는 진짜 맞는지 떨리는 맘 그댄 맘 혹시나 알고 있을까 모르는 나을까 너와 함께라면 모든 다 아름다워 평소엔 지저분하다 생각했던 골목길마저 젠틀한 미소 향긋한 향기도 다 꿈만 같아 영원하리라 믿어밉기만 하던 동네 아이들이 이리 귀엽게 보이고 거리는 온통 향기니 그대를 사랑하게 떨렸던 마음은 반기는 웃음에 날아가 버리고 부르는 입술에 입 맞추려고 했지만 용기가 없어 떨렸던 마음은 반기는 웃음에 날아가 버리고 부르는 입술에 입 맞추려고 했지만 기회에,0,1,7,2,9
171,매일 아침 똑같은 시간에 정류장에 서있는 그대 고개 돌려 눈 마주친 순간 두근거리는 가슴 애써 먼 곳을 바라보면서 콧노래도 불러 보지만 이미 들켜버린 뜨거워진 얼굴 숨어버리고 싶은 기분 그대 일하나요 그대 여자친구 있나요 그댈 조금만이라도 알고 싶은데 이미 사라져버린 버스에 탄 오늘 하루 종일 생각이 아무 일도 손에 안 잡혀 내일 혹시나 그댈 만나면 다시 한번 용길 볼래 이름이 뭔가요 즐겨 듣는 음악 뭔가요 그댈 조금만이라도 알고 싶어요 이미 마음속에 가득 찬 대시 간 있나요 너무 뜬금없는지 두 눈을 깊이 들여다봐요 그대를 향한 나의 진심이 보이나요 노랠 불러요 남자친구도 없어요 우린 좋은 친구가 될 수도 있어요 사람인가요 말해 줘요 조금만이라도 알고 싶어요 시작된 걸까 우리만의,0,1,2,-4,-2
172,지겨운가요 힘든가요 숨이 턱까지 찼나요 할 수 없죠 어차피 시작해 버린 것을 쏟아지는 햇살 속에 입이 바싹 말라와도 할 수 없죠 창피하게 멈춰 설 순 없으니 단 한가지 약속은 틀림없이 끝이 있다는 끝난 뒤에 지겨울 만큼 오랫동안 쉴 수 있다는 지겨운가요 힘든가요 숨이 턱까지 찼나요 할 없죠 어차피 시작해 버린 것을 쏟아지는 햇살 속에 입이 바싹 말라와도 창피하게 멈춰 설 순 없으니 이유도 없이 가끔은 눈물 억울하겠죠 일등 아닌 보통들에게 박수조차 남의 일인 걸 단 한가지 약속은 틀림없이 끝이 있다는 끝난 뒤에 지겨울 만큼 오랫동안 쉴 그것은 나에게 충분히 좋다는 나에게 충분하다,0,1,-3,-5,-8
173,그랬어 가서 차이고 찾지 마 얼굴만 보더니 내가 뭐랬어 이렇게 될 말 들어 뭔 얘긴데 누구를 만나도 맘에 안 드니 뭐가 문제야 맘대로 여자친구가 없지 그만 해 제발 부탁이야 날 언제까지 동생으로만 남자고 너는 여자라고 잔소리쯤은 이겨낼 수 있다고 헤어지는 이유는 한 가지야 처음부터 말곤 없었어 잘난 스펙 봐에 잘 자리 잡은 식스팩 이래도 내가 남자로 안 보여내 특기는 변신술이야 오빠나 동생 친구 뭐 원하면 아빠까지도 솔직히 같은 남자가 어딨어나는 남자고 너는 여자라고 잔소리쯤은 이겨낼 수 있다고 남자고 너는 여자라고 잔소리쯤은 이겨낼 수 있다고 우린 할 거냐고,0,1,-1,2,1
174,날 사랑한다는 말 번이나 해줬나요 변치 않는다는 말도 진심인가요 첨엔 나를 좋아한다 했죠 나도 그래요 그댄 나의 꿀 꿀 아기 꿀 베이비 사랑 사랑 내게 와줘요 아기 첨엔 나를 좋아한다 했죠 나도 그래요 그대는 나의 아기 베이비 사랑 베이비로 내게 와줘요 베이비로 내게 와줘요 베이비로,0,1,1,-4,-3
175,걸렸어 널 보는 눈빛이 무심한 척 잘 숨겨왔었는데 땜에 잠도 못 자고 땜에 밤새 설레는데 이제는 솔직히 말해볼래 떨어지는 꽃길만 걷게 해줄게 맘에 쏙 들게 할게 널 알게 된 순간부터 머릿속엔 온통 너뿐이야 항상 널 웃게 해줄게 오랫동안 느껴왔어 누구보다 떨어지는 떨어지는 알겠어 날 보는 눈빛이 너도 바라고 있던 거야 잠 못 들지 마 고민하지도 마 이제는 너만 바라볼게 꽃길만 걷게 해줄게 맘에 쏙 들게 할게 알게 된 순간부터 머릿속엔 온통 너뿐이야 항상 웃게 오랫동안 느껴왔어 누구보다 꽃길 만 걷게 길을 걸을래 매일 설레게 할래 알게 된 순간부터 말하지 못한 아껴왔던 말 꽃길만 오랫동안 꿈꿔왔어 누구보다 꽃길 위를 걸어가는 베이비 베이비 베이비,0,1,1,-4,-3
176,예쁜 너를 위한 노래 이거 러브 송이 노래의 노래의 노래 넌 괜찮아 부사랑은 달콤 쌉쌀해 넌 나를 밀어내 어딜 가도 꿀린 적 없어 근데 너에겐 무릎 꿇게 돼 작업도 안 통해 넌 날 모른 척 없는 척해 날 자존심도 없는 그런 남자로 생각하겠지만 아픈데 네가 소녀 좋은데 아파 맘을 몰라넌 제발 내게로 와줘 당신을 사랑합니다우쭈쭈쭈쭈쭈 널 안고 싶어온 추 슈츠 추 여자친구 돼줄래 아름다운 여자를 들어보세요 가서 나도 내가 제일 잘나가 남자가 어딨어 요즘 세상에 어머나 세상에 너무나 속상해 자존심 상하게 딴 데 보는 가야 날 봐줘 맘 받아줘 해바라기 같은 몰라줘 가슴 아픈데 좋은 심리는 뭐야 사랑해네 여자 친구가 되세요 나에게 눈길도 안 주는 보는 척 마는 척해 그런 상관없어 결국엔 너는 거 될 테니까 아픈데 네가 소녀 좋은데 아파 맘을 몰라넌 제발 내게로 와줘 당신을 사랑합니다우쭈쭈쭈쭈쭈 널 안고 싶어 여자친구 돼줄래 당신을 사랑해 꽉 잡고 싶어 뭐래도 좋아난 네가 영원히 좋은데 아파 맘을 몰라 널 사랑해 사랑해 갖고 싶어져 추 슈츠 축내 맘 받아 거니 사랑합니다 당신은 사랑합니다,0,1,4,-4,0
177,베이비 당신은 준비되어 있습니까 지금 나와 어디든 가자 지루한 하루 여기까지만 정지 작은 가방 운동화 챙겨 크게 라디오를 높이고 코발트블루 물결 눈부신 바다 달빛 가득 묻은 작은 섬이 야경이 눈부신 도시는 함께라면 어디든 너와 그곳으로 떠나는 거야 상상에 상상에 상상을 더해서 어머 깜짝이야 눈부셔 눈부셔 눈부셔 이건 뭐 안녕하세요 새로운 세상도 손 모아 소리치면 푸른 하늘이 내게로 날아가볼래 상상의 상상의 미래로 가볼까 바람을 타고 새로운 눈빛에 가슴이 붐 붐 붐이 발견했어 우리들만의 파라다이스 흑백영화 같은 하루에 레몬 터지듯 짜릿함이 필요해 지금 널 데려갈게 꿈꿔오던 사진 속 그곳으로 민트 그린 빛 바람 가득한 숲속 달콤한 향기의 칵테일 지도를 벗어나 꿈에 대한 티켓 함께라면 어디든 너와 그곳으로 떠나는 거야 상상에 상상을 더해서 어머 깜짝이야 이건 뭐 안녕하세요 새로운 세상도 손 모아 소리치면 푸른 하늘이 내게로 날아가볼래 상상의 미래로 가볼까 바람을 타고 눈빛에 가슴이 붐 발견했어 우리들만의 너와 나의 비밀스러운 풍경들언제라도 다시 주겠니 은하수 아래 밤새 부른 노래 영원히 잊지 않을 거 속에 영원히 품에 안기고 싶은 걸 단둘이 순간 잠들고 싶은 걸지도 엔 없는 이곳을 꼭 기억해줘 우리들만의 파라다이스 상상을 더해서 어머 깜짝이야 이건 뭐 안녕하세요 세상 처음 만난 세상 속에 나의 가슴이 라 라 라 날아가볼래 미래로 가볼까 바람을 타고 눈빛에 붐이 발견했어 만의 파라다이스 준비하십시오 내가 준비했어 베이비 당신은 준비되어 있습니까,0,1,2,4,6
178,두근거린 느낌 가슴 설렌 마음 이렇게 멍하게 바라만 어제와 똑같이 널 바래다주면 돌아선 모습에 번이고 고민해 자꾸만 뒤에서 널 바라만 계속 너의 뒤에 서면 용기 있는 멋진 남자 앞에선 쳐다보지도 못해 이제는 걱정 말고 그냥 확 나의 뒤에 서서 망설여 계속 이대로 안을까 말까 안을까 말까 널 오늘은 꼭 따뜻한 가슴에 너를 안을까 말까 너무 망설여져 또네 이건 엄마입니다 보통 뒷모습이 아름다운 여자는 그리 예쁘지 않다고 하던데 넌 어디서 봐도 너무나 예뻐안을까 고민하는 사이 생각을 다 눈치챈 듯이 어느새 멀리 가버린 그대 날 밀고 당기나요 나의 모습 실망하진 않을까 위한 거라고 변명이라도 할까 손잡을 때처럼 그냥 물어볼까 오늘도 수없이 머리가 복잡해 자꾸만 날 보면 방끗 미소를 띠면 준비한 말도 입에서 나오지가 않아 오늘도 이렇게 너를 뒤에서 바라보면 오늘은 아무 생각 말고 그냥 확 나의 뒤에 서서 망설여 계속 이대로 오늘은 꼭 따뜻한 가슴에 너를 너무 망설여져 고민하는 나도 행운이야 같은 여자와 하니까 언제나 할 순 없겠지만 지금 순간은 행복하니까 당신은 행운의 스타입니다 별들은 많잖아 그중에서도 특별한 뭐 말로 표현이 다 안되겠지만 오늘도 이렇게 너의 앞에 서서 널널 향한 마음을 꼭 보여줘 안아 버릴래,0,1,8,-2,6
179,넌 내가 지킨다 어떡해 마법이 풀리질 않아 어쩌다 어쩌다 이렇게 됐니 태양보다 뜨거운 맘 어쩌면 어쩌면 사랑일 거야 당신은 나를 높이 데려가서 나를 너무 높게 날아라 풍선처럼 두둥실 떠올라 맘을 매우 흔들어 놓아난 너의 기쁨 슬픔 다 꼭 끌어안고 너만 알겠어 사랑보다 깊은 감정을 느껴 지금 누구보다 약하면서도 강해그래 운명 따위는 내가 다 바꿀 당신이 나에게 나쁜 말을 할 아기 아기 눈물이 흘러도 닦아줄게 이별 따위랑은 이제 이별해크게 소리쳐 어린 소녀 말로도 어린 소녀 널 꾸밀 수 없어 사랑보다 사랑 같은 당신은 어린 소녀입니다 세상 모든 걸 다 잃는다 해도 운명보다 운명 같은 날 넌 내가 지킨데 넌 지킨다 지킨다 마법이 풀린대도 어쩌다 그럴지라도 태양이 빛을 잃는다 해도 날 믿어 날 믿어 우리는 무언가가 될 수 있습니다 꽃잎이 져도 매일 그대 곁에 있을게 시간이 내게 준 지금이라는 보물 너그래 머리부터 발끝까지 내게 기대내 전부를 걸겠어 사랑보다 깊은 감정을 느껴 지금 누구보다 약하면서도 강해그래 운명 따위는 바꿀 당신이 나에게 나쁜 말을 할 아기 눈물이 흘러도 닦아줄게 아름다움 앞에 상냥해지는 소리쳐 말로도 소녀 널 꾸밀 수 없어 사랑 같은 당신은 소녀입니다 세상 모든 걸 소녀다 잃는다 해도 운명보다 더는 없어 외로움과 계절을 뛰어넘어온 세상이 너로 꽉 찼는걸 당신과 소녀를 압니다 널 위한 멜로디 소녀목 터져라 불러 큰 사랑 노래야 소녀입니다 세상이 우릴 속일지라도 운명보다 지킨데 지킨데 너만을,0,1,1,1,2
180,오늘은 얘기해야 될 거 같아 다시 정리할래 너와 나의 관계 너와 보기도 오래 봤지 우린 좋은 친구야 매일같이 붙어 다녔지 넌 식구야 비밀까지 믿고 말할 수 있는 넌 특별하고 소중한 친구야 친구라 서로 기대고 때로는 취해 치대고 서로의 기대에 못 미쳐 어어 가끔 삐대고 그렇게 넌 모든 걸 다 알았지 하나만 빼고 그동안 꾹 참았지 참고 참았지 말하려다 말았지 널 생각하는 마음은 우정과는 달랐지 혹시나 사이 멀어질까 착각이라고 날 속이면서 살았지 애달프고 닳았지 맘은 겉은 웃지만 힘이 들어 안은 날 똑바로 봐야 이제 네게 얘기를 하고 싶어 주변에서 중심으로 가고 싶어 이제는 말하고 싶은데 여태 있는데 아마 겁이 네가 떠나갈까 곁에서 곁에서 맴돌고만 있어 사실 질투가 났었어 남자와의 연애상담해줄 잘 안되길 바랐어 때론 밤잠도 설쳤어 나도 연인처럼 낮이 아닌 너의 밤을 갖기를 바랐어 너와 걸을 땐 손을 잡고 싶었어,0,1,3,-6,-3
181,날 바라보는 너를 느끼 듯이 네가 남긴 향기엔 그런 느낌이 있지 눈을 감아도 다 보이는 너의 오늘 하루 종일은 내가 없이도 그리도 아름다운지 날 울리는 널 버리는 슬픈 얘긴 하지 마요 둘이 홀로 아름답도록 세상에 날들은 너의 밤들은 같은 끝을 보고 있죠에 기 애호가 눈을 감아요 포기 포기 당신은 빛을 봅니다 안에서야 마음이 그리도 헤맸지만 길을 찾았지 아침에도 함께라면 세상 하늘을 다 끌어안고 모두에게 기쁨을 선물할 텐데 날 울리던 널 버리던 슬픈 얘긴 하지 마요 둘이 홀로 아름다웠던 세상에 날들은 너의 밤들은 같은 끝을 향해있죠에 기 애호가 잠이 들어요 손을 잡고 손을 잡고 긴 잠에 빠지고 긴 잠에 빠지고 편하게 몸을 편하게 몸을 맡기면 돼 맡기면 돼 가슴 아픈 사랑은 이제 그만 널 품고 잠이 들고 싶어 오일 수 있어 네가 원하는 모든 불난 너에게 주고 싶어 오이 밤이 남긴 것은 사랑을 믿는 것뿐 순간 우릴 덮는 슬픔과 깊은 어둠 바라면 돼 바라면 돼바라면 바라면 잘 하면 사랑하는 나라면 돼향기로운 숨결이 내게 닿을 때란 조용히 손을 잡고 눈을 감을래느껴봐 너와 이제 바람이 모던 자유로워 그게 사랑일 울리는 버리는 슬픈 얘긴 하지 마요 둘이 홀로 아름답도록 세상에 날들은 밤들은 같은 끝을 보고 있죠에 기 애호가 감아요 울리던 버리던 아름다웠던 향해있죠에 잠이 들어요 포기 당신은 빛을 봅니다,0,1,4,-2,2
182,예쁘네 오늘도 어제만큼 오늘은 예뻐졌네 말을 할 때마다 너는 못 들은 척 늘 딴 얘기를 해의 젠 너무 좋은 꿈을 꿨어 지금 말해주긴 간지러워서 말하기 싫어 건 말하면 안 된대꿈다신 꾸지 못하는 너무 기분 좋은 꿈 네가 꼭 그런 거 같은데 꿈 종일 아른거리는 너무 기분 좋은 꿈 그게 잘 어울린 대나는 그녀가 알고 있다는 것을 안다 사실 내가 봐도 근데 가끔 불안한 기분이 땐 혼자서 울적해 흠 거짓말 마 그렇게 있는 얼굴을 하고 있으면서 듣기엔 좋다 그렇긴 하네 대신 꾸지 못하는 기분 네가 꼭 그런 거 같은데 종일 아른거리는 그게 너글쎄요 당신이라면 달콤한 거짓말 내가 하지 않는다 지금 그런 눈으로 나를 바라볼 때면 네가 꼭 같은데 다시 잠들고 싶은 그게,0,1,-2,1,-1
183,깨끗한 느낌 내게 보여준 싱그러운 아침 햇살처럼 상큼한 그대만의 향기가 가슴속에 스며드는데 숙녀 하얀 작은 손을 가진 그대여 가슴 설레게 해 숙녀 따스한 눈길로 나를 보면서 웃어줄 순 없겠니 그대의 귀여운 작은 입술 포근히 느껴지는 환한 미소 긴 밤을 지새우고 싶다고 얘기할 용기가 나질 않아 숙녀 하얀 작은 손을 가진 그대여 가슴 설레게 해 따스한 눈길로 나를 보면서 웃어줄 순 없겠니 하얀 손을 가진 그대여 가슴 설레게 해 따스한 눈길로 나를 보면서 웃어줄 순 없겠니 오늘은 어쩐 일일까 그대가 보이질 않아 가슴은 초조해지고 떨리는 두 손 어떡하나,0,1,6,-8,-2
184,말할 거예요 이제 결혼해요 늦은 저녁 헤어지며 아쉬워하는 그런 일은 없을 거예요 나도 모르게 겁이 나요 꼭 붙어줘 처음부터 시작해요 우리의 당신을 믿을게요 그대에게 반한 같아 말은 안 했지만 너무 멋져 보여요 그대에게 반한 같아 말한 뒤에라도 후회하지 않을게요 두근거려요 마음으로 안아줘요같이 살아가면서 부딪치고 힘들겠죠 걱정 말아요 잘할게요 그대에게 반한 같아 말은 안 했지만 너무 멋져 보여요 말한 뒤에라도 후회하지 않을게요 말할 거예요 이제 결혼해요 늦은 저녁 헤어지며 아쉬워하는 그런 일은 없을 말은 안 했지만 너무 멋져 보여요 말한 뒤에라도 후회하지 않을게요,0,1,-3,6,3
185,옛날 옛적 언니들과 계모에게 몹시 구박받던 그녀 이름 맘도 몸도 착한 신데렐라 날 밤에 무도회 이쪽저쪽 다니다가 왕자님 만나 첫눈에 반해서 사랑에 빠져 버렸죠 주위를 둘러봐멋진 왕자님 공주님 모두들 우리를 축하해요 아직은 어리지만 그대의 존재를 믿어요 단 한 명의 나만의 왕자님을 그대만의 공주 될래요 그대에게 잘 어울릴난 공주가 될래그래 기분 기억하니 항상 하나의 두 줄을 맞춰 걸어가는 착한 난쟁이들과 행복한 백설공주도 사과를 먹고 죽음과 같은 깊은 잠이 백마 탄 왕자 달콤한 키스로 잠자는 공주를 깨워 주었죠 주위를 둘러봐멋진 왕자님 공주님 모두들 우리를 축하해요 아직은 어리지만 그대의 존재를 믿어요 단 한 명의 나만의 왕자님을 그대만의 공주 될래요 그대에게 잘 어울릴난 공주가 될래그래 공주님은 왕자님의 성으로 마차를 타고서 갔고요 둘은 행복하게 살았다죠 인생에 아직은 백마 탄 왕자님은 없지만 어딘가 그대 있겠죠 언젠가는 거 만나게 될 그댈 기다리며 꿈을 잃지 않아 어리지만그대의 존재를 믿어요 단 한 명의 나만의 왕자님을 그대만의 공주 될래요 그대에게 잘 어울릴난 공주가 될래그래 어리지만 그대의 그대 역시 나를 찾겠죠 만날 그날 올 때까지나 여기에 있어봤어,0,1,7,1,8
186,해야 할지 몰라웃질 않아도 아름다워 바라만 봐도 너무 죽겠네 코를 골아도 듣기 냄새가 나도 향기로워 씻지 않아도 너무 빛이 나서 죽겠네 이러다 미쳐 돌아 버리면 어쩌나 이러다 진짜 숨이 덜컥 멎으면 어쩌나 그대의 눈가에 눈곱이 내게는 너무 멋져요 멋져요 그대의 스타킹 뜯어진 구멍도 멋져요 멋져 요일분 일초가 보석 같아싸울 시간이 나질 않아 사랑만 해도 시간이 모질라서 죽겠네 이러다 미쳐 돌아 버리면 어쩌나 진짜 숨이 덜컥 멎으면 그대의 잇몸에 김가루 내게는 가슴이 충분치 않아도 좋아어떻게 해야 할지 몰라 웃질 아름다워 바라만 봐도,0,1,5,5,10
187,나랑 결혼해줄래 나랑 평생을 살래 둘이 알콩달콩 서로 사랑하며 닮은 닮은 낳고 천년만년 아프지 말고 살고 싶은데 솔직히 말해서 내가 널 좋아해 남자와 여자 사이에 그게 좋다고 하던데 내가 사랑할게 내가 아껴줄게 눈물이 나고 힘이 때면 아플 때면 아파할게 평생을 사랑할게 평생을 지켜줄게 너만큼 좋은 사람 만난 걸 감사해 매일 너만 사랑하고 싶어 나랑 결혼해줄래 매일이 매일이 행복에 겨워서 괜스레 내일이 기대되는 사람 이리 이리 떨리는 걸까 보고 봐도 내겐 제일인 사람 검은 머리 파뿌리 될 때까지 우리들의 생이 다 끝날 때까지 손에 물은 묻혀도 눈에 눈물 절대 안 묻혀 넌 나의 반쪽 가슴 너의 반쪽 가슴 되어 숨을 쉬는 순간순간 널 사랑해줄게 시간이 지나서 주름이 늘어나도 꼭 지금처럼 너와 영원히 할 거야 사랑할게 아껴줄게 눈물이 나고 힘이 때면 아플 아파할게 지켜줄게 너만큼 좋은 만난 걸 감사해 매일 너만 사랑하고 싶어 너는 어두웠던 삶을 밝혀주는 빛 보글보글 찌개 소리로 반겨주는 집 메말랐던 마음에 내려주는 비 사랑이란 열매가 담겨있는 시 하늘이 정해준 운명의 끈 너와 나의 만남은 천생연분 세상을 다 준대도 바꿀 수 없는 삶엔 평생 너뿐 사랑할 아껴줄게 눈물이 나고 힘이 아플 아파할게 사랑할 지켜줄게 너만큼 좋은 만난 걸 감사해 매일 너만 사랑하고 싶어나랑 결혼해줄래,0,1,12,-9,3
188,사랑의 롤러코스터 날 올렸다 내렸다 사랑의 롤러코스터 타고 싶어서 사랑을 찾아서 떠나요 장미 밭을 지나야 지나겠어요 꽃의 향이 날 안아 뽀뽀하네요 더운 날이 온대도 상관없어요 사랑이 좋아요 힘들 거 알지만 사랑을 찾아서 떠나요 사랑의 롤러코스터 날 올렸다 내렸다 타고 싶어서 사랑을 찾아서 떠나요 장미 밭을 지나야 지나겠어요 꽃의 향이 안아 뽀뽀하네요 더운 날이 온대도 상관없어요 사랑이 좋아요 힘들 거 알지만 올렸다 내렸다 타고 싶어서,0,1,5,-2,3
189,키가 작아서 하이힐만 고집하는 피곤한 삶에 손을 건넨 사람 눈이 작아서 진한 라인 그려 넣은 부자연스러운 눈 속에 따뜻한 눈길 건넨 사람 사뿐사뿐 살짝살짝 편 한 맘으로 너에게 갈 거야 오늘도 질리지 않는 사랑 거야 자꾸자꾸 듣고 싶은 음악 같은 사랑을 들려줄게 시간이 다시 듣고픈 목소리로 노랠 불러줄게 내가 소심해 먼저 고백할 수 없어수줍어하는 두 볼에 싱그런 입술을 준 사람 사뿐사뿐 살짝살짝 편 한 맘으로 너에게 갈 거야 오늘도 질리지 않는 사랑 자꾸자꾸 듣고 싶은 음악 같은 사랑을 들려줄게 시간이 다시 듣고픈 목소리로 노랠 불러줄게 너의 손길 너의 눈길 영원히 훔쳐버릴 소곤소곤 몰래몰래 너의 귀에만 속삭여 누구도 비밀을 듣지 못하게 자꾸자꾸 보고 싶은 영화 같은 사랑을 보여줄게 시간이 기억하고픈 추억만 가득 만들어 사뿐사뿐 살짝살짝 편 한 맘으로 너에게 갈 오늘도 질리지 않는 사랑 듣고 음악 들려줄게 다시 듣고픈 목소리로 노랠 불러줄게,0,1,-1,-3,-4
190,너는 웃겨 이러는 거 보면 내가 뭐가 좋다고 옆에 있는 걸까 아무것도 없는 남잔데 나를 믿어주는 네가 너무 예뻐멋지게 꽃다발을 주는 법을 몰라 따뜻하게 말 건네지도 않아 미안해 연애라는 것에 익숙하지 못해 사실은 어떡해야 할지 몰라 요즘 무척이나 지쳐 보인다고 남자는 축 처지면 절대 안 된다고 혼자서 중얼거리다 요리책을 맛없어도 다 먹으라고 투정 부려내 작은 기침에도 큰일 것처럼 허둥거리다가 어느샌가 내밀어 뭐 하러 약은 챙겨 필요 없어나는 사랑하는 하나만 있으면 돼 널 사랑 해저 뜨거운 태양만큼 눈부신 하늘만큼 빛나는 별빛처럼 언제나 반짝이고 있어널 사랑해 드넓은 바다만큼 시원한 파도만큼 해맑은 아이처럼 언제나 미소 짓고 있어널 사랑해 담배를 예전보다 줄여야겠어 이제는 술도 마셔야겠어 밤늦게 어디에서 뭐를 하냐고 그런 잔소리까지도 너는 너무 예뻐 누가 나를 챙겼을까 이렇게 행복하게 웃어볼까 되는 대로 살았겠지 네가 언제나 고마 워니가 있어줘서 내가 잘 할게 별 볼 없지만 표현도 못 하는 바보 같은 나지만 절대로 돌아서는 일이 없게 눈에서 눈물 흘릴 일도 없게 숨소리 하나도 귀를 기울이고 작은 거 하나까지 내가 신경 쓸게 지금처럼만 곁에서 약속해 평생을 지켜줄 테니까 널 사랑 해저 뜨거운 태양만큼 눈부신 하늘만큼 빛나는 별빛처럼 반짝이고 있어널 사랑해 드넓은 바다만큼 시원한 파도만큼 해맑은 아이처럼 미소 짓고 사랑 해저 드넓은 바다만큼 시원한 파도만큼 해맑은 아이처럼 미소 짓고,0,1,9,2,11
191,달콤한 초콜릿 무스케이크 새콤한 레몬향 아이스티 온종일 널 위해 준비한 나만의 비장의 무기들 사각사각 네가 눈 속에 밟혀 새록새록 너는 매일 새로워져 모든 걸 빼앗긴 바보는 꿈속에서도 너를 그려다 뜻한 나뭇잎 스웨터 두툼한 파스텔 머플러 겨울이 다 가고 완성해 지금껏 눈치만 보는 사각사각 네가 눈 속에 밟혀 새록새록 너는 매일 새로워져 모든 걸 빼앗긴 바보는 꿈속에서도 너를 그려네 곁에 있어 기분이 둘이라서 기분이 영원히 이대로였으면 소복소복 네가 맘속에 쌓여 사뿐사뿐 너는 맘을 흔들어 모든 걸 빼앗긴 바보는 세상 가득 너뿐이야 사각사각 눈 속에 밟혀 새록새록 매일 새로워져 꿈속에서도 너를 그려,0,1,1,-4,-3
192,네가 필요해 가만히 눈을 감고 있어도 생각나죠 그댄 내게 뜬구름 같은 걸 사랑이란 말로 아직 부족한가요 맘이 위험한가요 그댄 내게 전부가 됐네요 같은 길을 걷고 같은 꿈을 꾸고 혼자만 몰래 상상을 하고 그대 곁에 잠든 연인 그대와 모습 베이비 사랑해 당신이 필요해수줍은 나의 고백 오랫동안 몰래 숨겨왔던 노래 순진했던 고백 너도 좋다면 가까이 다가와난 네가 필요해울리지도 않는 전화기를 보게 되죠 그댄 내게 기분 좋은 기대 걸 하루만 기다리면 답이 올까요 고백할까요 한 걸음만 다가와 줘요 길을 걷고 꿈을 꾸고 혼자만 몰래 상상을 하고 그대 곁에 잠든 연인 그대와 모습 베이비 사랑해 당신이 필요해수줍은 나의 고백 오랫동안 숨겨왔던 노래난 네가 필요해 순진했던 너도 좋다면 가까이 다가와 당신이 필요합니다 당신만이 필요합니다 나의 인걸요 당신을 그리워합니다 당신과 사랑에 빠졌습니다 오늘도 내일도 필요해수줍은 오랫동안 숨겨왔던 노래난 필요해 순진했던 너도 좋다면 가까이 다가와 필요합니다 수줍은 노래난,0,1,0,-8,-8
193,널 기다리던 밤처럼길고 어둡던 사이 공백이게 끝이 아니길 바래나는 돌아가길 원한다너가 원하던 거 다 고친 지금에야 넌 어디로 갔는지난 홀로 남아 외로운오늘 부는 바람도참 시린 같은데넌 왜이리 멀쩡해보이는 건지눈치도 없는 너지만예전처럼만 웃어주면 돼나에겐 하나뿐인 걸너 때매 아파 하는걸널 잊으려고 노력해봐도 잘 안돼널 미워하는 건추억 속 너에겐 못된 일이라난 할수가 없어이렇게 널 그리워하는 날 알고있는지나에겐 하나뿐인 걸너 때매 아파 하는걸널 잊으려고 노력해봐도 잘 안돼널 미워하는 건 너무 어려워날 몰라주는 너도 서러워나는 공식적으로 공식적으로 그리워서 당신을 그리워하고 공식적으로 그리워요이젠 너와 내가 친구 사이로 남아내 삶이 진부 하게만 느껴져마치 실이 빠진 진주혹은 가벼운 티슈우리둘 간에 발행하십시오은 없을거야넌 아무 느낌두 안나겠지만서도나 없는 밤이 긴듯 혼란스럽겠지나 역시 옆구리 시린 그냥 샌들지루한 스캔들내 안티팬들이 되버린니 주위사람과 불리한 게임을 하기도 전에 위에를 쳤지만 그냥 고통 스러워요사랑 노랠 들어도멜로디가있는 곳행동 다 외로움이 돼 날 떠난 너지만 아직 날 괴롭히네나에겐 하나뿐인 걸너 때매 아파 하는걸널 잊으려고 노력해봐도 잘 안돼널 미워하는 건추억 속 너에겐 못된 일이라난 할 수가 없어이렇게 널 그리워하는 알고있는지나에겐 걸너때매 잘안돼널 건너무 열심히너무 어려워 몰라주는 너도 서러워공식적으로 당신을 그리워합니다,0,1,-8,-1,-9
194,인생은 노래와 같습니다 매력쟁이 린과 맥몽또 협업 너만을 생각하면 하루 꼬박 밥을 안 먹어도 너무 사랑이란 건 원래 도박 정신이 나갔나 너무 분명 사랑에 빠졌어요 당신에 대해 생각합니다 내가 이럴 수는 없어요 밥을 먹다가도 보다가도 괜히 마음이 찡해져요 가슴도 내가 이럴까요 내게 주문을 걸어 논 거죠 그대가 떠올라요 마음을 간지럽혀요 사랑이 내게 왔나 봐요 생김새는 몽을 닮았고 몸매도 그리 좋진 않지만 보면 볼수록 매력쟁이몽이면 매력쟁이나에게 올인 해봐 나에게 줘 주문을 걸어 줘봐 부리디 밥 박 뭐든지 필요하면 물어봐 당신의 발에 일어서십시오 너와 뗄 수 없는 하나의 빛 그대 고백은 짜릿해우린 너무 비슷해 눈엔 하트가 만개 사랑은 뜨겁게 노래 부르면서 사랑에 빠졌어 이제 손을 잡아줘요 늘 감사해 당신의 발에 일어나서 발에 일어나서 일어나 눈을 봐요 그대 생각을 읽어요 지금 내게 키스하겠죠달콤해요 두 사람 생김새가 몽을 닮아도 몸매 역시 그리 좋진 않아도 사랑해 내겐 멋진 그대여 당신은 아름다워서 당신이 아름다워라는 것을 몰라 노래가 끝나도 우리는 영원히 할 거야 맘을 받아줘 사랑해 내겐 멋진 그대 생각을 읽어요 지금 키스하겠죠달콤해요 두 사람 생김새가 몽을 닮아도 몸매 역시 그리 좋진 않아도 사랑해 내겐 멋진 그대여 당신은 당신이 아름다운 소녀 당신이 아름다운 소녀를 몰라 아름다웠다는 것을 몰라요 아름다워널 당신은 아름다워서 아름다워라는 것을 몰라널 넘어질 수 있다고 생각합니다 맘을 받아줘 매력쟁이 린과 맥몽또 협업,0,1,11,2,13
195,기억 속에서 간단한 소극 아침은 토스트와 차를 타고 가져가서 사랑의 사랑이 나에게 끔찍한 일보다 화려하다고 생각했을 사랑이 갑자기 나에게 갑자기 나에게 갑자기 사랑의 운명이 지연되었을 사랑의 운명에 대한 불쾌감을 느꼈다는 생각을 했을 행복하다고 생각할 기억 속의 간단한 송 날 아침은 토스트와 차를 타고 가져가서 사랑이 행복하다고 생각할 것입니다 위해 노래는 내가 어두운 조용한 방에 앉아있는 시대입니다 토스트와 차는 행복하다고 생각했다 당신은 당신이 나의 하나이고 유일한 사람이 될 것입니다 모자 노래를 꿈꾸고의 이야기를 위해 노래를 부르며 기억 속에 간단한 노래가 가득 찬 마음으로 가득 차서 차를 타고 가져가라는 행복하게 행복하게 생각한다,0,1,5,7,12
196,초록빛 바람 불어오는 날 마른 비 지나 그녀를 닮은 나라 꽃길을 둘이 걷는다 가슴은 두근두근 약속한 듯이 발을 맞춘다 숨소리마저 입을 맞춘 다부 더러운 손길 팔을 감는다 살며시 기대온다 새까만 찰랑 찰랑 찰랑 그녀의 머릿결 살랑살랑 살랑 노래를 부르면 꽃바람 휘파람 너울너울 무지개 따뜻한 숨결 뺨을 스친다 짜릿한 상상 입술이 탄다 햇살이 반짝 아른거리다 노을빛 물이 든다 새까만 그녀의 머릿결 살랑살랑 살랑 노래를 부르면 꽃바람 휘파람 너울너울 무지개 바람이 널 타고 불어와 햇살이 아플 만큼 따가운 날이라도 괜찮아 무엇을 할지 어디를 갈지 목적지 없이 걷는 것도 좋아해가 저물어 올 때쯤 바래다주는 길은 이렇게도 짧은 건지 하늘은 어두운데 주변만 밝지 아직 밤공기는 찬데 두 볼이 뜨겁지 가만히 그녀 입술 위에 입을 맞춘다 산뜻 산뜻산뜻 그녀의 모든 하나하나 아름다운 걸 첫사랑 안녕 옛사랑 안녕 너는 나의 무지 개꽃 바람 닮아 휘파람 닮아아름다운 무지개,1,0,-1,-1,-2
197,물어보는 늘 확인하고픈 같은 말해줘도 매일 말해줘도 계속 물어 입술이 말라 오네 식은땀이 흐르네 정답은 알지만 네가 듣고 싶은 말 듣고 싶은 말 나를 시험하는 말 이쁘다 이쁘다 이쁘다니까 믿지 않는 건데 말하고 말하고 아무리 말해도 화난 듯한 너의 표정 수가 없어진 불안해지는 매일 같은 퀴즈 반복되는 게임 항상 술래 머리를 새로 했나도 손톱이 바뀌었을까 감이 오질 않아니가 듣고 싶은 말이 힌트도 없는지 이쁘다 이쁘다니까 믿지 않는 건데 말하고 아무리 말해도 화난 듯한 너의 표정 이쁘단 하나론 널 표현 하긴 부족하잖아 아기 맘이라도 꺼내줘야 넌 믿겠니 널 사랑해 사랑해 사랑하는데 변했다고 하는 건데 화내고 삐지고 매일 토라져도 그것마저 사랑스러워 네가 백번 천 번 내게 물어도 정답은 늘 하난데 어제도 오늘도 내일 물어도 세상에서 네가 제일 이뻐,1,0,0,-1,-1
198,오늘은 고백할까 말을 걸까 당신이 나와 오는 것을 좋아합니다 멋지게 차려 입고 꽃다발 손에 들고 다가간다 너에게 오늘은 고백할까 언제쯤 말을 걸까 당신이 나와 오는 것을 좋아합니다 모른 체 기뻐하고 예쁘게 웃어야지 다가온다 나에게 사랑 살며시 다가와서 사랑고백해 널 좋아해 사랑 수줍은 내가 사랑하는다 언제나 둘이 손을 잡고 걸어가기 츄팝츄팝 바쁠 때도 통화는 꼭 하기 츄팝츄팝 혹시나 싸웠대도 웃으면서 화해하기 츄팝츄팝 상큼한 미소 한 번 달콤한 포옹 한 번 당신이 나와 오는 것을 좋아합니다 행복한 순간을 바랬는지 너는 알고 있을까 사랑 조금씩 다가가서 사랑고백해 널 사랑해 약속해 내가 사랑하는다 언제나 둘이 손을 잡고 걸어가기 바쁠 때도 통화는 꼭 하기 혹시나 싸웠대도 웃으면서 화해하기 꿈꾸던 너를 만나 행복해난 바랄 없어 추노에게만 사랑을 줄래 응아프고 힘들 때도 둘이라면 이겨 낼 수 있어츄팝츄팝 웨이는 사랑합니다 이제 거야에 대한 나의 유일한,1,0,-13,-7,-20
199,따스한 햇살 가득 가슴에 안고서 가벼운 기분으로 바람을 가르며 그대란 가슴 벅찬 기쁨과 단둘이 날아가 버리다 하늘 가득 흘러가는 구름에 이름을 새기며 그댈 바라봐요 참을 수 없죠 수줍은 그대의 뺨에 키스를 날아가서 당신의 눈으로 날아갈 것입니다 우릴 바라보는 햇살 속을 달려요 이렇게 좋은데 당신의 마음에 날아라 사랑이란 그런 말조차도 모자라 어디서나 한 움큼 가득 쥔 바람을 그대에게 햇살은 더욱 우릴 아름답게 하고 이렇게 일상의 고민들을 버리고 날아가 버리다 맘 가슴 벅찬 이름 하나를 새기고 그댈 바라봐요 참을 수 없죠 수줍은 그대의 뺨에 키스를 날아가서 당신의 눈으로 날아갈 것입니다 우릴 바라보는 햇살 속을 달려요 이렇게 좋은데 마음에 날아라 사랑이란 그런 말조차도 모자라나는 눈으로 날아갈 때마다 어디에서나 바라보는 속을 달려요 좋은데 마음에 날아라 사랑이란 그런 말조차도 모자라나는 때마다 어디에서나 모자라나는 때마다 어디에서나 모든 곳에서 마음을 사로잡으십시오,1,0,-6,0,-6
200,아름다운 밤입니다 우리가 쓰레기를 버는 현금을 얻었습니다를 찾는 무언가를 찾고 있습니다 내가 당신과 결혼하고 싶다고 생각합니다 당신의 눈에 모습이 당신의 눈에 보이는 것은 춤추는 주스가 걱정하는 것입니다 깨어나 넌 냉담한 사람이 아니에요 너를 비난하지 않겠어 당신은 내가 준비된 것처럼 준비가 된다 무언가를 찾고 있습니다 내가 당신과 결혼하고 싶다고 생각하기 위해 당신의 눈에 보이는 모습은 보인다 그것은 아름다운 밤입니다,1,0,2,2,4
201,사랑 노래가 너무 많아서 노래로 고백을 할까 처음 본 순간 당신과의 사랑이 떨어집니다 미칠 같은데 널 사랑하는 데니까 있어 좋다 사랑해서 좋다 말로 설명할 수 없는 기분 너무나도 좋다 너와 함께하는 순간 영원히 간직할 기분 멋진 말들로 꾸며댈수록 나의 마음을 가릴 같아빼고 빼고 줄여갈수록 보석과도 남아있는 사랑해서 말로 설명할 수 없는 기분 너무나도 너와 함께하는 순간 영원히 간직할 왠지 서툴러 보이는 작은 두 글자로 나의 마음을 전할 게니까 있어 사랑해서 말로 설명할 수 없는 너무나도 너와 함께하는 영원히 간직할,1,0,-8,-2,-10
202,혼자서 널 기다릴 때면 행성에 있는 듯해 여기서 네가 있는 곳까지 오래 걸릴지 궁금해 상상이 안돼내게 빨리 와줘 그대가 없는 이곳은 내게는 너무 캄캄해 여기서 두 벌려 그대를 안아줄 준비가 돼있어 너와 사이의 우주를 건너 내게로 나에게 오시고 싶습니까 너와 사이의 우주를 건너 내게로 날아와 줘 기다리게 하지 마나 지금 당신을 기다리고 있습니다 지금 당신이 필요합니다 지금 당신을 기다리고 있습니다 당신이 필요 해저 멀리 널 보고 있으면 너와 생각을 하는 듯해 여기서 언제까지나 기다리고 있어야 하는지 궁금해 답답하기만 해내게 빨리 와줘 그대가 없는 이곳은 내게는 너무 막막해 꼭 잡은 손 그대를 놓치지 않을 준비가 돼있어 사이의 우주를 건너 내게로 나에게 오시고 싶습니까 날아와 줘 기다리게 하지 마나 당신을 있습니다 당신이 필요합니다 필요해 멀리 있는 것만 같아도 손 내밀면 잡힐 듯한 그대 그림자 그댈 꼭 안고 마음 느낄 수 있도록 놓지 않으려나 나에게 오시고 싶습니까 거리 우주 가득히 너로 채울게 다가와 필요합니다 필요해 바비가 필요해,1,0,1,4,5
203,우연히 내게 오나 봐봄 향기가 보여 너도 오나 멀리서 향기가 설레는 코끝에 나의 입술에 괜찮은 느낌 떨림 나도 몰래 우연히 봄 어느새 겨울 지나 봄이야 앞에 선 돌이야 아직 이게 믿기지가 않지만 왼손은 지금까지도 너의 향기가 미묘하게 흘렀던 분위기에 아직까지 숨 쉬네 무대 위완 다르게 눈을 피해 고개를 돌렸던 모습에 한숨 쉬네 오랜만에 느껴지는 떨림이 날 단순하게 만들어 너만 아는 거리 지다 고쳤다고 생각했던 버벅임이 도져서 준비했던 말을 잊어버리지 주워 담지 못할 말은 절대 안 해원하는 걸 말해봐널 위해서만 할 빼곤 다 색칠할 수 있어 까맣게 천천히 갈게 가깝게 우연히 내게 오나 봐봄 보여 너도 멀리서 설레는 코끝에 나의 입술에 괜찮은 느낌 떨림 나도 몰래 봄 봄 아직까지 짙네 발걸음이 가벼워 집에 가는 길엔 가까워질 너와 나를 상상하는 모습이 오글거려 몸서리치 네어 머릿속이 하얘지기 하루 종일 날씨 얘기만 반복하게 돼 것들에겐 무감각하게 돼 정적이 만드는 긴장감은 설레어나를 미소 짓게 만들어 모른 척하려 했더니 옆의 남자들은 흐릿했던 눈앞에 불을 키게 만들어 겨울은 유난히도 추웠고 다시 돌아온 그토록 기다렸던 움직이지 못하도록 잡고 있고 싶어날 느낄 수 있게 안고 있고 싶어 내게 봐봄 보여 너도 멀리서 설레는 코끝에 나의 입술에 괜찮은 느낌 떨림 나도 몰래 너를 사랑해서 사랑해 너무 쉬운 걸 참고 있을게 여자이니까 하루 기다려 바보야 말해봐 티 마음도 보여갖고 싶다고 해봐 이상은 감추지 마 어느새 앞에 앞에,1,0,2,0,2
204,다들 고백하나요 멜로디론 솔 정도 높이 얘기하면 된단 말이 얼핏 본 같은데 사랑을 글로 배운 남자가 나선배의 충고도 소용없었고 그린라이트 같은 건 남의 얘기한데 이걸 어째요 놓치면 안 될 같은 사람이 앞에 꿈처럼 있네요 이거 어쩜 한없이 차올라 관심 없는 척 못 본 척 몰래 힐끗 보는 이거 어쩜 눈길이 간 사랑이란 말은 아직 이르지만 꼭 그렇게 될 같아두근거리는 맘 그대는 알까요 이거 어쩜 한없이 차올라 관심 없는 척 못 본 몰래 힐끗 보는 눈길이 간 사랑이란 말은 아직 이르지만 꼭 그렇게 될 같아 오해하진 말아줘 그대가 한번 한 번 한 번 한 번 봐어떡하면 좋죠 해야 하죠 관심 없는 못 몰래 힐끗 보는 눈길이 간 사랑이란 말은 아직 이르지만 꼭 그렇게 같아 두리번 두리번 두리번 조심스레 다가가 나와 연애할래요,1,0,-6,4,-2
205,그댈 보면 얼굴이 빨개지고 그댈 보면 가슴이 두근두근 아이처럼 수줍게 말하고 그댈 보면 괜스레 웃음이 바보처럼 자꾸만 아마 내게 사랑이 온 건 가봐 그대는 마음속의 대통령 가슴의 별 수놓지 당신을 위한 지니입니다 숨을 멎게 하지 그대가 원하는 건다 너를 사랑하니까 사랑에 이유는 없잖아 알잖아 그대는 밤 하늘 별빛보다 아름다워요 맘속 깊은 곳에서 반짝거리는 나만의 사랑 빛 그대를 사랑해요 언제나 곁에서 빛을 내줘요 매일 범퍼라 보고 바라봐도 아름다워요 그댄 나의 사랑 빛 구름을 기분 유치해도 자꾸만 아마 내게 사랑이 온 건 가봐 그대는 밤 하늘 별빛보다 아름다워요 맘속 깊은 곳에서 반짝거리는 나만의 사랑 빛 그대를 사랑해요 언제나 곁에서 빛을 내줘요 매일 밤 바라보고 바라봐도 그댄 나의 사랑스러운 하늘 햇살보다 눈이 부셔요 맘속 어두운 곳까지 밝게 비추는 나만의 그대를 사랑해요 사랑스러운 두 눈을 감아봐도 그대 보여요 이렇게 바파보고 바라봐도 눈이 부셔요 그댄 나의,1,0,-7,2,-5
206,내가 사랑에 빠질 그대와 함께한다면 사라질 꿈이라도 달콤하기만 하죠 지금 순간 순간을 믿어요 내가 당신과 사랑에 빠질 어제부터 확신했죠 매일 그린 그림이 당신이란 걸 내일은 꼭 얘기할래요 아무 이유도 없이 보고 싶었다는 걸 사실 많이 설레었어요 그대는 아마 언제인지 모르겠지만 앞으로도 많이 궁금해질 같아요 당장이라도 그대를 껴안고만 싶은데 내가 사랑에 빠지면 그대와 함께한다면 사라질 꿈이라도 달콤하기만 하죠 지금 순간 순간을 믿어요 당신과 빠질 사실 조금은 겁이 나요 영화에도 엔딩이 있을까요 그대 손을 꼭 잡아줘 걷는 길 덕분에 따뜻해요 좋은 일만 매일 있을 거예요 날 보며 웃는 그대 예쁜 모습처럼 앞으로는 아직 걱정 안 하기로 당장이라도 그대를 껴안고만 싶은데 빠지면 그대와 함께한다면 사라질 꿈이라도 달콤하기만 하죠 지금 순간 순간을 믿어요 당신과 늘 그대였죠부푼 기대로 잠 못 들게 했죠왠지 우린 느낌 부드럽게 오당장이라도 그대를 껴안고만 싶은데 빠지면,1,0,-5,-2,-7
207,솔직하게 말하면 달콤한 건 싫었어 네가 좋아한 뜨거운 커피 나른한 비도 있었지 네가 좋아서 이제 어느새 커피 향기에 고개 돌리네 네가 남긴 메시지 웃는 사진들 내게 알려준 날 위한 너의 비밀 레시피 남긴 것들이 나의 전부야 지금 너에게 할 말이 있어 아기 사랑 곁엔 온통 너뿐이야 사랑 빗소리마저 눈이 부셔 사랑 표정까지 너를 닮아가 잠드는 시간마저 아까워 목소릴 들려줘 간직할 수 있게 사랑니가 있는 세상이 이제야 너를 발견했으니 솔직하게 말하면 뜨거운 건 싫었어 사랑한다고 말하나 마나 다시 떠나고 넌 달랐어 다시 생각해봤어 지금 너에게 할 말이 있어 아기 안엔 온통 너뿐이야 지난 눈물조차 눈이 부셔 눈빛까지 너를 닮아가 모른 시간이 아까워 얘길 들려줘 알 수 있게 사랑니가 있는 세상이 이제야 발견했으니 안엔 온통 너뿐이야 지난 눈물조차 눈이 부셔 눈빛까지 닮아가 모른 시간이 아까워 얘길 들려줘 알 수 있게 사랑니가 있는 세상이 이제야 발견했으니,1,0,-6,0,-6
208,그대여 그대여 그대여 오늘은 걸어요 거리를 밤에 들려오는 자장노래 어떤가요 오예 몰랐던 그대와 단둘이 손잡고 알 수 없는 떨림과 둘이 걸어요 봄바람 휘날리며 흩날리는 벚꽃 잎이 울려 퍼질 거리를 둘이 걸어요 봄바람 휘날리며 흩날리는 벚꽃 잎이 울려 퍼질 거리를 둘이 오예 이제 손잡아요 거리에 마침 들려오는 사랑 노래 어떤가요 오예 사랑하는 그대와 단둘이 손잡고 알 수 없는 봄바람 휘날리며 흩날리는 벚꽃 잎이 울려 퍼질 바람 불면 울렁이는 기분 탓에 나도 모르게 바람 불면 저편에서 모습이 겹쳐 울렁이는 기분 탓에 나도 모르게 바람 불면 저편에서 모습이 겹쳐 사랑하는 연인들이 많군요 알 수 없는 친구들이 많아요 많군요 좋아요,1,0,-2,1,-1
209,아름다운 너의 목소리는 내가 원하는 모든 것을 허락했지 흔들리는 많은 사람 속에서 넌 나만을 위한 춤 붉은 칵테일 빛에 담긴 밤 너와 단둘이 떠나고 싶어온 아름다운 너의 목소리는 내가 원하는 모든 것을 허락했지 지금 우리는 춤을 추고 있어 비밀스러운 몸짓과 노래로 검게 타버린 같은 심장이 터질 너를 비추고 붉게 물든 나의 입술 뜻밖의 아찔했던 입맞춤이 아름다운 너의 목소리는 내가 원하는 모든 것을 허락했지 지금 우리는 춤을 추고 있어 비밀스러운 몸짓과 노래로 아무 말 할 수 없어 넌 지금 앞에 있는데 밤이 다 지나가면 넌 사라질 같아오 우리는 춤을 추고 있어 비밀스러운 몸짓과 노래로 곁에서 있어하얀 달빛과 마음에 들어왔어 목소리에 녹아내리는 순간에 멈추고 싶어온 곁에서 있어하얀 달빛과 마음에 들어왔어 목소리에 녹아내리는 순간에 멈추고 싶어온,1,0,-5,-3,-8
210,너의 한 마디 말도 웃음도 나에겐 커다란 의미 너의 작은 눈빛도 쓸쓸한 뒷모습도 나에겐 힘겨운 약속 너의 모든 것은 내게로 풀리지 않는 수수께끼가 되네 슬픔은 간이역의 코스모스로 피고 스쳐 불어온 넌 향긋한 바람나 이제 뭉게구름 위에 성을 짓고 널 향해 창을 내리 바람 드는 창을 한 마디 말도 웃음도 나에겐 커다란 의미 작은 눈빛도 쓸쓸한 뒷모습도 힘겨운 약속 모든 것은 내게로 풀리지 않는 수수께끼가 되네 슬픔은 간이역의 코스모스로 피고 스쳐 불어온 넌 향긋한 바람나 이제 뭉게구름 위에 성을 짓고 널 향해 창을 내리 바람 드는 슬픔은 간이역의 코스모스로 피고 스쳐 불어온 넌 향긋한 바람나 이제 뭉게구름 위에 성을 짓고 널 향해 내리 바람 드는 한 마디 말도 웃음도 커다란 의미 작은 눈빛도 쓸쓸한 뒷모습도 힘겨운 약속,1,0,2,-2,0
211,부드럽게 무드 있게 따뜻하게 꼭 안아주시오 매일 한 번씩 사용하시오부드러운 눈 마주칠 땐 미소 지어서 그녀를 웃게 뭐 야말을 거시오 그날 아침엔 먼저 일어나서 재즈 젠틀 키스 켜기 널 바라봐 너무 지칠 땐 소주 두 병 들고 솔직하게 그녀의 집 두드리시오 가끔 한 번씩 무작정 떠나가시오 하늘 바람 숨 쉬게 해줘 가끔 한 번씩 무작정 키스해 주시 오이 유 없이 너에게 빠진 그날처럼 잘 때는 나긋하게 조용하게 눈물 말해주시오 매일 너무 고마워 그날 아침엔 먼저 일어나서를 청소하십시오 썸 널 깨우고 바래다줄 땐 발걸음 천천히 나직하게 그녀에게 고백하시오 여자 앞에선 이성적이지만 이상하게 앞에선 감정이 앞서널 사용하기엔 너무나 아까워 마냥 바라보기엔 넌 날 미치게 해 영원히 널 사용하고 싶어온 마이 딸 마이 여자 부드럽게 무드 있게 따뜻하게 꼭 안아주시오 매일 사용하시오 잘 때는 나긋하게 조용하게 눈물 말해주시오 너무 고마워 아름다운 소녀 놓치지 마시오,1,0,-6,-2,-8
212,널 보낸 아침엔 구겨진 양치질 라디오 들으면 모두가 이별 노래 쓸쓸히 노을에 외로이 다림질 어느새 눈물이 주르륵 주르륵 여보세요 잘 있나요 내게 돌아와요 사랑해요 보고파요 너무 그리워요 펀치 아무 말 못 한 마음 바쁜 아침 지하철 한가운데 눈물이 주르륵 부끄러워 고개를 돌려도 떠오르는 얼굴 정말로 우리가 이렇게 끝난 거느니가 없는 밤 하루도 네가 없이 지내기 싫다는 걸 알면서 그냥 날 보냈어내 마음도 모르는 바보 같은 널 아직도 좋아해 사랑 안의 여든 둘만이 타는 기차 많은 연인들은 그려 아주 비슷하게 영화 속 주인공들은 꿈꿔 바래 서로에게 멈추질 못함에 사이를 상처 내를 위해 날려 서로 자존심은 버려돌고 도는 이곳에서 롤러코스터 안에서 인스턴트 낭만적인 바닥 모닝콜 울리면 다가와 입맞춤 초콜릿 파르 페그보다 달콤한 너와 본 화면이 가득한 러브 신 오늘도 내일도 행복한 날 미안해요 고마워요 이제 잘할게요 사랑해요 안아줘요 입 맞춰 주세요 펀치 아무 말 못 한 마음 너를 위해 커피를 끓여야 지 사랑을 한 아름 눈물도 넣어어 제의 마음 복수를 해야지 정말로 우리가 다시 함껜 거니 너의 미소가 어여쁜 너의 미소 하나가 어이없이 사르르 마음을 녹여요 사랑해요 이제는 두 번 다시 싸우지 말아요 당신의 눈에서 볼 수 있습니다 아직은 몰라 둘이 될지 짐작이 아닌 직감이 맞는다면 다시 수 많은 고난들 사일 가로막아 배로 남아 그러다가 가짜 이별 번 맞아 펀치 사랑의 증거물 준비물 높이 쌓아가는 고층 건물에 멈추길 바라 엘리베이터를 타고 멈추십시오 사랑 가득한 낭만적인 바닥 층에 사랑 가득한 당신을 위한 낭만적인 바닥 당신을 위한,1,0,-1,-1,-2
213,아주 멀리까지 보고 싶어 그곳에선 누구를 만날 수가 있을지 아주 높이까지 오르고 싶어 먼 곳을 바라볼 수 있을지 작은 물병 먼지 낀 카메라 묻은 지도 가방 안에 넣고서 언덕을 넘어 숲길을 헤치고 가벼운 발걸음 닿는 대로 끝없이 이어진 길을 천천히 걸어가네 멍하니 앉아서 쉬기도 하고 가끔 길을 잃어도 서두르지 않는 법언 젠가는 나도 알게 되겠지 길이 나에게 가르쳐 테니까 촉촉한 땅바닥 앞서 간 발자국 처음 보는 하늘 낯익은 길 언덕을 넘어 숲길을 헤치고 가벼운 발걸음 닿는 대로 끝없이 이어진 길을 천천히 걸어가네 새로운 풍경에 가슴이 뛰고 별것 아닌 일에도 호들갑을 떨면서 걸어가네 휘파람 불며 때로는 넘어져도 작은 물병 먼지 낀 카메라 묻은 지도 가방 안에 넣고서 언덕을 넘어 숲길을 헤치고 가벼운 발걸음 닿는 대로 끝없이 이어진 천천히 내가 자라고 정든 거리를 가끔 그리워하겠지만 이렇게 떠나네 넓은 세상으로,1,0,-5,-1,-6
214,시간을 듣고 기능을 확인하고 있습니다 입술 엉덩이를 보고 당신의 슈퍼맨이 되고 싶어 당신의 슈퍼맨이 되지 않습니다 퐁당퐁당 너를 처음 보고 두근두근 빠져 버렸지 달콤달콤 너의 눈을 보고 어쩔 줄을 몰라 버렸지 웃기지도 않게 불쑥 내게 온 날 잡아 볼까 어떡해 어쩜 모습이 내가 우스워널 닮는 모습이 점점 우스워 스르륵 네가 기다려다가와 줘야 도로로 네가 달콤해 사랑 내겐 너무나 사탕 같은 어쩔 수 없는 걸눈과 코와 입술 맛 너를 처음 만난 건 네게 행운이었어 지 겨지겨운 세상 너의 손길 필요해 오사 탕 같은 널 항상 안아주고 싶어나 말이야 네가 필요하단 말다 문득문득 너의 입술 조심조심 키스 살랑살랑 손길 어쩔 줄을 몰라 버렸어 바라지도 않던 내게 찾아온 널 사랑할까 이제 어쩜 모습도 내게 묻어나날 닮은 모습 사랑해도 괜찮지나 사르륵 날 감쌀 짜릿해져 도로로 내가 널 안길 안길 날 안아버릴 때란 너에게 안길 시간이 영원히 멈추지 않기를 스르륵 네가기다려다가와 줘야 도로로 달콤해 사랑 내겐 너무나 사탕 같은 수 없는 건 손과 귀와 맛나 사르륵 감쌀 짜릿해져 내가 안아버릴 때란 너에게 그렇게 너에게 집으로 뽀로로 달려가서 안아줄 거야 사랑할 거야 그렇게 사랑하는 거 나의 맘이 이제 나에게 솔직히 이제는 나에게 가까이 몸이 두근두근 벌렁벌렁 어서 어서 와서 베이비 베이비 베이비,1,0,-1,-7,-8
215,이제는 아무렇지 않겠지 함께했던 날들이 찾아와도 없는 내가 아파했던 만큼 너도 많이 아파하며 지냈겠지 미칠 가슴 뛰던 순간이 기억 속에 남아 추억에 더해지고 곁에서 멀어지는 널 그려봐도 견딜 만해졌던 추억이 말을 걸어도 듣지 못해서 잡지 못해서 못 들은 척 지나쳐야겠지 미련이 불러 세워도 우린 여기에 선 닿을 수 없어 없이도 잘 살아볼게 안녕 미칠 그리웠던 순간이 흐린 기억처럼 내게서 사라지고 없이도 살아지는 날 바라보다 보내줄 수 있는 추억이 말을 걸어도 듣지 못해서 잡지 못 들은 척 지나쳐야겠지 미련이 불러 세워도 우린 여기에 선 닿을 수 없어 없이도 잘 살아볼게 기억 속 너와 언제나 함께한 날을 조각 내봐도 뿌리쳐봐도 떨어지지 않아 곁에서 추억이 찾아온다 해도 보지 잡지 눈을 감고 지나쳐야겠지 미련이 불러 세워도 여기에서 자리에서 잘 살아볼게 안녕,1,0,4,-5,-1
216,우하하 우하하 케로로 중사 사랑을 내게 주세요 음 내가 어때서 이러시나 눈이 작다고 놀리지는 말아줘요 이렇게 귀엽게 웃을 수가 있어요 이렇게 엉덩이를 흔들고 춤추죠 으에으에으샤 우샤 우샤 우샤 나를 봐요 나를 봐줘요 내가 말하 다우 날 사랑해줘요 크게 우하하 나를 안아줘요 얼굴도 크고 바보 같지만 나만을 사랑해줘 봐요 내가 말하 다우 날 사랑해줘요 크게 우하 하나를 안아줘요 밝은 빛으로 감싸줄게요 사랑을 내게로 주세요 앞에 와서 웃어봐요 즐겁게 나와 춤을 춰요 우울할 때나 지겨울 때나 보면서 웃어봐요 앞에 와서 웃어봐요 즐겁게 나와 춤을 춰요 우울할 때나 지겨울 보면서 웃어요 사랑해라고 말해요 음 하나만이 가득 사랑을 주세요 눈이 작아도 귀엽다고 말해줘요 아주 큰 행복 안겨줄게요 이렇게 엉덩이를 흔들고 춤추죠 으에으에으샤 봐요 봐줘요 말하 다우 날 사랑해줘요 크게 안아줘요 얼굴도 크고 바보 같지만 나만을 사랑해줘 우하 하나를 밝은 빛으로 감싸줄게요 내게로 우하 하나를 밝은 빛으로 감싸줄게요 내게로 주세요우하하,1,0,-5,0,-5
217,예뻤다 나를 보던 너의 눈동자 좋았다 나의 하루를 함께해 주어서 나의 바람 같았던 너의 온도가 따스하게 나를 어루만져 활짝 웃어주던 미소가 예뻐서 어느새 눈물짓게 하잖아나는 너였다 다시 돌아오면 안 될까 너였다 숨도 못 쉴 만큼 그리운 사람 너무 보고 싶어서 미치겠어돌아갈 순 없을까 네가 없는 빈 하루가 간다 어렵다 가만히 널 보내주는 일참 버겁다 미뤄뒀던 너를 떼어 내는 쏜살같이 지나간 널 사랑했던 날 어김없이 찾아온 유난스럽게 널 찾아봐도 네가 없다 넌 곁에 더는 없다나는 너였다 다시 돌아오면 안 될까 숨도 못 쉴 만큼 그리운 사람 너무 보고 싶어서 미치겠어돌아갈 순 없을까 네가 없는 빈 하루가 간다 눈부시게 아름다웠던 세상을 만들어 준 간직하며 살게 맘에 가득히 담아그래 하나였다 끝내 보내야겠지만 못 견디게 너무 그립겠지만 없는 세상에 무너져도 하루를 살아가 모든 순간들은 다,1,0,1,9,10
218,너랑 입으려 고른 옷 오늘 받아봤어오래 걸려서 잊고 있었는데 있을 너의 생일에 예약해놨던 커플링마저 취소를 했어 헤어지는 혼자라는 아직 실감이 안 나는데 어떡할까 너를 떠나보낼 준비해 걸 그랬어나랑 있으면 불편도 괜찮은 줄만 알았어다 급히 맘을 붙잡으려 해도 이미 마음 정해버린 너의 대답에 아무 말 못 하던 끝까지 바보 같던 내가 싫어 멍하니 있다가도 전화벨이 울리면 목소리가 들릴 같아 어떡할까 너를 떠나보낼 준비해 걸 그랬어나랑 있으면 불편도 괜찮은 줄만 알았어다 급히 맘을 붙잡으려 해도 이미 마음 정해버린 너의 대답에 아무 말 못 하던 끝까지 바보 같던 내가 싫어날 보기 싫겠지만 어떻게든 널 붙잡고 싶은데 널 되돌릴 방법이 없어 네가 없는 나의 하루는 아무것도 잡히지가 않아다 미안해 보고 싶어 사랑한다는 말 많이 해줄 걸 그랬어 사랑받으면 예뻐진다는데 땜에 많이 야위었어 마지막 가는 길 데려다준대도 괜히 맘 약해진다며 뒤도 안 보고 서둘러 떠나던 맘은 그동안 어땠을까,1,0,2,4,6
219,잠이 오는 잠에 나른해지고 눈이 무거워 무거운 눈꺼풀이 싫어다 좋은데 한가지 안 좋은 것은 눈뜰 수가 없네 눈을 뜰 수가 없네 봄이 봄이 그대와 함께라 좋아라 봄이 그대와 함께라 좋아라 오면은 산에 들에 진달래 피고 햇볕은 쨍쨍 모래알은 반짝거리고 다 좋은데 한 가지 안 좋은 것은 눈뜰 수가 없네 눈을 뜰 그대와 함께라 좋아라 좋아하다 좋은데 한 가지 안 좋은 것은 눈뜰 눈을 뜰 그대,1,0,-2,-4,-6
220,시간이 많이 흘렀지 넌 요즘 지내 한동안 멍하게 지냈어 먼지 쌓인 기억들만큼 뾰족한 마음들이 미워하려 해도 빛이 하늘에서 떨어졌습니다 기억 속에 남겨 있는데 이렇게 볼 수 없는 널 찾으며 방황할수록 그리워 그날들이 우리의 그날을 기억해 하늘에 비가 내렸지 우산에 가려진 얼굴 마지막까지 널 못 봤어흐려진 추억에도 뚜렷이 남는 빛이 하늘에서 떨어졌습니다 기억 속에 남겨 있는데 이렇게 볼 수 없는 널 찾으며 방황할수록 그리워 그날들이 어떻게라도 옆에서 숨 쉬고 싶어추운 겨울이 와도 네가 없는 것보단 그게 나을 테니까 세상은 없이는 겪었습니다 없이는 무너져갈 뿐이 닿을 수 맘이라 해도 아무것도 바라지 않을게 너라면 그냥 여기에 서서 기다릴게 맘이 날 볼 있기를,1,0,1,5,6
221,미안해 마요 이제야 깨달아요 절대 그대 짝이 아님을 괜찮을 게요 영혼 밖에 없는 못난 날 잘 비켜갔어요 그대 행복 내가 꼭 아니라도 지킨다면 그게 사랑일 테죠 그게 나의 몫이죠 잘 가요 소중한 사람 행복했어요 이것만 알아줘요 지금 사랑보다 결코 사랑이 부족하다거나 얕지 않음을 잊어도 돼요 나를 만난 시간들은 잠깐의 연극이라 여김을 잘한 거예요 아무리 노력해도 작은 희망도 없잖아요 아주 멀리멀리 뛰어가세요 어떡해요 잘못한 일만 떠오르는 걸 잘 가요 소중한 사람 행복했어요 이것만 알아줘요 지금 사랑보다 결코 사랑이 부족하다거나 얕지 않음을 어긋난 인연이 남겨놓은 사랑이란 날카로운 슬픔이군요 가요 사랑아 고마웠어요 이것만 알아줘요 지금 사랑보다 결코 사랑이 부족하다거나 얕지 않음을,1,0,-2,-3,-5
222,우린 서로가 많이 변한 같아 인정하긴 싫겠지만 너도 알고 있잖아 할 수 없단 걸 우린 서로가 상처만 줬잖아 아주 사소한 일에도 날카로운 말로 다투기만 했잖아그래 솔직히 노력했지만 서로가 바라는 달랐어 서운해지고 미워지는 당연했는지도 몰라 헤어지자 그만하자 붙잡지 말자 여기서 끝내는 답인 같아 막연하게 속에 기댄대도 달라질 없잖아어쩔 수없이 아파해야 해이쯤에서 헤어지자 솔직히 나도 두려워 우리가 사랑했던 추억이 없었던 일로 잊힐까 봐망설였는지도 몰라 헤어지자 그만하자 붙잡지 말자 여기서 끝내는 답인 같아 막연하게 속에 기댄대도 달라질 없잖아어쩔 수없이 아파해야 해힘들어도 이쯤에서 서로 너무 좋아서 사랑했는데 달라서 이별해 시작부터 우린 아니었나 그리워도 보고 싶어도 다시는 만나지 말이자 시간이 흐르면 괜찮아질 거야 나보다 좋은 사람 만나길 바라 너는 잘할 테니까 잘 지내야 해우린 여기까지야,1,0,-5,3,-2
223,오랜만에 펴본 낡은 일기장첫 장부터 끝까지 다 얘기 이랬구나 읽는 내내 맘이 끄덕여져사느라고 다 잊고 있었어 잘 사니 한 번씩 궁금하긴 했었어 미소도 아직 여전하니 오늘따라 그립다 사무치게 그립다 벅차도록 설레도록 사랑에 가슴 뛰던 그날들이 그때의 넌 어디로 그때의 어디로 아련히 멀어져 간다 시 못 올 그날들이 눈물겨울 만큼 그립다 오래돼 도 낡아지지 않는 반짝임이 사라지지 않는 순간 슬픔마저 애틋해지는 그걸 추억이라고 해 갑자기 멈춰진 우리의 인연처럼 끊겨 있던 마지막 날짜 오늘따라 사무치게 벅차도록 설레도록 사랑에 가슴 뛰던 그날들이 그때의 넌 어디로 아련히 멀어져 간다 시 못 올 눈물겨울 만큼 살면서 무너질 때마다 또다시 펴볼게 추억에서 만나 그때까지 안녕히 그곳에서 안녕히 잊은 듯이 다 지운 듯이 그렇게 지금처럼 살아가다 가슴 시린 날 마음 추운 날 문득 기억 속의 그때로 널 찾아갈게 반갑게 나를 맞아줘,1,0,1,6,7
224,바다를 건너 너를 처음 봤던 날로 돌아가 안녕이라고 말하며 다시 네게 같은 말을 건넬 거야 구름을 넘어 너를 사랑했던 날로 돌아가아무렇지 않은 웃으며 다시 네게 꿈을 나눠줄 거야 너랑 보던 별들이 떠있어 거짓말처럼 눈부셔해가 뜨기 전에 잠들 거야 잠버릇을 그리며 바다를 건너 너를 처음 봤던 날로 돌아가 안녕이라고 말하며 다시 네게 같은 말을 건넬 너랑 보던 별들이 떠있어 거짓말처럼 눈부셔해가 뜨기 전에 잠들 잠버릇을 그리며 너랑 보던 별들이 떠있어 거짓말처럼 눈부셔해가 뜨기 전에 잠들 잠버릇을 그리며 시간을 넘어 헤어졌던 돌아가 많이 늦었지만 미안하다고 다신 손 놓지 않겠다고,1,0,3,-6,-3
225,처음 너를 만나던 그날 설레던 월의 아침 아카시아 달콤한 향기 부드러운 바람 우릴 감싸주고 걸어왔던 시간들 그림 같은 예쁜 날 여우비 내리던 여름 하늘을 구르던 너의 웃음처럼 너는 나의 사랑 너는 나의 요정 온 세상 눈부신 향기를 뿌리고 너는 나의 노래 햇살 넌 비타민 날 깨어나게 해함께 걸어왔던 시간들 그림 같은 고운 날들 눈 내리던 겨울밤우리가 남겨놓은 발자국처럼 사랑 요정 온 세상 눈부신 향기를 뿌리고 노래 햇살 넌 비타민 날 깨어나게 해예쁜 영화 불꽃놀이와 플 아이스크림 롤러코스터 화이트 크리스마스 여름바다 당신의 미소 사랑 요정 온 세상 눈부신 향기를 뿌리고 노래 햇살 넌 비타민 깨어나게 해너는 해,1,0,-7,5,-2
226,너의 안부를 묻진 않아도 같은 하늘 아래 어딘가에서 너의 나른한 오후가 흘러가고 있기를 거기에 난이 없지만 같은 거리 한 편 어딘가에서 너의 인생이 꼭꼭 채워지고 있기를 행복하고 행복한 기억들로만 채워져 가기를 어제 같은 오늘 내일도 마음 눈물 흘리지 않는 평온하고 평범한 사랑네가 그렇게 원한 컷 끝끝내 내가 너에게 주지 못한 것이 그런 것들이 오늘을 가득 채우기를 어제 오늘 내일도 마음 아무 일도 일어나지 않는 느긋하고 안전한 하루네가 그렇게 원한 컷 끝끝내 내가 너에게 주지 못한 것이 그런 것들이 매일을 가득 채우기를,1,0,-3,4,1
227,외로운 날이 많았어아팠던 날도 너무 많았어어쩌면 사랑이 아니었을지 몰라 이별이 당연했을지도 몰라 세상엔 영원한 건 절대 없단 사실과 아무리 사랑해도 반복됐던 이별에 지쳐가 마음으로 서로를 원하던 그때가 그리워 자꾸만 생각나괜찮아졌다고 말하기엔 너무 보고 싶고 죽을 만큼 아프다고 말하기엔 살만해 네가 그리운 건네가 보고 싶은 건 자연스러운 거겠지 사랑한다는 말이 와닿지가 않았어 꽤 오랜 시간들을 불안하게 보냈어 둘은 지난날을 후회하며 보낼 거야 아쉬워 그때를 생각하면 괜찮아졌다고 말하기엔 너무 보고 싶고 죽을 만큼 아프다고 살만해 네가 그리운 건네가 싶은 건 자연스러운 거겠지 둘이서 채워 놓은 비워내는 어렵고 힘들겠지만 안 힘든 헤어짐은 어디에도 없으니까 자고 나면 괜찮아질 거야 새로운 사랑을 시작하고 설렘을 느끼고 지나 그랬냐는 듯이 잘 살겠지 지금 그리운 건네가 싶은 자연스러운 거겠지 사랑이 남은,1,0,5,3,8
228,마주했던 기억들을 오늘만큼은 바라보지 마긴 하루를 살아내는 매일 그러한 가요 서로 반짝이던 하얀 웃음 오늘만큼은 떠올리지마다 지워버릴 수 없는 아무 소용 없는 다짐 더는 의미 없는 후회 꼭 잡았던 우리의 많은 약속과 바램들이 아직 언저리에 아픈 나를 바라봐 줘요 아직 기대 울 뿐이죠 붙잡을 수 내일의 너를 행여 자리가 없을지라도 나를 돌아봐 줘요 내겐 서투른 어둠뿐이죠다가갈 수 매일의 너를 잡을 있다면 기다릴게요 걷던 그날의 수놓았던 걸음들이 가슴 안에 아픈 나를 바라봐 줘요 아직 기대 울 뿐이죠 붙잡을 내일의 너를 행여 자리가 다신 없을지라도 제발 알아봐 내겐 서투른 어둠뿐이죠돌아갈 아픔의 가질 있다면 기다릴게요 기다려줘요 기억해줘요,1,0,5,1,6
229,당신이란 사람 몸서리 처질 정도로 끔찍하네요 언제까지 안에서 그렇게 살아 숨 쉬고 있을 건가요 죽어 생각 인가 요시 간이 흐르고 마음이 흘러서 그렇게 당신도 흘러가야 되는데 그게 말처럼 쉽지가 않네요 그리움에 울다 지쳐 잠이 드는 것도 지겹고 같은 그리움에 사무쳐 눈을 뜨는 것도 지겨워 시간이 흐르고 마음이 흘러서 그렇게 당신도 흘러가야 되는데 그게 말처럼 쉽지가 않네요 안에 살고 있는 너의 기억 마음 다 멈춰버려서 흔한 추억조차 만들지 못하고 아직도 도대체 언제쯤에나 당신에게서 자유로울 수 있을까요 그런 날이 오기는 올까요 그때까지 견딜 수 있을까요 시간이 흐르고 마음이 흘러서 당신도 흘러가야 되는데 그게 말처럼 쉽지가 않네요 안에 살고 있는 너의 기억 마음 다 멈춰버려서 흔한 추억조차 만들지 못하고 아직도 이렇게 이별 중이죠,1,0,1,-3,-2
230,배드민턴 치자고 꼬셔 커피 한잔하자고 불러 동네 한 번 걷자고 꼬셔 넌 한 번도 안 된다는 말이 없었지 꽃송이가 꽃송이가 그래그래 피었네 꽃송이가 꽃 한 송이가 그래그래 피었구나 거리에 사람들 수많은 사람 길에 사람들 네게 특별한 건지 그게 어려운 거야 그게 어려운 거라 그게 어려운 거야 맛있는 거 먹자고 꼬셔 영화 보러 가자고 불러 단대 호수 걷자고 넌 번도 안 된다는 말이 없었지 그래그래 피었네 꽃 송이가 피었구나 거리에 사람들 수많은 사람 길에 네게 특별한 건지 거야 거라 하모니카 솔로 피었네 꽃 송이가 피었구나 거리에 수많은 사람 길에 네게 특별한 건지 거라,1,0,-1,-8,-9
231,늘 바라만 보네요 하루가 지나가고 하루가 지나도 그대 숨소리 그대 웃음소리 아직도 나를 흔들죠또 눈물이 흐르죠아픈 맘 모른 채 그댄 웃고 있네요 바보 같은 철없는 못난 나를 한 번쯤 그대 돌아봐 수 없는지 알고 있죠 바램들을 그대에겐 아무런 의미 없단 건 나였으면 사랑하는 사람 나였으면 수없이 많은 날을 기도해왔죠푸르른 나무처럼 말없이 빛난 별처럼 바라만 보고 있는 나를 그댄 알고 있나요 늘 오늘까지만 연습해왔던 사랑의 고백들도 슬픈 뒷모습 오늘까지만 맘을 모른 채 살아갈 테죠기다림이 잊힘보다 쉽다는 걸 슬프게 잘 알고 있죠 나였으면 사랑하는 사람 수없이 많은 날을 기도해왔죠푸르른 나무처럼 말없이 빛난 별처럼 바라만 보고 있는 그댄 있나요 묻고 싶죠 잘 지내는 가요 함께하는 사람이 그대에게 잘해주나요 바보 같은 걱정도 부질없단 걸 알지만 눈물 없이 꼭 한 번은 말하고 싶었죠 사랑한다고,1,0,1,0,1
232,가식적인 체면 다 다 버리고 사랑이 주는 많은 기쁨만을 노래해 미쳐있던 나의 사랑만큼 뛰면서 소리쳐 내가 버텨가야 하는 인생 속에 미쳐 갇혀 힘들다 하여도 그대와 나의 작은 사랑으로 가슴에 새기고 기쁘게 모든 걸 이겨가 어렵다고 생각 말아요 나도 그댈 바라보고 있는 걸 작은 고집 나의 마음을 감춰 둔 거죠 오지 치지 마요 힘을 내어요 오면 나를 느낄 수 있죠 날 안아줘요 깊은 맘으로 가슴 가득히 나를 사랑해 주세요 어디선가 들려오는 사랑 노래에 나와 기쁨에 파도에 몸을 실어봐 어차피 만들어 나가는 가치 너와 둘이서 하나가 되는 이치 모든 걸 맘 안아 뭘 하던 뭐든 건에 인생에 끝에 우리가 만났던 끝에 나를 담고 모든 다 맡기고 기쁨에 너와의 사랑에 차근차근 말해보세요 사랑하고 있다고 한 번만 말해줄래요 달콤함에 어지럽겠죠 오지 치지 마요 힘을 내어요 오면 느낄 수 있죠 날 안아줘요 깊은 맘으로 가슴 가득히 사랑해 주세요 너무도 힘이 때면 두 눈 꼭 감고 달려와요 내게도 그댄 전부죠 날 사랑해줘요 오지 치지 마요 힘을 내어요 오면 느낄 수 있죠 안아줘요 깊은 맘으로 가슴 가득히 사랑해 주세요,1,0,-3,5,2
233,그럴 수 있겠지 괜찮아 수 있어 너무 괜찮아 다시 혼자라니 믿어지니 새로 시작해 기대하지 않던 무엇이 이루어진 대 늘 똑같을 순 없어 계속 노력하십시오 계속 꿈을 꾸세요 조금씩 달콤해질 같아 그녀에게 키스할 수 있습니까 우리는 진짜 모르고 지냈어 너무 보였다 아픈걸 그것은 옳지 않아 다시 시작할 없는 거야 슬픈 얘기들 기대하지 않아 무엇도 설레지 않아 그녀의 이름을 속삭여 보네 가장 이상한 느낌 조금씩 달콤해질 같아 당신을 데리고 싶어요 당신은 내가 지금 노래하는 이유입니다 당신이 나를 너무 웃게 만들기 기분이 좋아요 가까이 오세요 그녀의 이름을 속삭여 보네 계속 성장하고 있습니다 가장 이상한 느낌 조금씩 달콤해질 같아 당신은 내가 지금 노래하는 이유입니다 당신이 나를 웃게 만들기 기분이 좋아요 가까이 와서 당신이 나를 잘 만들기 당신의 마음을 느끼게 해주세요 당신은 사랑이 아니에요,1,0,-3,2,-1
234,네가 날 싫어해 하는 걸 알아내는 서운해 그런 날 너는 못 이해해 당신은 이해하지 못합니다 너를 좋아한다고 내가 뭘 잘못했는데 내게 그러는데 그럴수록 되게 섭섭해 너무 슬프다 슬슬 내가 당신의 안에 들어오겠습니다 마음 중요한 건 마음 결코 얼굴만 보고 좋아하는 거 아니야 날 미워하는 너의 날이 선 말투까지도 사랑하게 된 거 이게 맘이야 너에 대한 건 사소한 것도 기억해 마니아 아무리 나삐 굴어도 넌 내게 순간 만화야 순정만화야 주인공은 맨날 맨날 이렇게 밤마다 기도해 사랑을 주다 사랑을 주세요 사랑을 주다 사랑이 모자라요 매일매일 자라는 그녀에게 주는데도 받질 않으니 주다 주세요 사랑이 모자라요 매일매일 자라는 그녀에게 주는데도 받질 않으니 잘못한 것도 없는데 무작정 싫어하고 보는 너나를 이해할 수 없는 유난 너를 좋아한다고 네가 싫어해 하는 걸 안 후부터 샘솟던 의욕이 다 시들고 설레던 맘도 끝이겠구나 했는데 또다시 슬금슬금 다가가도 될까 바라보는 것조차 싫어할까 봐난 몰래 뒤에서 긍긍 전전해 점점 해가 지면 달빛 정전에 용기가 맘을 전해하지만 그녀와 사이 거리 너무 멀어주고 주는 사랑이 길바닥에다 버려져 낙엽처럼 쌓이네 봄이 되면 흙으로 남아 기대해 싹이 될까 주세요 모자라요 매일매일 자라는 그녀에게 주는데도 받질 않으니 사랑스럽게 사랑받는 사랑의 사랑과 사랑의 사랑의 주십시오,1,0,-5,-12,-17
235,꿈에 너의 번 홀 연락처에 다시 올렸어 이미 바뀐지 오랜데 너의 번 홀 등록하니 떠오른 너의 얼굴 오랜만에 보았어 잠든 바 너에게 말을 건넬까 어차피 꿈인데 넌 망설이니 꿈에서 본 너에게 말하다 꿈을 깰까 아무 말 못 한 채 바라보고 있어 번의 이별을 해야 괜찮니 이번엔 안되니 그만 아프고 싶은데 눈물이 흐르다 기억 추억 흐른다 웃는다 이별이다 안녕 드디어 너에게 도착한 설레는 메시지 안녕 잘 지냈니 왠지 아픈 말 잘해주지 못한 일만 떠올리다나도 모를 전활 네게 걸고 있어 번의 이별을 해야 괜찮니 이번엔 안되니 그만 아프고 싶은데 눈물이 흐르다 기억 추억 흐른다 아아 이제 그만 안녕 이렇게 널 여러 번 보냈어 이제 널 잊고 싶은데 꿈에서도 우린 이별하지 못하고 이렇게 가슴 터지게 눈물만 흐르다 번의 이별을 해도 너야 다시 제자리야 내가 사는 이유 너야 아무리 이별 요란하게 해봐도 자리 절대 비워지지 않는 자리,1,0,5,4,9
236,다시 누워난 그댈 헤치지 않아요 다시 누워난 뒤로 물러서 그댈 볼게요 당신이 날 사랑한다고 수 있을 만큼만 사랑을 줘요 수 있을 만큼만 기쁨을 줘요 너무 과하지도 않게 부담주지 않을게 뒤로 누워 있으면 다시 누워 있습니다 너의 그림자 되어 늘 곁에 있을게 넌 옆에 붙어 누가 봐도 부럽게 꿈속에서도 너만 그려이런 맘 넌 아는지 뒤로 누워 있으십시오 천천히 걸어 있으십시오 넘어지지 말고 백 레이를 레이블로 오라 백 레이를 말해줘 사랑에 빠지기 그댈 알면 알수록 궁금해 눈에 안 보이면 있는 건 아닐까 걱정돼 수 있을 만큼만 사랑을 줘요 기쁨을 너무 과하지도 않게 부담주지 않을게 있으면 있습니다 너의 그림자 되어 늘 곁에 있을게 넌 옆에 붙어 누가 봐도 부럽게 꿈속에서도 너만 그려이런 맘 아는지 천천히 걸어 백 레이를 놓으십시오 넘어지지 말고 누워서 오백 사랑하자 베이비 사랑해 잘 가란 인사를서로 건네고 아쉬워 잡은 두 손을 붙잡고 분만 아주 잠시만 옆에 있어줄래 밤이 끝나기 전까지만 너의 그림자 되어 늘 곁에 있을게 붙어 누가 봐도 부럽게 꿈속에서도 너만 그려이런 맘 아는지 있으십시오 천천히 걸어 넘어지지 말고 누워서,1,0,-3,1,-2
237,처음 너를 본 순간 정신 차릴 수 없어내 마음을 들킬까 조심조심해 어떡하면 맘을 답답해진 맘을 쫄깃해진 심장이 어쩌면 좋아가까워졌다 점점 멀어져 가는 이상해울다가 웃다 내버려 둬요 언제나 이랬다 저랬다 헷갈려 그녀는 맘을 들어다 놨다 들었다 놨다 들었다 놨다 들어다 들었다 들어다 다시 너를 본 순간 차갑게 대해보려 애써 관심 없는 듯이 외면했지만 너의 눈빛 하나에 너의 손짓 하나에 바짝바짝 말라버려 나의 입술은 멀어져 갔다 다시 다가와 주는 오늘도 울다가 웃다 점점 짜증이 나오 언제나 이랬다저랬다 헷갈려 그녀는 봐들어다 어떡 하면 그녀를 맘속에 가둬 수 있을까 봐들었다,1,0,1,-3,-2
238,너무 오래전에 깨어난 파란색의 느낌이 들었습니다 내가 당신을 자신을 부르고 애호가를 하고 부를 수 있습니까 당신을 부르기 위해 전화할 수 있습니까 눈이 너를 향해 웃으면 서있는 별에서 사람이 없고 사랑이 없다는 것을 알았다는 내가 식으로 느끼지 않았다 내가 당신이 긴장했을 것인지 확실히 당신이 긴장했을 것입니다 당신을이라고 부를 수 있습니까 연인을 당신에게 유일한 소녀와 유일한 소녀는 당신을 부를 있습니다 운영하는 유일한 사람 자신이라고 부르고 연인이라고 세상을 운영하는 사람입니다,1,0,0,-7,-7
239,세상을 몰랐었던 마냥 웃기만 했던 푸른 하늘 닮은 꿈을 가진 키 작은 꼬마가 어느새 담을 넘는다 언덕 위로 좁게 트인 작은 길 어디로 가는 걸까 작은 돌에 그만 넘어져도 일어나 다시 길 걸어보렴 더디면 어디든 한 걸음씩 너무 행복합니다 너의 손을 잡고서 너와 발을 맞추며 가자 우리는 춤을 추고 있습니다 서두르진 마 익숙한 멜로디를 불러봐 후루루 후루루 너를 위한 멜로디 후루루 누구도 상상 못 할 내일이 오겠지 소나기에 자라난 무지개를 빌려다 포켓 속에 가득 꼭 넣어두렴 주문을 외워 괜찮을 거야 한 걸음씩 너무 행복합니다 너의 손을 잡고서 너와 발을 맞추며 가자 우리는 춤을 추고 있습니다 서두르진 마 이제 익숙한 멜로디를 불러봐 너를 위한 멜로디 하늘 아래 누워 쉬어가도 돼 눈을 감아도 보이는 너를 닮은 별 찾아 고맙다는 인사를 건넨다 크게 너야 한걸음 너무 행복합니다 다시 밝아온 아침 머나먼 여행을 떠나자 우리는 속합니다 혼자가 아냐 영원히 위해 불러줄 멜로디로 루루 우릴 위한 멜로디로 루루 지금 앞에 있는 내가 찾던 세상,1,0,-3,5,2
240,날 바라봐 줘 아직 사랑을 모르지만 옆에 서십시오 날 지켜봐 줘 아직 사랑에 서툴지만 너를 볼수록 기분이 좋아져나도 몰래 노래를 불러 한 송이 장미를 사고 싶어진 모습 신기한데 마음이 너에게 닿는듯해 세상이 아름다워이런 설렘을 너도 느낀다면 부디 조금만 기다려줘함께 사랑하게 만듭니다 너의 환한 미소 가득히 사랑하게 만듭니다 이제 손을 손을 잡아내 옆에 서십시오노를 바라봐 줘 아직 사랑을 모르지만 옆에 서십시오노를 지켜봐 사랑에 서툰 같아 너를 알수록 가슴이 떨려와나는 웃고만 있어 너에게 살며시 키스해볼까 맘에 다 가설 까네 마음이 어쩌면 사랑일까 아직은 수줍은데 한 걸음도 다가서지 못한 나의 사랑을 기다려줘함께 사랑하게 만듭니다 너의 환한 미소 가득히 이제 조금씩 조금씩 갈게 나를 바라봐 가까워지고 싶어내 서십시오노를 지켜봐 멋지게 보이고 싶어난 처음엔 몰랐어 누군가 바라보는 아직도 마음 몰라 그대는 그대를 사랑해함께 너의 환한 미소 가득히 이제 손을 잡아 나를 모르지만 사랑에 서툰 같아,1,0,-8,-1,-9
241,우린 첨부터 어울리지는 않았죠 단 투기만 하고 속만 태우던 사이였었는데 이상한 건요 어느새 맘이 통해서 곁에 없으면 미칠 것처럼 그댈 보고 싶은 걸 특별한 나만의 님으로 설렘이 가득 찬 선물로 점점 다가서는 그대를 어쩜 좋아요 그대 가슴이 심장이 두근두근 그대만을 사랑해 맘 가득 외치는 말도 눈을 꼭 감고서 떨리는 입술을 내민 날 보면 먼저 안아주는 그댈 꿈꾸고 있죠 그대에 기대어 잠든 척했었던 날 나보다 큰 그대의 심장 소리가 들려 왔죠 숨결도 감출 수 없는 건 꿈에도 원하고 있는 건 세상 무엇보다 소중한 한 사람 그대 가슴이 심장이 두근두근 그대만을 사랑해 맘 가득 외치는 말도 눈을 꼭 감고서 떨리는 입술을 내민 날 보면 먼저 안아주는 그댈 꿈꾸고 있죠에 미 알고 있어요 그대 나와 같단 걸 눈부시게 심장 속에 새겨진 사랑인 걸 영원히 심장이 두근두근 그대만을 사랑해 맘 행복한 말도 활짝 펼쳐서 떨리는 가슴을 내준 그대여 최고의 사랑을 안겨 줄게요,1,0,-9,4,-5
242,창문을 두드리는 깨끗한 빗소리에 널 만나기 전 설렘이 더해가고 영화를 보러 갈까 어디로든 떠나볼까 투명하게 물든 거리를 걸어볼까 가까이 작은 우산 속에 한쪽 어깨 끝이 다 젖어도 좋은 걸 널 사랑하나 사랑에 빠졌어 기분 좋은 느낌이 변함없길 바라 널 사랑하나 보고 싶어 매일 모닝커피를 너와 들고 싶어 언제나 힘겨울 내게 올 그런 사람 애써 얘기하지 않아도 아는 사람 가끔씩 화를 내고 때론 내가 토라져도 오랜 친구처럼 살며시 나를 꼭 안아줘 조금씩 다가와 나를 보여줄게 은은한 향기처럼 나의 곁에 머물러줘 사랑하나 사랑에 빠졌어 기분 좋은 느낌이 변함없길 바라 보고 싶어 매일 모닝커피를 너와 들고 꿈은 아니겠지 비를 타고 찾아온 수줍은 사랑 너무나 행복해 언제나 투명하게 나만 사랑해줘,1,0,-3,-3,-6
243,언제쯤 그대는 얘길 내게 할는지 매일 헤어지는 건 싫다는 그런 얘기 한 번쯤 그대도 나와 같은 생각하는지 매일 혼자서 상상만 하죠 꿈 들새 하얀 집을 꾸미고 작은 정원을 가꾸는 꿈 그렇게 될 수 있다면 세상 모든 걸 가진 거야 둘이서 찍은 사진을 보며 그대 오길 기다리며 언제나 눈부신 아침을 너의 옆에서 만나는 꿈 한 번쯤 그대도 나와 같은 꿈을 꾸는지 매일 혼자서 상상만 하죠 들새 하얀 집을 꾸미고 작은 정원을 가꾸는 그렇게 될 수 있다면 세상 모든 걸 가진 거야 둘이서 찍은 사진을 보며 그대 오길 기다리며 언제나 눈부신 아침을 너의 옆에서 만나는 꿈가만히 눈 감고 그때를 생각하면 어색하긴 해도 나도 몰래 웃음 지으며 행복해 하죠새하얀 집을 꾸미고 작은 정원을 가꾸는 그렇게 될 수 있다면 세상 모든 걸 가진 거야 둘이서 찍은 사진을 보며 그대 오길 기다리며 영원히 눈부신 아침을 너의 옆에서 맞고 싶어,1,0,1,5,6
244,금요일에 토요일에 놀고 싶어 도모 챠쿠신노첵쿠시테 미테모당신은 나타나지 않을 것입니다 콧치카라 카케테모 이이 캐도 자존심은 친구가 계속해서 당신에게에게 좋지 않다고 말하는 방식에 도달합니다 안 나야 쓰 홋토키나볼이 너무 많아 요요의 히토니 데 아우 찬스와 아루 시킴요 비노 스칼라 니키 미오 와스레니오도리아카스요 콩이야 노래를 부를게요토도쿠요니세츠나이 메로 비니나 미다 시나이 여니 쿠루 너네 오도 리츠 즈케사세테네 는 다시 오지 않을 것입니다 후로 오못토 아츠쿠히비카세테응아사마데 마와시츠즈케테카에리타쿠 나이 카라 토에 나이데 쵸쿠츠코레 아스트로시레테루하즈모 이와 스토 이후로 계속 하츠 토조 미미 카라 하나레루 코 토네 흐름캇소로 절하다쥬단 토츠뉴 아라유루 쿠칸 아라고 유루 슈하스침략 입체 게쥬츠 누구를 말해주세요 로쿠만도 루노 휴먼 내에 진정 해소라 토부 주탄 쇼단 소시아루~보다아후로큐방 도카 시테 쿵제 미치후사 프루 야츠라 케토 바스 코레 슈카 그것에 낙지하지 않습니다다마라스 나무 코토르 마키 쿳챠우 후론토 아쿠 토이 마이,1,0,1,0,1
245,지내세요 괜찮아요 감사합니다 오가다 하는 인사말 언제쯤 들을까요 당신을 사랑합니다 당신이 가까이 있어 그것만으로도 꾹 참고 기다려요 그대와 나의 암호죠 느낄 수 있잖아요 마음이 너무 환해져 가슴이 벅차오네요 사랑은 이런가요 고등학교 학년이고 열여덟 풍선처럼 부풀었던 감정 무섭기만 했던 부모님 속이고 큰맘 먹고 갔던 그곳 여름 날 바캉스 기차 안에서 마주쳤던 두근대는 맘 뒤로하고서 그대와 다시 멀어지고 아쉬워 어머 웬일이니 해변가에서 마주친 너와 어쩜 한마디도 건네보지도 못하고 서울로 돌아오고 한 달 두 달 세 달 만화 속 주인공이 되어버렸죠 예전 그대 모습 그리며 다시 보기만을 기대하면서 밤새 별을 보며 기도하면서 오가다 하는 인사말 언제쯤 들을까요 당신을 사랑합니다 당신이 가까이 있어 그것만으로도 꾹 참고 기다려요 사랑해 지내세요 괜찮아요 감사합니다 그대와 나의 암호죠느낄 수 있잖아요 마음이 너무 환해져 가슴이 벅차 오네요 사랑은 이런가요 당신을 사랑합니다 부스스 졸린 눈을 비비며 가는 학교길 어머 이럴 수가 믿기지 않아 볼을 꼬집어도 보고 깜박여도 보고 해도 있는 모습 역시 한 두 정도 보기 바빴고 언제부턴가 다시 멀어지고 아쉬워 나도 대학생 근데 이게 뭐야 변함없는 하루 일과 왔다가 갔다가 갔다 왔다 재미없어 따분해 언제나처럼 집으로 오는 길 너무 놀라 휘둥그레져 옆집으로 이사 온 너를 보게 되고 하늘이 나를 도와 이번에는 제대로 아직까지 안부 인사 외엔 말 못 해봤지만 알잖아요 그대 미소가 다정하다는 걸 당신은 지내세요 감사합니다 오가다 하는 인사말 언제쯤 들을까요 당신이 가까이 있어 그것만으로도 꾹 참고 기다려요 나의 암호죠느낄 수 있잖아요 마음이 환해져 가슴이 벅차 오네요 사랑은 이런가요 느낄,1,0,-6,0,-6
246,당신은 맘 모르고 있게죠 떨리는 맘 모르고 있겠죠 그대만 보면 뛰는 가슴 아마 상상도 못하겠죠 오늘도 그댈 멀리서 보았죠 항상 이렇게 주위만 맴돌죠 할 말이 너무도 많지만 그대 앞에선 말 못 하죠 그대를 보면 사랑이 보여요 그대 웃으면 사랑이 웃어요 그대 날 부르면 사랑이 날 불러요 없으면 사랑도 없어요 떠나면 사랑도 떠나요 내게 오면 내게 와요 언젠간 고백할 수 있을까요 내게 그런 용기가 있을까요 마음 전하기도 전에 떠나면 어떡하죠 것인가요 이렇게 가슴 아픈 것인가요 그댈 바라보는 눈에 눈물 고이는 것인가요 그대를 보면 보여요 웃으면 웃어요 날 부르면 불러요 없으면 사랑도 없어요 떠나면 떠나요 오면 와요,1,0,-3,-3,-6
247,사랑 사랑 사랑 사랑을 주는 사랑보다 사랑해 당신은 너무 산만해요 식으로 느끼기 내가를 만났기 관심을 유지할 수 없고 당신은 사랑을 비난해야 한다 내용은 컨트롤에서 벗어났을 당신의 손에 빠졌고 우리가 어디에 있는지 모르겠다 도망치고 싶다 두 세계가 되십시오 사랑은 영구적인 산만함 완벽한 상호 작용 느낌이 너무 극단적인 식욕을 잃어버린 식욕을 잃어버렸습니다 이것은 컨트롤에서 벗어났고 당신의 손에 떨어졌고 우리가 어디에 있는지 모르겠다 마음을 위해 당신의 사랑은 비가 내린 것보다 큽니다 당신이 꿈에 빠졌고 내가 강하다고 생각했지만 모든 것을 알고 있다고 생각했지만,1,0,-1,-3,-4
248,내가 노래를 들려줄게 내가 휘파람 불어줄게 맑은 너의 눈 보며 맨발의 널 보며 마음도 깨끗해져요 우린 너무나 먼 곳에 한참을 달려도 널 만나 행복해졌어 이제 노래를 들려줄게 내가 염소를 선물할게 신발을 신겨줄 벅찬 모습 보며 웃는 너를 마음도 행복해져요 우린 너무나 먼 곳에 떨어져 있지만 널 도와 행복해졌어 이제 노래를 들려줄게 이제 너에게 선물할게,1,0,-2,-5,-7
249,넌 몰랐겠지만 사랑은 허구입니다 이미 모든 건 다 정해져 있는 걸 그대 넌 운명이야 첨 본 순간부터 시작된 이야기 넌 신데렐라 하나뿐인 왕자는 나잖아 늘 곁에 있을게 웃어줄게 그냥 있으면 돼 이제야 말하는데 널 만난 건 맹세코 절대로 우연히 아니야 이제야 고백하는데 네가 나를 만나기 전부터 여자였어 당신은 나를 느끼게 합니다 사랑은 다 널 위한 진심인 걸 당신은 나를 가져 가게 합니다 시작된 거야 너와 나의 사랑 소설 고백하지만 사랑은 허구입니다 이미 너의 맘을 다 알고 있는 걸 그대 당신은 햇살입니다 잠 못 들게 하는 카페인 어린 왕자 늘 너에게만 기대고 싶은 어디서나 편이 돼줄게 그냥 있으면 돼 이제야 말하는데 널 만난 건 맹세코 절대로 우연히 아니야 고백하는데 네가 만나기 전부터 여자였어 사랑 사랑 달콤한 로맨스 그대와 유치한 이야기 그대와 영원히 너만을 사랑해 말하는데 만난 맹세코 절대로 우연히 아니야 고백하는 데니까 만나기 전부터 여자였어 위한 소설 진심인 가져 가게 합니다 시작된 거야 너와 나의 소설 너와 나의,1,0,-6,-1,-7
250,뭐라도 말할 있는 것처럼 불러 놓고 분도 못 참고 일어서서 나가고 말걸 안아주기를 대뜸 원한 것도 잊어주기를 대뜸 말한 것도 롤링 될 거야 굴러 갈 거야 사랑이 이리 힘든지 두고 볼 굴러 갈 거야 다 온 같아졌어 됐어 이게 다라면 뭐라 하겠어 너무 많이 됐건 됐건 시간이 됐다 믿어안아주기를 대뜸 원한 것도 잊어주기를 말한 롤링이 될 롤링이 롤링 될 사랑이 이리 힘든지 두고 볼 굴러 갈 다 온 같아 어떨지 모르는 걸 괜히 마음만 너에게 뺏겼나 아냐 아냐 안아주기를 원한 잊어주기를 말한 롤링이 롤링 사랑이 이리 힘든지 두고 볼 다 온 같아 같아,1,0,1,-3,-2
251,그녀가 사랑스럽지 않아 그녀는 훌륭하지 않다 그녀는 분 귀중한 분 사랑을 통해 결코 사랑을 통해 우리가 사랑스럽지 않다고 생각했지만 그녀가 사랑스럽지 않다 천사의 최고의 소년 너무 행복해서 우리가 천국이 되어 축복을 받았습니다 하나님께서 우리를 통해 우리를 행하신 일을 믿을 수 없습니다 인생은 그녀의 이름의 의미 론 디아 의미 론디입니다,1,0,-7,-2,-9
252,매일 하늘을 오르내리는 같아널 보고 있을 때면 정말로 우린 커다랗게 사랑하고 있는 거 맞지 그치네 눈엔 너무나 커 보이는데 사람들 눈엔 작아 보인데 일까 너의 마음은 내게 마음 같지 않은 걸까 아름다운 그대에게 영원히 남고 싶어널 지켜주고 싶어아름다운 그대에게 내가 너의 하늘이 되어줄 수 있다고 하이 하이 하얀 아름다운 그대 맘과 같나요 하이 하얀 아름다운 우리네 맘속에 번져가네 우리는 너무 아름다워 넌 날 생각해 눈엔 너무나 커 보이는데 사람들 작아 보인데 일까 너의 마음은 내게 마음 같지 않은 걸 꺼내 마음 같은 곳을 보니까 알아 하나뿐인 나만 마음을 바니 말 하나하나에 하루가 결정돼 난내 날개는 앞에서만 반응해 벼랑 끝에 막혀도 너니까 가능해 나에게 사랑을 주지 않을래아름다운 그대에게 영원히 남고 싶어널 지켜주고 싶어아름다운 내가 하늘이 되어줄 수 있다고 하얀 그대 맘과 같나요 당신과 사랑에 빠졌습니다 우리네 맘속에 번져가네 우리는 너무 아름다워아름다운 영원히 남고 싶어널 지켜 주고 싶어아름다운 내가 하늘이 되어줄 수 있다고 지켜 주고 너만의,1,0,-5,-3,-8
253,매일 똑같은 지루함 속에 널 만나는 걸 너의 눈 속에 언제부턴가 모습이 보이고 있어 어린아이 같은 걸 숨길 수가 없는 걸 두근거림조차 느껴져나는 사랑 받고 싶다 내게 다가와 너의 손을 잡을게 눈에 너를 담으려나는 그것을라고 부를 수 있습니다 나도 몰래 찾아오는 설렘에 당신은 그것을 사랑이라고 부를 수 있습니다 망설이지 마 도망치지 마 늘 곁에 있어줘나는 그것을라고 부를 수 있습니다 나도 몰래 다가오는 설렘에 당신은 그것을이라고 사랑을 사랑할 사랑이라고 부릅니다 오늘 하루는 아무런 걱정만 너의 날인 당신이 나를 너무 원한다는 앓아 눈빛이 언제부턴가 내게 말하고 있거든 어린아이 같은 숨길 수가 없는 두근거림조차 느껴져나는 사랑 받고 싶다 내게 다가와 손을 잡을게 눈에 너를 담으려나는 그것을라고 나도 몰래 찾아오는 설렘에 망설이지 마 도망치지 늘 곁에 있어줘나는 다가오는 당신은 그것을이라고 사랑을 사랑할 사랑이라고 부릅니다 모든 변해 상처받을 바엔 혼자가 편해진 심 없는 만남 이별 표정은 태연해하며 떼어냈던 안의 사랑 잠들어있던 사랑을 일깨워준 사람 가벼운 관계 배려 말투에 다운되어 있던 뻔한 일상과 작별할 때야 새로운 사람 인사해 새로운 나날 반가운 아침을 맞이해 오늘은 최고의 날이야 밝은 미소에 일주일을 버텨 일이 바빠도 해 본적 걱정 주말에 가고 싶은 곳이 많아졌어고마워 나의 진짜 모습 알아줘서 너무 행복해 네가 여자라 역시 나와 같은 마음이라는 알아급하게 가지 말자 천천히 느낌 오래 간직하고파 영원히 찾아오는 망설이지 도망치지 늘 곁에 있어줘 다가오는,1,0,-7,-2,-9
254,네가 떠난 작은방 안에 남겨진 너의 온기가 나를 차갑게 만들어작은 불빛 속에 남겨둔 우리의 아주 작은 꽃이 졌네 날이 추워서인지 네가 떠나서인지 무뎌진 내가 옷을 걸쳐 길을 나선다 하루 지나면 생각이 날까 잊히지 않는 그날의 얘기처럼 한참 뒤엔 너를 바래다주던 좁은 길에 멈춰 서네 계절인지도 전혀 모른 체 웃음소리가 떠난 적 없던 사소한 일들마저도 소중하게 놓지 않고 간직하네 익숙해진 탓인지 버릇처럼 베인 건지 불안한 나의 입술은 메말라가네 하루 지나면 생각이 날까 잊히지 않는 그날의 얘기처럼 한참 뒤엔 너를 바래다주던 좁은 길에 멈춰 서네 선선히 불어온 바람마저 달갑지 않은 표정을 머물 곳 없는 마음과 무너진 머릿속 작은 이야기네가 떠난 작은방 안에 남겨진 너의 온기가 나를 차갑게 만들어작은 불빛 속에 남겨둔 우리의 아주 작은 꽃이 졌네,1,0,3,2,5
255,아기 웃어요 아기 아기 한번 해보면 쉬운걸요 나쁜 기억은 버려요 지나면 끝인 걸요 첫 키스에 들뜬 그날도 설렌 겨울 여행도 기쁜 생을 소중했던 순간 잊진 말아요 행복하게 행복한 당신을 사랑합니다 늘 하루 한 번 꼭 생각해봐요 행복하게 행복한 당신을 사랑합니다 소중한 추억들 만들어가요 때론 힘들어 울겠죠 한숨이 나오겠죠 아픈 기억은 지워요 다시 털고서 일어나요 꼭 손잡고 했던 약속도 지갑 속 그대 사진도 작은 속삭임도 사랑했던 순간 잊진 말아요 늘 하루 한 번 꼭 생각해봐요 소중한 추억들 만들어가요 행복하게 행복한 당신을 사랑합니다 늘 하루 한 번 생각해봐요 소중한 추억들 만들어가요 그대 맘속에 숨어있던 바램들도 노력하면 되겠죠 조금씩 이뤄질 수 있죠 날 바라보는 따스한 햇살도 하루로 시작해봐요,1,0,-2,0,-2
256,지겨운가요 힘든가요 숨이 턱까지 찼나요 할 수 없죠 어차피 시작해 버린 것을 쏟아지는 햇살 속에 입이 바싹 말라와도 할 수 없죠 창피하게 멈춰 설 순 없으니 단 한가지 약속은 틀림없이 끝이 있다는 끝난 뒤에 지겨울 만큼 오랫동안 쉴 수 있다는 지겨운가요 힘든가요 숨이 턱까지 찼나요 할 없죠 어차피 시작해 버린 것을 쏟아지는 햇살 속에 입이 바싹 말라와도 창피하게 멈춰 설 순 없으니 이유도 없이 가끔은 눈물 억울하겠죠 일등 아닌 보통들에게 박수조차 남의 일인 걸 단 한가지 약속은 틀림없이 끝이 있다는 끝난 뒤에 지겨울 만큼 오랫동안 쉴 그것은 나에게 충분히 좋다는 나에게 충분하다,1,0,3,2,5
257,그대에게 불러주고 싶은 노래들을 틀어놓고 수많은 마음들을 뭐라고 전할까 생각해요 그대에게 들려주고 싶은 이야기는 많은데 수줍은 나를 기다려줘요 이미 지나가 버린 사랑의 기억을 질투해 가끔 잠 못 이루다 가도 결국엔 결국엔 그대는 나에게 늘 새로운 사랑 이예요 그대와 맘이 늘 똑같지 않다 해도 그대는 나에게 늘 새로운 사람이에요 이미 지나가 버린 사랑의 기억을 질투해 가끔 잠 못 이루다 가도 결국엔 그대는 나에게 새로운 사랑 이예요 그대와 맘이 똑같지 않다 해도 사람이에요 해가 떠오를 때부터 해가 질 때까지 달이 떠오를 때부터 잠들 때까지 해가 떠오를 때부터 질 때까지 달이 잠들,1,0,-2,-11,-13
258,거짓말처럼 앞에 네가 내게 말 걸어줬으면 해 논 아마 모를 거야 당신은 나에게 모든 것을 의미합니다 넌 생각해 소녀 다이빙을 하러 가려고 난에서 다이빙을 할 때나는 여잔 필요 없어 여자들도 내겐 관심 없어내가 못나서 라면 그거는 아니고 잘 중요한 건 그냥 마녀에게 시간을 보내고 싶어요 넌 대체 생각하는데 머릿속에만 맴돌아 나오지 않아 입 밖엔 너를 대체 해 그냥 내게 해주세요 잠깐만 잠깐만 너의 수영장에 빠진 같아 괜찮아 괜찮아 괜찮아 너의 미소만 보면 다 좋았어요 거짓말처럼 앞에 네가 내게 말 걸어줬으면 해 논 아마 모를 거야 당신은 나에게 모든 것을 의미합니다 넌 생각해나는 데서 다이빙을 하기 위해 다이빙하기 위해 다이빙하기 위해 하기 하기 위해에서 멍청한다 너도 잘 알잖아 너의 인스타그램을 보느라 밤잠도 안 자고 이러고 있어 카페인으로 가득 찬 어항이 밤보다 깊어진 건 나의 마음인 듯싶어 기다려 전화 거리를 둬 봐도 너무 빡빡합니다 무더운 성수기의 콘도 멀지도 가깝지도 않은 사이 너에게 달려갈게 프런트로 내일은 같은 방에서 새 아침을 맞으며 말할게 많이 남는 날엔 너랑 있고 싶고 날이 맑은 날엔 달리고 싶어나쁜 날엔 너랑 쉬고 싶지 사실 날씨 따윈 아무 상관없지 있는 마냥 좋지 뭐가 가치 있는 일인지 모르겠지만 그냥 너에게로 깊게 빠질 거야 우리는 너와 젊은 날의 아까운 여름 마음은 너무 더운 해태 양인 걸 오늘 밤 그렇다면 밤에 뭘 하면 좋을까 시원한 너를 향해 빠져야겠어 에어 할,1,0,-2,5,3
259,힘들었겠지 하루가 유난히 길었을 거야 지금 내가 데리러 갈게 지쳐있을 모습에 바뀌는 빨간 신호등에 괜히 맘이 조급해 너를 위해 베이비 너를 위해 베이비 뭐든 다 말해도 돼 내가 다 들어줄게 원인 당신에게 좋습니다 오늘 밤 나와 샴페인 어때좋아하던 카페에 라테는 오키아너하고 싶었던 거 다 얘기해줘 당신을 위해 잘할 수 있습니다 피곤할 텐데 졸아도 돼 어차피 차도 막히는 데다와 갈 때쯤 깨워줄게 너를 베이비 아무 말 안 해도 돼 내가 알아줄게 원인 당신에게 좋습니다 오늘 밤 나와 샴페인 어때좋아하던 카페에 라테는 오키아너하고 싶었던 거 얘기해줘 아기는 걱정하지 마세요 당신을 잘할 수 있습니다 지치고 우울하다 느낄 때아닌 꼭 않아도 나를 불러줘 옆에 있을게 연애 바비가 나를 들여보냈다오 늘 밤 나와 샴페인 어때좋아하던 카페에 라테는 오키아너하고 싶었던 거 얘기해줘 아기는 걱정하지 마세요 당신을 잘할 수 있습니다,1,0,4,7,11
260,당신은 내가 당신에게 모든 것을 것이라는 것을 알고 있습니다 지금 당신에게 사랑이를 채우고 있다고 믿습니다 기억은 우리를 거기에 데려갈 것입니다 너무 슬프게도 우리는 절대 분리할 것입니다 지금 당신의 영혼에 들어가는 것을 알고 있습니다 당신에게 모든 것입니다 내가 당신의 삶을 주고 싶다는 알면 내가 기억하는 말을 듣고 기억이 우리를 거기에 데려갈 것이라고 말하는 듣고 당신을 그리워했을 너무 슬프게도 우리는 결코 분리할 당신의 영혼에 들어가는 알고 모든 줘 당신이 인생을 주실 것인가 당신이 말하는 듣고 싶을 기억이 우리를 거기에 데려갈 것이라고 말하는 당신을 그리워했을 너무 슬프게도 우리는 결코 분리되지 않을,1,0,-1,2,1
261,원인은 자신의 장소를 찾기 위해 충만한 생명을 찾고 있었을 것입니다 아마도 파티가 말하거나 초콜릿 퐁듀 버트와 당신과 당신의 자리를 발견한 것을 발견했습니다 당신과 당신과 문을 열어 두는 문은 우리가 서로를 끝내는 것이 미친 것임을 의미합니다 작별 인사 작별 인사 과거의 고통은 과거의 고통을 느낄 필요가 없다고 생각할 필요가 없다 미친 듯이 말해봐,1,0,5,0,5
262,언제부터 사랑이었는지 알아채는 요령 없나요 맘이 변해서 사랑하게 되는지 나만 훔쳐보고 싶은데 사랑하면 달라진다는데 알아채는 요령 없나요 말을 숨기고 애태우게 하는지 그만 내게 가르쳐줘요 매일 단장하는 그대의 부지런함 나완 무관한가요 그런가요 몰라보게 착해진 마음씨에 다들 놀라요 사랑하나요 나도 그댈 사랑해 그대보다 오래오래 평생 웃게 해줄게 둘이서 산다면 맘이 변해서 사랑하게 되는지 그만 내게 가르쳐줘요 괜히 토라지는 어설픈 연기가 내겐 묘한 즐거움 귀여워요 아무 상관없는 걸 맞춰보는 건 아마도 사랑하나요 나도 그댈 사랑해 그대보다 오래오래 평생 웃게 해줄게 둘이서 산다면 나도 그댈 사랑해 그대보다 많이 많이 평생 보살펴줄게 둘이서 산다면  많이 많이  이뻐해 줄게 산다면,1,0,-1,0,-1
263,몇십 서로 달리 살아온 달라도 한참 달라 너무 피곤해 영화도 멜로 너는 행동 피자 너는 순두부 우린 통한 있어 김밥 김밥을 좋아하잖아 언제나 김과 밥은 붙어산다고 너무나 부러워했지 잘 말아줘 잘 눌러줘 밥알이 김에 달라붙는 것처럼 너에게 붙어 있을래 날 안아줘 날 안아줘 옆구리 터져 버린 김밥처럼 가슴 터질 때까지 예전에 김밥 속에 단무지 요새 김치에 치즈 참치가 세상이 변하니까 김밥도 변해 우리의 사랑도 변해 잘 말아줘 눌러줘 밥알이 김에 달라붙는 것처럼 너에게 붙어 있을래 날 안아줘 옆구리 터져 버린 김밥처럼 가슴 터지게 해낼 사랑해 널 사랑해 세상이 우릴 갈라 놓을 때까지 영원히 사랑할 꺼야 끝까지 붙어있을래,1,0,-3,0,-3
264,힘을 내라고 말해줄래 눈을 반짝여 날 일으켜줄래 사람들은 원하지 빨리 많이 평범한 소녀인 걸 바람은 자유로운데 모르겠어 다들 어디론지 힘을 왔잖아 이것쯤은 별거 아냐 세상을 뒤집자 도무지 알 수 없는 것뿐인 복잡한 지구가 재밌는 이유는 사랑한다고 말해줄래지친 널 감싸고 웃어줄래 사람들은 원하지 빨리 많이 평범한 소녀인 걸 하늘은 저리도 파란데 모르겠어 다들 어디로 가하지만 힘을 왔잖아 이것쯤은 별거 아냐 세상을 뒤집자 하도 무지 알 수 없는 것뿐인 복잡한 지구가 재밌는 이유는 너나는 당신이 당신이 있는 방식으로 당신을 좋아합니다 네가 나타난 뒤 모던 달라졌어 이제부터 다시 시작해 좋았어 왔잖아 이것쯤은 별거 아냐 세상은 뒤집혔어 도무지 알 수 없는 것뿐인 복잡한 지구가 재밌는 이유는 당신의 사랑에 대해 예입니다 도무지,1,0,-4,-3,-7
265,두 사람은 가자 눈독 들지 마요 나만 바라봐 주세요 손 한번 잡을게요 나를 두려워합니다 아찔한 느낌 한자리 비워 주세요 이리 봐도 저리 봐도 섹시한 살살 녹아 녹아 우짜면 좋노 어떡해야 하니 두 눈 뜨고 봅시다 울적한 날엔 나에게 키스해줘요 달콤해 달콤해 입맞춤 가슴 떨려 행복한 날처럼 너에게 뽀뽀해줄게 뽀뽀 달콤해 솜사탕 너야 남의 눈치 신경 마요 밥 한 끼 사줘요 가슴에 안아줘요 엄마 엄마 여기서 그만 아직은 서둘지 마요 이리 봐도 깜찍 저리 깜찍 살살 녹아 우짜면 좋노 어떡해야 하니 커플 완벽해요 울적한 날엔 나에게 키스해줘요 입맞춤 가슴 떨려 행복한 날처럼 너에게 뽀뽀해줄게 솜사탕 당신과 시원한 내게 약속 하나만 할게요 나만을 아껴 그런 사람이 되어줘요 그것을 할 수 행복한 날처럼 너에게 뽀뽀해줄게 자기야 자기야 노래를 사랑합니다 날,1,0,0,4,4
266,그녀는 남자 친구를 얻었습니다 여자가 더럽게 나이가 나이가 아니에요 모르겠어요 우리가 그것을 통해 그것을 만들었는지 모르겠어 모른다 내가 모른다 그녀가 그녀의 입술을 물은 방식을 좋아한다 너무 사랑스럽습니다 그녀가 그녀가 그랬을 그녀 가이에 맞았기를 원한다 살 젊어 나와서 나만을 보자 그녀는 나를 가르쳐 속임수를 가지고 있다고 말했다 우리가 그것을 만들었는지 모르겠다 모르겠어요 우리가 만들었는지 모르겠다 모르겠어요 모르겠다,1,0,3,2,5
267,당신이 자신을 바다 한가운데에 갇혀 있다면 당신이 어둠 속에서 잃어버린 것을 발견하고 당신은 우리가 우리가 만든 것을 당신을 안내할 빛이 될 것입니다 가난한 사람들의 친구들을 도와달라고 부름을 받았습니다 두 사람과 당신은 거기에 있을 것입니다 그것이 친구들이 해야 할 일이기 때문입니다 셋째 거기에 있을 것이고 내가 필요할 당신을 네처럼 믿을 수 있습니다 울 항상 어깨가 있을 거야 절대 놓지 않을 거야 작별 인사를 하지 마십시오 셋째 거기에 것이고 내가 필요할 당신을 네처럼 믿을 수 있습니다 두 사람과 당신은 것입니다 그것이 친구들이 해야 할 일이기 때문입니다 예는 나를 믿을 수 있어 내가 있기 때문입니다,1,0,0,-1,-1
268,서로를 느껴가면서 조금씩 서로 알아가면서 언젠가는 어쩌면 둘이 그래요 친구들 우리가 친구 사일 넘어서 둘이 영원히 하기로 했다며 하고 알고 싶다나만 이렇게 느낀 거냐고 아님 마음도 마음처럼 영원히 할 꿈을 꾸는지 영원히 하겠다는 말 그래요 너와 있을 때마다 조심스럽게 마음속으로 당신과 인생을 보내고 싶어요 꿈을 꾸며 그래요 소중한 맹세를 할 곁에 내가 나의 곁엔 네가 있기를 손을 잡고 걸어가면서 서로에게 발을 맞춰보면서 할 수 있는지 느껴봐 알아야 합니다 나만 이렇게 느낀 거냐고 아님 너도 마음처럼 함께할 꿈을 꾸는지 내가 한다 하겠다는 말 너와 있을 때마다 조심스럽게 나의 마음속으로 당신과 인생을 보내고 싶어요 꾸며 소중한 맹세를 곁에 내가 나의 곁엔 네가 있기를 이제 시작한 사랑 아직은 모든 이르지만 나도 모르게 꾸는 꿈 나도 모르게 꾸는 꿈 한다,1,0,-4,-2,-6
269,마와 레마 와레메리고라모오케시테 토마라나이요니우고키다시타메로디 도사 부리 노 고고오맛떼마치니토비다소오코코로니후루아메니카사오쿠레타키미또맛삐라토요코무이테혼네와우라하라데모 소노마마데이이오타가이사마다카라메구리아에타키세키가 나미다 놀이로 오카에 타 새로운 브랜드를 사랑하고 싶다이키가토마루쿠라이노아마이쿠치즈케오시요우요히토코토모이라나이사토비키리노이마오유우키오쿠레타키미니테레테루바아이쟈나이카라코토바요 리모혼키나 시라누마니오토시테타치이사나카케라오스키마나쿠다키요세하다데타시카메아우오츄노미에나이요루 카마와 나이 키미가미에루그리고 당신의 빛나는 스타가 되고 싶습니다 마와 레마와 레 메리 고 라운 모오 케시테토마라나이요니우고키다시타메로디 토메도나쿠타노시쿠테야루세나이호도 세츠나쿠테손나아사니우마레루보쿠나리노 사랑 노래 카메이 키노 마에 니코 코니 오이데요 당신을 보호하고 싶습니다코코노하카나사오요와사오키미노료쿠오 별노호시쿠주니낫떼모나는 모든 것을 반대할 수 있습니다스베테오우루오스 코노우타니타쿠시 마모로 모든 연인들에게 우마로타테노 사랑 승마 유콘 나니 모치 카이크 미오 우시나 우난 떼 소우 쿠리아 에스 마이니치나 칼이 소우 요리 이마 노타이 온 이키가토마루쿠라이노아마이쿠치즈케오시요우요히토코토모이라나이사토비키리노이마오유우키오쿠레타키미니테레테루바아이쟈나이카라코토바요 리모혼키나,1,0,-5,-8,-13
270,나른한 햇살에 눈을 떠 보면 이제 어디로 가야 할지 모르겠어 변함없는 하루 그대로인 그냥 이렇게 살아가도 되는 걸까 내가 할 수 있기 가라 곁에 언제나 네가 있어준다면 가라 괜찮을 거야 이제 내게 다가와 처음엔 그냥 왠지 불안하고 알면서 속아주고 이게 연륜이지 오늘은 여기까지 정도면 되고 이게 적당하고 상대만 바뀔 뿐 건조하고 근데 언젠가부터 가슴이 흠 뭣이 신경이 쓰이더니 두근두근하더니 가슴이 막 터질듯한 설렘에 내가 할 수 있기 가라 난생처음 사랑하는 사람처럼 소풍 전날 밤새 잠 못 드는 아이처럼 내가 할 수 있기 항상 자식 걱정하는 엄마처럼 텅 빈 집에 홀로 남은 강아지처럼 눈을 감지 말아요 그대로가 좋아요 이제 그만 연인이 되라 연인이 되라지 금 네가 누구든 어디서 뭘 하든 괜찮아요 사랑이 되어주세요 가슴이 막 터질듯한 설렘에 안 되거든 안 되겠고든 안 되거든 되겠거든 없이는 안되거든 없이는 되거든 없이는 안되겠거든 창밖의 사람들 나완 상관없이 다들 어디론가 바쁘게만 흘러가고 가끔 의미 없이 떠나려 해도 곁에 있을 네가 싫어서 곁에 언제나 있어준다면 괜찮을 거야 내게 다가와 처음 사랑하는 사람처럼 잠 못 드는 아이처럼 엄마처럼 강아지처럼 처음 사랑하는 사람처럼 잠 못 드는 아이처럼 엄마처럼 강아지처럼,1,0,1,-1,0
271,넌 밝은 빛이 있어 우리는 은하수를 걷고 있어 너와 발을 맞춰 걷기 시작한 그날 후로 매일 괜히 어깨가 으쓱해지고 뭘 해도 있게 돼 머리에 들어와 나를 간지럽히고 있니 입꼬리가 올라가 내려오질 않잖아 여자 당신은 나의 밝은 빛입니다 빛나도 너를 빛나게 할래 오늘 밤 당신의 밝은 빛입니다 넌 빛나기만 해줘 소녀는 질문 답변이 없습니다 서로에게 정답이야 우리들의 관계를 의심하지 만난 앞에선 절대 돌아서지 않아새까만 밤하늘의 별을 모아 모아 너를 눈부시게 할래 베이비 당신은 나의 나의 당신은 것입니다레 눈 속에 비친 얼굴 속엔 반짝이는 미소뿐 세상에 빛나는 무엇보다 너야 너야 매력은 끝도 없이 몰아쳐 러블리한 허리케인 쉽게 널 벗어날 수가 없어 빠져들게 돼넌 가슴에 들어와 온도를 높이고 있어 심장이 요동쳐 진정을 못 하잖아 여자 스타 라이트입니다 세상을 다 푸른빛으로 오늘 밤 걸어,1,0,-5,-3,-8
272,어쩌면 너를 만나고 사랑한 건 운명 같은 일이었지 신기하지 해를 만난 새벽처럼 긴 겨울 끝의 봄날처럼 너에게 이끌려 꼭 영화 속의 주인공처럼 의존할 수 너의 눈을 보면 알 같아 너라면 기댈 수 있어 다시 꿈을 꿔 깊은 밤 어쩌다 걷다가 힘이 날 일으켜주던 한 사람 나에게 빛을 비추는 사람도 눈이 붉게 물들 나를 안아준 너에게 있잖아 내가 달라지는 것만 같아 마음을 알 수 있어 세상이 변해가 오늘 밤 당신이 빛을 비치면 가끔 서운하다 해도 괜찮을 거야 내겐 무엇도 필요 없어 당신이 당신의 빛을 비추면 아기 알잖아 운명 같은 사랑 더디게 흘러가도 기억해 기적처럼 이뤄질 거야 하늘에 별들처럼 너를 영원히 비춰줄 거야 세상이 변해가 오늘 밤 당신이 비치면 너의 눈을 보면 알 같아 너라면 기댈 있어 다시 꿈을 꿔 깊은 비추면,1,0,1,-7,-6
273,팝콘이 춤춘대 팝 팝 튀어 오른다 처음 그녀와 영화를 보러 온 맘도 춤춘다란 소심한 남자 넌 무얼 좋아할까 고민 끝에 고른 메뉴 캐러멜 팝콘 영화를 볼까요 로맨스 가득한 영화는 두근두근 팝팝팝 하늘로 하얗게 날아올라 하늘 높이 팝팝팝 맘도 부풀어 올라달콤한 느낌이 좋아따뜻한 느낌이 좋알 팝 소심한 남자 넌 표정일까 눈에는 영화 대신 가득한 너의 옆모습 영화를 본대도 로맨스가 펼쳐질 같아 두근두근 팝팝팝 하늘로 하얗게 날아올라 하늘 높이 맘도 부풀어 올라달콤한 느낌이 좋아따뜻한 팝팝팝우연히 팝콘에 손을 뻗은 순간 따스한 온기가 느껴져 서로 잡았던 두 손을 놓지 않았죠 심장이 터질 같아 눈물을 쏟을 같아 당신과 영원회 하늘로 하얗게 날아올라 하늘 높이 부풀어 올라달콤한 좋아따뜻한 좋아팝팝팝팝팝팝 날아올라고,1,0,-2,-1,-3
274,침대에서 뛰어 내려와 커튼을 열어 아침을 들이켜 내가 원하는 방식으로 할래 강아지와 아침 인사 커피 한 잔 사소한 차이를 느끼는 나만의 작은 행복 들어볼래 독특한 라이프 스타일 바다 건너가지 않아도 내게는 여행 스타일이야 떠나자 떠나자 떠나자 어디든 가벼운 일상을 여행하자 어디라도 달려가는 상상 오늘을 즐겨봐 매일 기분 오미 독특한 라이프 스타일 마음이야 오미 독특한 라이프 스타일 매일 기분 오미 스타일이야 원한다면 언제든지 자유롭게 훌쩍 떠나 마주한 바람에 손을 내밀어봐 스타일자유로운 사고방식 남다르게 오늘을 즐겨봐 내가 만들어 새롭게 세련된 지금이 보다 상큼하게 전혀 곳에 있지 않아도 언제나 새로운 만남이 안녕 안녕 어디든 가벼운 일상을 여행하자 어디라도 달려가는 상상 오늘을 즐겨봐 매일 기분 마음이야 독특화 스타일이야 발을 올라가는 아름다운 하루 새 신발을 신고 발을 디뎌 늘 맘이 가는 대로 해도 괜찮아 뭐래도 그래나는 나를 믿어 허락하다 간나를 반기는 세상으로 왼손엔 핸들 오른손은 음악을 키 워모도 나를 알 수 있도록 내일이 없다는 생명을 살게 될 거야 마음이야,1,0,-4,-4,-8
275,나와 있을 땐 음악을 꺼 나와 대화를 해줘 달링 핸들처럼 요리조리 끌고 가지는 말아요 너와 있을 음악은 분위기 살해 키스하기 전의 간식 아무것도 넌 모르면서 그냥 나를 믿고 안에 맥주 대신 나의 사랑을 남아 서로의 옆자린 서로만이 앉아만 사랑 나와 있을 시선 고정 나만 바라 보라고요 운전은 나를 위한하게 코너링 미소는 숨겨진 카드 사랑한단 말의 디저트라고 백미러의 시선은 널 지키기 위한 눈빛 당신은 나를 믿습니다 항상 곁에 있어줘요 항상 곁에 있을게요 항상 품에 잠들어요 품에 잠들게요 트렁크 안에 맥주 대신 나의 사랑을 남아 서로의 옆자린 서로만이 앉아만 사랑 너를 원해 너를 원해 너를 원해 만나 요다음에 꼭 만나 꽃다발을 준비할게 만나 요다음에 꼭,1,0,-1,-5,-6
276,바람이 좋다 날 어루만져 준다도 슬금슬금 맘속 불을 지펴 발 길을 옮긴다 낯선 길이 많다 어딜 따라갈 까이 끌리는 대로 닿는 대로 가보면 알겠지 새로운 세상을 향한 설렘 꿀 같은 달콤함에 또다시 천국의 문을 연다네 이끌려 미지의 길을 걸어가고 있어 천국의 문을 열면 만나게 될까 너의 답을 진짜 답을 찾고 싶어갈 길이 멀디 여정이 좋다 두근두근 설렘 속 불안함이 묘하게 섞인다 같은 길은 없다 나를 볼가 펼쳐지는 대로 있는 가보면 알겠지 오랜 방황에 만난 떨림 꿈같은 포근함에 또다시 천국의 문을 연다네 이끌려 미지의 길을 걸어가고 있어 열면 만나게 될까 너의 답을 진짜 찾고 싶어나의 진짜 찾고 싶어의 길의 끝에 서면 나란히 옆에 서면 자라난 날 나를 기대해봐도 될까 너에게 속한 세상이란 기분 기분일까 또다시 빛을 본다나를 이끌어 미지의 걸어가고 있어 열면 만나게 너의 싶어 연다네 이끌려미지의 싶어,1,0,-3,0,-3
277,안녕 소녀 안녕하세요 오늘 기분 어때요 이렇게 만나게 돼서 설레요 먼저 편하게 앉으면 돼요 앉아 여자 이완 걸 긴장할 필요 없죠 니와 함께라면 이제 시작해 볼까요 당신의 이름은 무엇입니까 그댈 알고 싶죠 자연스러운 척해도 아닌 척해도 사실 준비 많이 해왔죠 당신은 너무 보인다 그대도 알고 있죠 자연스러운 척해도 아닌 사실 그대가 좋은걸요 인터뷰 인터뷰 인터뷰를 시작합시다 묻고 싶은 너무 많은 걸 사실 그대의 모든 다 궁금해요 먼저 눈 맞춰볼까요 세상에 너무 아름다워 표현할 말이 없죠 할까요 그렇게 웃는 거 예뻐요 당신의 이름은 무엇입니까 그댈 알고 싶죠 자연스러운 아닌 준비 많이 해왔죠 그대도 있죠 그대가 좋은걸요 실례가 좋을 텐데 불편하지 않았다면 좋을 텐데 내가 싫지 않다면 내가 궁금하다면 베이비 질문 하자 그댈 싶죠 준비 많이 해왔죠 당신은 보인다 그대도 있죠 그대가 당신의 이름은 무엇입니까 당신은 보인다 좋은걸요 인터뷰 인터뷰를 시작합시다,1,0,-6,-4,-10
278,느닷없이 갑자기 말해볼까 덜컥 사랑에 빠졌다고 세상 모든 기쁨 나와 할 사람 그게 너라면 좋겠다고 이상해 내가 너만 보면 가슴이 떨려스쳐 지날 샴푸 향기에 귓가에 종소리가 들려 아직도 한 번 제대로 한번 맘 털어놓지 못했지만 요즘 부쩍 자주 마주쳐 왠지 좋은 일이 생길 느낌 느닷없이 갑자기 말해볼까 덜컥 사랑에 빠졌다고 세상 모든 기쁨 나와 할 사람 그게 너라면 좋겠다고 눈치 못 채 벌써 며칠째 뒷자리에 앉은 나를 너에 뒤에 들키지 않게 사랑한다 속삭인 나를 실순척 한번 모른 척 한번 손잡아 보고 싶은 거야 나의 손에 너의 향기가 깊이 새겨질 수 있게 느닷없이 갑자기 말해볼까 덜컥 사랑에 빠졌다고 세상 모든 기쁨 나와 할 사람 그게 너라면 좋겠다고 널 바라보는 내가 서있잖아가까운 곳에서 이렇게 서있잖아들려줄게 있어 보여줄게 있어 한 걸음 한 걸음씩 다가갈게 사랑해 사랑해라고 속삮일께세상에서 가장 아름다운 프러포즈 네게 선물할게 다가와 가까이 입술을 대신해 가슴이 하는 말 들을 수 있게 사랑해 사랑해 말도 안 될 만큼 너무 옆에 너만 있으면 돼 왠지 어설퍼 보이는 나이지만 힘껏 널 안아주고 싶어 달아나버리는 용기지만 네가 사랑이 되어줄래 것이 달라질 하루하루 너와 단둘이 하고 싶어내 손목을 꼭 잡은 하나만 가장 소중히 아낄 거야,1,0,-11,-2,-13
279,안녕이라는 말은 하지 마음이 무너지잖아슬퍼도 괜찮은 척했었어웃으며 널 보고 싶었어 넌 이제 아무렇지 않나 모던 걸 다 잊었나 사랑했던 시간은 그대론데 나만 아직 자리여 추억 눈물이 흐르고 친구들은 이제 그만 너를 보내주라는데 아직 널 보면 가슴이 떨려오는데 내가 널 잊고 다시 웃을 수 있겠니 오랜만이라 어색할까 웃어주고 싶지만 마음이 고장 나서 안 되나 바보처럼 수백 번 연습했는데 추억 눈물이 흐르고 친구들은 이제 그만 너를 보내주라는데 아직 보면 가슴이 떨려오는데 내가 잊고 다시 웃을 수 있겠니 사랑해서 보내준단 말다 거짓말이잖아 말 믿을 수 없어 떠나가지 마 사랑 안녕 이제는 보낼 잡고 있던 손을 놓을게 보고 싶을 거야 행복하기를 영원히 기억할 거야 많이 사랑했어 너를 만난 시절 봄날은 너였어,1,0,1,1,2
280,혼자라고 느낄 땐 멜로디를 기억해봐라 랄랄라 랄랄라 라 랄랄라라 순간이 그리워질 불러봐라 랄랄라 라 랄랄라라 너랑 걸어 다닐 때면 노래가 들려 너는 내게 젤 반가운 멜로디거든 너랑 걸은 거리마다 그림이 보여 넌 그런 느낌인 거야 재미있는 얘길 해줄까 걸을 때에도 따라다녀 네가 네가 나의 곁을 지키는 같아난 지칠 땐 늘 생각해 그건 휴식이거든 그건 향기롭거든 혼자라고 느낄 땐 멜로디를 기억해봐라 라 랄랄라라 순간이 그리워질 불러봐라 바람의 결 너의 결을 따라난 흘러가고 싶어 너랑 걸어 다닐 한겨울에도 마음이 뜨거워 뜨거워 더운 여름이 거리 위에 소음이 너와 나의 멜로디 우린 멀리 있어도 신호가 안 멀어 흥얼거리는 박자에 너와 발걸음을 맞춰 조용한 공원에선 서로의 목소리를 낮춰 넌 소중해 알아줘나는 항상 당신과 당신의 기억이 될 것입니다 넌 가끔 나를 나를 아이처럼 아이처럼 꿈을 꾸게 해손을 왼쪽으로 오른쪽으로 움직여 자주 나를 아이처럼 막 웃게 만들어 어서 여기로 와서 우리가 간다 혼자라고 느낄 멜로디를 기억해봐라 순간이 그리워질 불러봐라 라랄랄랄라아,1,0,-4,-4,-8
281,처음으로 너를 소개받던 날 잘 되리라 생각 못 했는데 거짓말처럼 손을 잡게 돼버렸고 너에게 예뻐 보이려고 뒤꿈치 아픈 모르고 늘 높은 굽만 신고나 했었지 나를 두고 군대 가기 전날 많이 울었었는데 기다릴 거라고 떼를 쓰고 했었는데 년이라는 긴 시간이 지금 와서 생각해보니 힘든 만큼 기억에 남네 어렸지만 막연했지만 뭐 그리도 행복했는지 늘 싸웠지만 아팠지만 뭐가 그리 좋았는지 사랑을 지나 이별을 지나 추억을 모아보니 너는 나의 대였어 너는 어떠니 처음으로 네가 월급 받던 날 내게 선물한 하트 목걸이 너를 만날 때마다 늘 하고 다녔는데 어디선가 잃어버리고 미친 듯이 울고 울었어 그게 너인 같아서 어렸지만 막연했지만 뭐 그리도 행복했는지 싸웠지만 아팠지만 뭐가 그리 좋았는지 사랑을 지나 이별을 추억을 모아보니 너는 나의 대였어나의 가장 예쁜 날에 너를 만나서 세상에서 가장 행복한 여자로 살게 해줘서 눈물 고마 워너는 없지만 우린 없지만 가슴이 기억하니까 변했지만 달라졌지만 넌 아물지 않으니까 사랑만으로 사랑이 되던 시절을 돌아보니 나의 대였어 행복해야 해 행복해야 해 행복해야 해,1,0,0,6,6
282,좋아해 너무 달지 않은 라떼비 갠 거리로 가볍게 나서는 산책 번이나 본 로맨틱 코미디 보기 좋아해 차가운 녹차 맛 아이스크림 문득 떠나는 하루짜리 짧은 여행 햇살 좋은 날 무심코 들어선 미술관 너의 곁 지낼까 정신없이 살다가도 거짓말처럼 막 보고 싶고 너의 곁에선 하루가 짧았었는데 기억하니 언제나 둘이던 그리운 시간들 돌아가고 싶은 한때 떠올리다 보면 어느새 웃곤 해좋은 일들만 너의 옆에 가득하기를 바랄게 널 좋아해 널 널 미안해 너를 지켜주지 못해 끝까지 사랑해주지도 못해 미안해 맘 나도 모르겠어 이제 끝난 건데 대체 아직도 가슴이 안에 네가 가득한데 다시 돌아가는 것은 안돼널 피하네 그게 진심은 아닌데 피하네 미안해 아직 너를 좋아해어떻게 지낼까 정신없이 살다가도 거짓말처럼 막 보고 싶고 곁에선 하루가 짧았었는데 기억하니 언제나 둘이던 그리운 시간들 돌아가고 싶은 한때 떠올리다 보면 어느새 웃곤 해좋은 일들만 옆에 가득하기를 바랄게 한참이 지나도 변하지 않는 것이 있나 함께한 시간들이 생각 나니가 알던 있나 목소리 날 흔들어 놓나 자꾸만 코 끝이 찡해 오네 너를 기다리나 봐난 기다리나 지낼까 정신없이 살다가도 거짓말처럼 막 보고 싶고 곁에선 하루가 짧았었는데 기억하니 언제나 둘이던 그리운 시간들 돌아가고 싶은 한때 떠올리다 보면 어느새 웃곤 해좋은 일들만 옆에 가득하기를 바랄게,1,0,-5,-2,-7
283,이슬비가 내리는 오늘은 사랑하는 그대의 생일날 온종일 그대를 생각하면서 무엇을 할까 고민했죠 가까운 책방에 들러서 예쁜 시집에 맘 담았죠 그다음엔 근처 꽃집으로 가서 빨간 장미 한송일 샀죠 내려오는 비를 맞으며 그대에게 가는 길 너무 상쾌해 품 속에는 장미 한 송이 책 한 권과 그댈 위한 깊은 사랑 아름다운 그대를 만난 건 하느님께 감사드릴 우연 작은 맘 알아주는 그대가 있기에 세상이 행복해 가까운 책방에 들러서 예쁜 시집에 맘 담았죠 그다음엔 근처 꽃집으로 가서 빨간 장미 한 송일 샀죠 내려오는 비를 맞으며 그대에게 가는 길 너무 상쾌해 품 속에는 송이 책 권과 그댈 위한 깊은 사랑 아름다운 그대를 만난 건 하느님께 감사드릴 우연 작은 알아주는 그대가 있기에 세상이 행복해 너무너무나 행복해,1,0,-7,-5,-12
284,상쾌한 기분이죠 하늘이 좋아요 오늘은 바람 내음도 향기롭네요 좋은 일이라도 생길 같은 오랜만에 기분 좋은 날이죠 매일 같은 자리에 사람이 있네요 오늘따라 나를 바라보네요 주문이라도 외운 것처럼 사람이 나를 향해 오네 요거 봐요 내가 그랬잖아요 오늘은 기분 좋은 일들만 생길 거라고 어쩐지 햇살조차 눈부신 사랑하기 날이죠 당신은 사랑입니다 당신의 포옹에 당신의 키스를 생각하는 것은 나에게 모든 것을 의미합니다 유난히 바람조차 달콤한 사랑하기 날이죠 사람이 웃네요 나를 보고 웃네요 이렇게 환한 미소도 오랜만이죠 그동안 상상했었던 많은 일들이 마법처럼 내게 일어나네 요거 봐요 내가 그랬잖아요 오늘은 기분 일들만 생길 거라고 어쩐지 햇살조차 눈부신 사랑하기 당신은 사랑입니다 당신의 포옹에 키스를 생각하는 것은 나에게 모든 것을 의미합니다 유난히 바람조차 달콤한 걸렸나 봐요 행복 바이런스에 모든 것이 예쁘게만 보이 직도 망설이고 있나요 지금 그대 손을 내밀어 요거 내가 그랬잖아요 일들만 거라고 뭐든지 상상하기만 하면 다 이뤄질 수 있는 그런 당신은 사랑입니다 포옹에 키스를 생각하는 것은 나에게 것을 의미합니다 믿어요 날 눈을 뜨면 다 예쁘게만 보일 거예요 그날이,1,0,-11,1,-10
285,그대와 둘이서 어딘가 남쪽 끝섬에서 쨍쨍한 태양에 불타고 시원한 바람에 춤추고 야자나무 그늘 밑에서 뽀뽀하고 싶소 소나기가 지나갔으면 무지개색 칵테일 건배 달콤한 향에 취하고 라디오 소리에 숨 쉬고 그대 허벅지에 엎드려 낮잠 자고 싶소 얼음 장수 아저씨 안녕 핑크색 구름 빙글빙글 빛나는 향기의 그대와 예쁜 포즈로 사진 한 컷 시계가 멈춘 낙원에서 눈을 감고 싶소 네온사인들 눈이 부셔 별빛은 보이지도 않네 도대체 어디서 꿈꾸나요 빌딩 숲속 허수아비 그대와 둘이서 어딘가 남쪽 끝섬에서 쨍쨍한 태양에 불타고 시원한 바람에 춤추고 야자나무 그늘 밑에서 뽀뽀하고,1,0,-3,5,2
286,사람을 만나는 거니 물을 좋은 사람을 만나게 된 거지 대답 해 자랑하고픈 다 말을 하고픈 기분에 친구들을 모아 시간을 떠들기만 해내 사랑은 너오 베이비 베이비 루 루보 베이비 루 루브 눈을 감아도 느껴지는 너오 루 루보 루브 하루에도 열두 번 보고 싶다고 하며 전화기를 바쁘게 하는 너나를 사랑해 줘서 고마워 내가 너보다 내가 너보다 사랑해 사랑해 바보 같아도 유치해 보여도 행복해 행복해 주고픈 다 해주고 싶은 마음에 적어 놓은 것들언제 다 해주나 걱정 대내 사랑은 너오 루보 루브 눈을 감아도 느껴지는 하루에도 열두 번 보고 싶다고 하며 전화기를 바쁘게 하는 너나를 줘서 고마워내 왼쪽에 오른쪽에 영원히 두고 싶은 건 너야 당신이 필요합니다 당신은 당신을 원한다 당신을 원한다 언제까지나 사랑은 눈을 감아도 느껴지는 사랑할 땐 꼭 필요한 레시피 유통 기한이 안 적힌 진실 사랑이란 특별한 요리,1,0,-1,3,2
287,엄마야 어떡하면 그녈 다시 돌아오게 할 수 있는지 내게 가르쳐줘 제발 그녀 없는 세상이 너무 두려워 드디어 내게도 운명 같은 사랑이 찾아온 거라고 매일을 들떴었는지 모를 거야 태어나 맨 처음 기도했어 이번엔 이별이지 않게 영원한 사랑을 지킬 수 있게 한 번만 도와주길 그댄 떠나려 해 사랑을 찾아내가 잘못했는지 알지도 못하는데 엄마야 이번만은 뜻대로 너만은 보낼 수가 없어 제발 믿게 해줘 내게 세상에 사랑이 있다는 것을 엄마야 이번만은 잊지 못해 다시는 사랑 못할 거야 나의 모든 것을 걸어 처음으로 사랑을 했어태어나 맨 처음 기도했어 이번엔 이별이지 않게 영원한 지킬 수 있게 한 번만 도와주길 그댄 떠나려 해 찾아내가 잘못했는지 알지도 못하는데 이번만은 뜻대로 너만은 보낼 수가 없어 제발 믿게 해줘 내게 세상에 사랑이 있다는 것을 잊지 못해 다시는 사랑 못할 거야 나의 모든 걸어 처음으로 했어 발 떠나가지 마 그대 없는 내가 아냐돌아와줘 곁으로 뜻대로 너만은 보낼 수가 없어 믿게 해줘 세상에 있다는 잊지 못해 다시는 사랑 못할 나의 모든 걸어 처음으로 했어,1,0,-1,1,0
288,새로운 방법 항상 나은 늘 사라졌습니다 우린 너무 철 없이 거품처럼 들떴지 서로를 겉핥기 식으로 공부하면서 요점을 다 놓쳤지 우린 소속감 따윈 못 느끼면서 빠른 속도감을 즐기면서 감정을 다 허비해 약간의 허탈함도 느끼면서 그게 너무 좋았나 그런 가벼움이 좋았나 열정이 너무 사나워 냉정한 감각이 졸았나 감정이 낮잠처럼 나른해질 때쯤 깨달았어 사랑이 떠나갔다는 걸 사랑은 그렇게 순간의 전기처럼 찾아와 머물고 사라져 먼지처럼 우린 쉽게다 태워버렸나 봐보고 싶어요 연기처럼 흩어지네 사랑은 우릴 스치고 가버렸지 열정은 빨리도 타버렸지 이별하는 순간조차 참을 수없이 가벼웠지다 지난 혼자서 잠드는 무서웠었나 아님 텅 빈 방에서 눈 뜨는 두려웠었나 부끄러웠었나 벌거벗은 영혼을 보여주는 우습기도 해서로의 몸은 스스럼없이 보여주는데 홀로 지새우는 밤 좁은 방구석이 끝없는 사막같이 느껴져 하나의 사랑이 휴지통으로 장의 사진들과 구겨져 사랑은 그렇게 순간의 전기처럼 찾아와 머물고 사라져 먼지처럼 쉽게다 태워버렸나 연기처럼 흩어지네 뜬금없이 생각나겠지 술잔을 입술에 기댈 때면 보일 듯하다 흩어지는 취한 듯이 아련한 기억들 늦은 밤 술에 잔뜩 취해 이불 속을 뒤척거려치워버린 번호 혹시나 해서 전화기를 뒤적거려 사랑조차 새로운 방법인 사라졌습니다 내겐 미련만이 남았어 그렇게 순간의 전기처럼 찾아와 머물고 사라져 먼지처럼 쉽게다 태워버렸나 봐보고 싶어요 연기처럼 흩어지네,1,0,-1,2,1
289,내가 거기에 있을 거야 내가 거기 있을 거 내가 거기 있을 거야 그럴 것이다 스피커를 켜 괜찮다고 말하지만 넌 항상 아니라 말하지만 뭐 얼굴에 다 쓰여있어 나에게 거짓말하지 마세요 바보같이 숨기지 마 약한 모습도 약한 약한 모습도 가끔은 괜찮아 대신 포기는 당신은 비트에 나를 느끼는 믿음을 믿지 않는다지 나간 일들은 다 잊고 건너뛰다 어깨를 쭉 펴고 하늘을 찾아보세요 한숨은 쉬지 마 나와 날아가자 믿어봐 날 믿어봐 지금 거기 거야 있을게 옆에 있을게 누구보다 힘이 돼줄게 언제까지나 할게 지금처럼 영원히 거 한 번 센척할 필요 없는데 여린 맘 다 알고 있는데 알아기다리며 애써 봤어 마음에 말해주세요 힘이 들면 내게 말해봐 걱정하지 마세요 걱정하지 마세요 걱정걱정은 멀리멀리 뒤로한 채로 거릴 둬 당신은 비트에서 나를 느끼는 믿음을 밑습니다 힘들었던 기억 건너뛰다 어깨를 쭉 펴고 한숨은 쉬지 마 나와 날아가자 믿어봐 날 지금 있을게 옆에 누구보다 힘이 돼줄게 언제까지나 할게 지금처럼 영원히 것이다 옆에 누구보다 돼줄게 언제까지나 할게 지금처럼 영원히 거 거기에 거예요,1,0,6,2,8
290,세계의 문제가 무엇인가 은 마마 시가 없는 것처럼 살아남지 않는 것처럼 전 세계가 당신에게 외상을 불러일으킬 것들에 중독된 전 세계에 중독된 것들에 중독되어 테러리즘을 막으려 고 노력하지만 우리는 테러리스트가 미국을 생생하게 얻었습니다 큰 당신이 당신의 자신의 대한 사랑 만 있다면 당신은 공간을 차별하기 위해 공간을 떠나 차별할 때만 해저를 생성할 뿐입니다 운영자 당신은 당신의 마음을 똑바로 통제하고 당신의 영혼을 사랑하기 위해 사랑에 끌려가기 위해 사랑해야 합니다 뺨 아버지 아버지 아버지가 우리에게 위의 지도를 보내도록 도와주세요 사랑 사랑 사랑은 항상 동일하지 않아도 됩니다 항상 변하지 않은 새로운 날은 이상합니다 은 청소년이 젊음으로 죽을 고통을 겪으므로 자신에게 물어보는 것은 정말로 사라 졌기 가이 세상에서 우리가 잘못된 결정을 내린 것에 대해 기뻐서 자신을 존중하지 않는 비전에 대한 비전에만 거부하는,1,0,-1,-2,-3
291,말이야 크림 가득 담겨있는 커피 한 잔과 너만 곁에 둘래나른한 날엔 더욱 생각이 드는 그런 나의 위로이니까 나의 위로이니까 햇살 가득 몸에 받아 손을 뻗으면 하늘 위로 느낌도 테지 네가 곁에서 입 맞추면 좋을 거야 머릿속 하얗게 지워져도 좋을 거야 그냥 밤을 새울 수도 있을 거야 볼 거라 진 뺨 아름다워 나와 행복해질 라라라라라라라라라라라라라라라라라 라스 파라 밥 스파 라밥 스파 라밥 스파 라밥 파라 스파쇼 노려 캐러멜은 너보다도 달콤하지만 너만 필요해나른한 날엔 더욱 생각이 드는 그런 나의 위로이니까 햇살 가득 몸에 받아 손을 뻗으면 하늘 위로 느낌도 테지 네가 곁에서 입 맞추면 좋을 머릿속 하얗게 지워져도 그냥 밤을 새울 수도 있을 볼 거라 진 뺨 아름다워 나와 행복해질 우린 맺어질 수밖에 없는 처음부터 우린 하나니까 나와 행복해질 커피 한 잔,1,0,-2,-2,-4
292,언제였던 건지 기억나진 않아 머리가 너로 어지럽던 시작 한두 번씩 떠오르던 생각 늘어가서 당황스러운 마음 별일이 아닐 수 있다고 사소한 마음이라고 내가 내게 내게 말을 하는 어색한 걸 사랑인가요 그대 나와 같다면 시작인가요 맘이 그댈 사랑한대요 온 세상이 듣도록 소리치네요 이제야 들리죠 우서 롤 만나기 위해 이제야 사랑 찾았다고 지금 마음을 설명하려 해도 네가 내가 되어 맘을 느끼는 방법뿐인데 이미 안에 있는 걸 안에 네가 있듯이 우린 서로에게 서로에게 이미 길들여진지 몰라 사랑인가요 그대 나와 같다면 시작인가요 맘이 그댈 사랑한대요 온 세상이 듣도록 소리치네요 이제야 들리죠 우서 롤 만나기 위해 사랑 찾았다고 생각해보면 생각해보면 많은 순간 속에 많은 설렘 있었는지 늦은 만큼 잘해 줄게요 할게요 추억이 될 기억만 선물할게요 다신 곁에서 떠나지 마요 짧은 순간조차도 불안한 걸요 내겐 머물러줘요 우글댈 이렇게 많이 그토록 많이 사랑하고 있어요 그대 하나만이 미,1,0,-1,-7,-8
293,당신이 내가를 보았던 방식을 기억합니다 우리가 촬영의 끈을 잡았을 기억합니다 우리가 공유 한 것들을 기억하고 우리가 당신을 공유하고 약속을 기억합니다 월과 아버지가 당신이 도둑질을 했다고 생각했을 공유 한 것들을 기억하고 당신을 공유한 약속과 당신을 만들었고 웃음을 우리는 웃음을 월과 내가 기억하는 메이즈에서 미소를 짓는 방식,1,0,0,3,3
294,눈꽃이 내린 버스 정류장에 날 데려다주다 꼭 손을 잡는 때문에나 놀랐어 아주 오래전부터 숨겼던 맘이 들킨 걸 까부는 바람에 실린 우리에게 번진 이것은 사랑입니다 마음에 내려와 사뿐히 내려와네 어깨 위에도 벌써 내린 이름 봄인가 잡은 손 틈 사이 얇아진 외투 사이 어느새 스며들어 우릴 변화시킨 봄이 왔나 첨언 그랬어 편한 친구 혹 동생 같았어 치마를 입고 꾸민 모습에도 놀라지 않았어 뭐가 우릴 지금 이렇게 바꿔 놓은 걸까 아마도 미친 듯이 너를 아기라고 부를 수 있어 마음에 내려와 사뿐히 내려와네 어깨 위에도 벌써 내린 이름 봄인가 잡은 손 틈 사이 얇아진 외투 어느새 스며들어 우릴 변화시켜 오우리 서로에 기대어 잠든 벤치 투명한 하늘에 물든 달콤한 벚꽃 늘 이러면 좋겠다 바꾼 이름 봄봄봄 봄 오늘 사랑해 너를 사랑해 사랑해 널 응넌 봄이 돼줘 항상 꽃이 될게 서로를 녹여주고 열리게 해주면 좋겠다 안 보이던 마음과 마음 마주한 시선 겨우내 숨어있던 꽃이 피었나 봄이 왔나,1,0,-2,-1,-3
295,사랑에 빠진 순간 너만 보이고심장은 두근거려사랑해 사랑해 사랑해 필요 야가슴에 폭 안겨주기길걷다 뽀뽀해주기일부러 투정부리기귀여운 애교도 살짝눈으로 맘을 알기더워도 꼭 붙어 있기걸을땐 팔짱 껴주기집앞에 달콤한 키스당신을 사랑하기 당신이 필요하기 당신을 사랑하기 당신을 사랑하기 당신이 필요합니다 하루만 못봐도 뽀뽀하고 싶어달콤한 너에게 뽀뽀하고 싶어숨막혀 터질듯 크게 안아줄께영원히 그대를 사랑해사랑해 사랑해요섹시한 여자를 봐도앞만보며 걸어가기늦은밤 네게 전화해사랑해 수백번 말해당신을 당신이 필요하기 당신을 필요합니다 하루만 못 봐도 뽀뽀하고 싶어달콤한 너에게 싶어숨막혀 터질듯 크게 안아줄께영원히 그대를 사랑해랄라 랄라 랄라 랄라너를 만나면 하루가 즐겁고너를 만나면 하루가 설레고너를 만나면 하루가 짧아져너를 아쉬워너를 포근해너를 행복해너를 공주가 되었고너를 행복한 여자야사랑해 사랑해,1,0,-4,6,2
296,오늘같이 싱그러운 날 길거리 차도 별로 다니지 않아 문득 지나가다 거울을 보면 오늘 모습은 예뻐 보이네 이따가 널 보면 말을 할까 날씨가 좋다고 뻔한 말이라도 건네볼까 어색한 장난이라도 용감하게 오늘은 널 웃음 짓게 만들 거야 사랑의 오늘같이 햇볕 좋은 날엔 매일 걷던 거리도 지겹지 않아 문득 지나가다 거울을 보면 얼굴도 정도면 잘생겼네 이따가 널 말을 할까 날씨가 좋다고 공원이라도 걷자 할까 짓궂은 장난이라도 용감하게 오늘은 웃음 짓게 만들 거야 나에 선에서 사랑의,1,0,-8,4,-4
297,그것이 그것이 될 방법입니다코코노로 카타치카와라나이일이 될지에 관계없이코노마마 멀리도시테모이이 나니모이라나이당신이 원한다고 말 해주세요 아시타니낫타라 와스레루요돗카이타노니히키즈루키모치 당신을 위한나제카토마라나이 소토와도라이다케도나카미부드러운 달콤한도코카라 도시요다시 한번 그것은 우주입니다아라모도오이시이머리부터 발끝까지마지오랫동우소쟈나이 개의 컬러 웰 당신은 꽃입니다비진당신은 나와 흔들리고 싶어노 큐방메노쿠모니놋테당신이 나를 생각하는지 저를 데려가주세요오시에테호시이돈나 패션돈나 메이쿠가이이당신이되고 싶어 당신의 사람이됩니다 뿐다레모이라나이당신이 나를 원한다고 말해줘바텐금기 사항이 없습니다바브 아마에루표본하싯테탈출하다시요그냥 둘후타리데 의카기히라쿠최하부산쥬기분 전환시마스국제적인지마쿠츠키날카로운 하모노 이라네고코이리구치 나소레가 이동케쇼 눈물데오치루와도칸도 무소스루키미스코시이죠요조라니마우실크 시폰을 드레스산토라츠키노 확실히 아기를위한 러브 스토리 스타카붓테 시테 언젠가는 언젠가는 것이 될 것입니다 오늘 밤 처음으로 사랑을 나누십시오다레모키즈카나이소시테혼토와혼토야바쿠나이 코코노로 카타치카와라나이 코노마마 멀리시테모이이나니모이라나이그냥 당신이 나에게 홉을 원한다고 말 해주세요 가지고 있습니다 당신은 멈추지 않는다도코사가시테모당신이 알고있는 곳은 어디에도 없습니다히토리노토키노감정 아니오도시테콘나니츠라이노 나를 사랑하지 않는다 오시에테호시이돈나 돈나 메이쿠가이이당신이되고 싶어 당신의 유일한 유일한다레모이라나이당신이 말해줘코코노로 카타치카와라나이일이 될지에 관계없이코노마마 멀리도시테모이이 나니모이라나이당신이 말 해주세요,1,0,0,-3,-3
298,뭔가 기분 좋은 일이 생길 것만 같은 기분이야 요즘 만에 사람들이 나를 알아봐 연예인이 된 것만 같아 뜻밖의 인연으로 연애도 되려나 뭔가 대박이 날 같은데 느낌상 무더운 여름도 다 지나갔고 쓸쓸해도 개코 형 말처럼 느낌 너무 오빠 차 뽑았다 라고 말할 수 있는 날도 올 같아 술 담배 욕 커피 다 끊고 도끼 형처럼 살아 볼까 자신감도 부쩍 늘고 잘 될 것만 같은데 주변 사람들은 생각들 그게 기분 탓이래 기분 탓이래 왠지 기분이 탓일 수도 있지만 바래 왔던 많은 꿈들 다 잘 될 같아 콧노래를 불러 발걸음이 가벼워지는 기분이야 일이든 잘 될 거야 이게 좋은 탓 오늘따라 거울에 비친 얼굴엔 김이 묻었네 잘생김 요즘에는 가장 꽂히는 노랫말 짜증을 내어서 사람들이 나를 보는 시선조차도 많이 변한 것을 느껴 나도 세상을 바라보는 시선도 변했겠지 못해도 아마 도내가 미쳐가는지 잠자는 시간조차 아까운지 궁금해서 물어보면 사람들은 탓이래 왠지 기분이 탓일 수도 있지만 괜찮아요 바라 왔던 많은 꿈들 콧노래를 불러 발걸음이 가벼워지는 기분이야 일이든 거야 이게 좋은 탓한 사주를 믿지는 않지만 올해는 너무 좋대 삼재도 끝났고 막히는 없이 술술 풀린 대 그런 걸 떠나서 나도 이제 훨훨 높이 날아오를 열심히 산 만큼 노래 가사처럼 길이 보이네 힘을 내왠지 기분이 탓일 수도 있지만 괜찮아요 바라 왔던 많은 꿈들 콧노래를 불러 발걸음이 가벼워지는 일이든 거야 이게 탓,1,0,-3,6,3
299,오늘도 슬쩍슬쩍 바라만 보고 있네 벌써 번째인지 몰라 사랑에 빠진 같아 사랑에 빠져 버렸어 이번엔 같아 같아 같아진지 놀리 면안 돼요 두근거리는 가슴 진지해요 사랑에 빠진 딸기야 날 웃음 질 수 있게 해줘요 조금씩 살금살금 주문을 걸고 있네 날 돌아볼지도 몰라 상상만으로는 안돼 상상은 안 돼 그건 안 돼 오늘은 말해볼 거야 말해볼 거야 진짜 고백할 거야 진지해요 놀라지 말아요 빨개지는 볼 진지해요 빠진 딸기야 날 웃음 질 수 있게 해줘요 딸기야 웃음 질 수 있게 해 줘요,1,0,0,1,1
300,방 가득 채우며 환히 웃던 맷 데이먼 그의 신작 영화도 뉴스거리 아니지 첨엔 잘 몰랐었던 너의 환한 미소가 이미 나의 마음속을 온통 사로잡은 걸은 나의 슈퍼 슈퍼스타입니가 다 나를 비춰 주는 걸 당신은 슈팅 슈팅 슈팅 스타입니다 내가 쏘아 올린 별 중 가장 빛나는 별 당신은 빛나고 있습니다 마음속의 별 듣기조차 싫었던 시끄러운 너바나 나도 모르게 흥얼거려져 첨엔 많이 달랐던 너와 나의 취향들 늘 해도 마냥 즐겁기만 해는 슈퍼 슈퍼스타입니가 다 나를 비춰 주는 걸 내가 쏘아 올린 중 가장 빛나는 당신은 스타드 레밍을 빛나고 있습니다 꿈꿔오던 나를 비춰주는 걸 스타입니다 내가 쏘아 올린 중 가장 빛나는 놀라운 마음속의,1,0,-3,1,-2
301,나와 와서 사랑하는 나와 오세요 그대 곁에 없을 때면 숨 쉬는 호흡 소리까지다 생각 나도 눈을 감고 열을 세면 어둠 속에서 불꽃처럼 떠올라 아기가 손을 잡아 나와 깍지 껴요 아기가 손을 잡아 도망가지 마요 너와 와서 사랑하는 오세요 작은 손잡고 걸을 때면 놀이동산에 기뻐서 들뜬 애 같아 그대와 짧은 밤을 새우면 뜨는 태양을 피해서 달아나고 파내 아기가 손을 잡아 깍지 껴요 제발 도망가지 마요 너와 와서 사랑하는 세 요시 간의 흐름 속에서 열정은 녹슬겠죠 사랑은 빛나고 아름다울 거예요 그대 내게 던지는 미소 이성과 본능의 끝없는 시소네가 딴 남자에 관심 가질 때면 화가 입에선 삐 소리의 음 죄송합니다 도망가지 마나에게서 멀리 걸어가지 마세요 내가 살게 두 잔의 진 토닉 짠해 우리의 플라토닉 오늘따라 예뻐난 너만 보면 웃음이 헤퍼져 매끈한 몸매 눈에 밥 주네 널 가졌으니 이미 갑부네 넌 느낌 눈이 고와 넌 나의 아이돌스타 심장에 불이 붙어 이성은 코마 상태 지금 초만 키스해보아 오세요,1,0,-3,5,2
302,괜히 눈뜨면 오늘도그대 나에게 남겨둔그 흔적들 뚜룻뚜잠에 취한내 귓가에 들리는그대의 노랫소리졸린 두눈을 비비면어느새 내게 다가온그대향기 뚜룻뚜같은 아침같은 하늘 아래서여전한 얼굴로 여기요너와 들려 온 세상의모든 소리가 내게 남아이렇게 벅차게 빛나는사랑 이었음을 알죠아직 게으른 열두시왠지 때늦게 비치는오후 햇살 뚜룻뚜달콤하게 귓가에흐르던 그날의 속삭임 여기요너와 들려 온 세상의모든 소리가 내게 남아이렇게 벅차게 빛나는사랑 이었음을 이젠기억하지 않을먼 발자욱 이라도타는 노을 메아리 처럼내 노래가 널 부르네 오너와 들려 온 세상의모든 소리가 남아이렇게 벅차게 빛나는사랑 이었음을 알죠랄라 라라 랄라 라 라랄라라 라 라랄라 랄라 랄라랄랄라 랄랄라 랄랄라랄라랄 랄랄랄 라랄라 라라 랄라 라 라랄라라 라랄라 랄라랄랄라 랄랄라 랄랄라랄라랄 랄랄라,1,0,-2,3,1
303,오늘 유난히 헝클어진 머리 너무나 맘에 안 들어 소개로 만난 새침한 애와 약속했는데 대가 직접 써준 전화번호 야릇한 느낌처럼 들뜨는 마음 진정시킬수록 이상한 웃음만 나네 밉기만 하던 동네 아이들이 이리 귀엽게 보이고 거리는 온통 그대 향기니 그대를 사랑하게 된 걸까 떨렸던 마음은 반기는 그대 웃음에 날아가 버리고 나를 나를 부르는 그대 입술에 입 맞추려고 했지만 용기가 없어 순간을 기다려 왔는지 네가 나를 좋아하는 진짜 맞는지 떨리는 맘 그댄 맘 혹시나 알고 있을까 모르는 나을까 너와 함께라면 모든 다 아름다워 평소엔 지저분하다 생각했던 골목길마저 젠틀한 미소 향긋한 향기도 다 꿈만 같아 영원하리라 믿어밉기만 하던 동네 아이들이 이리 귀엽게 보이고 거리는 온통 향기니 그대를 사랑하게 떨렸던 마음은 반기는 웃음에 날아가 버리고 부르는 입술에 입 맞추려고 했지만 용기가 없어 떨렸던 마음은 반기는 웃음에 날아가 버리고 부르는 입술에 입 맞추려고 했지만 기회에,1,0,-7,1,-6
304,달콤 초콜릿을 입에 물고 키스 한 모금 은빛 에나멜 칼라 손가락엔 별빛 한 스푼 예쁜 꼬리를 달고 너에게 갈게 조금만 기다려 착한 너는 눈이 반짝 빨간 포도주를 좋은 걸로 준비해 줄래 한번 사르라고 하고 마셔 보면 꿈을 꿀만큼 가슴을 열고 심장을 담고 쿠키를 구워줘 착한 너는 입이 활짝 시간은 흐르고 음악은 멈추고 밤도 그리 길지는 않아 새벽이 밝으면 주문도 풀릴 걸 후회할 시간도 모자라 말해나는 당신을 사랑합니다 장미 꽃다발을 백 송이만 준비해 줄래 친구들 슬쩍 보여주면 질투할 만큼너와 걸어갈 때면 어느새 얌전한 고양이 앙큼한 팔짱을 살짝 가끔 비밀스러운 속삭임도 나쁘진 안 지나의 한숨이네 닿을 때면 빨개질 테니네 가슴을 열고 심장을 보이고 마음을 내게 줘내게로 넌 한 발짝 시간은 흐르고 음악은 멈추고 밤도 그리 길지는 않아 새벽이 밝으면 주문도 풀릴 걸 후회할 시간도 모자라 말해나는 당신을 사랑합니다 당신을 사랑합니다 당신이에 있다고 말하면 이에게 갈 수 없다는 말을 마시고 당신이 당신이에 있다고 말하는 곳을 주었다 이에게 주어진 곳 어디든 가서 이야기를 나누고 당신이 있을 수 없다는 것을 이야기하십시오,1,0,-2,0,-2
305,하늘을 빨간 망토의 까만 고양이 꼬리가 달린 옆집 언니 밤마다 가요 꼬리를 무는 엉뚱한 생각 나도 멈췄으면 해 도대체 넌 커서 뭐가 될래 제일 많이 듣는 얘기하지만 알지도 못하는 사람들에게 일일이 설명하고 싶지 않아 진짜 나의 모습 애라는 걸 잔인한 말의 사람들 속에서 상처라면 이미 많이 받은 걸 이대로 난 나를 숨겨 놓을 거야 콧노래를 부르며 걸어가면 세상은 마법의 빛에 쌓이고 어제의 싫은 잊게 되는 걸 이해할 수 없는 세상에서도 이대로라면 행복한 가만히 상상 속에 앉아서 쉬는 날엔 싫은 나를 잊으려고 해 쉬는 날엔 싫은 너를 가리려고 해 달나라로 가는 황금마차 과자로 진집 콜라의 샘 알지도 못하는 사람들에게 일일이 설명하고 싶지 않아 진짜 나의 모습 애라는 잔인한 말의 사람들 속에서 상처라면 이미 많이 받은 이대로 난 나를 숨겨 놓을 거야 콧노래를 부르며 걸어가면 세상은 마법의 빛에 쌓이고 어제의 잊게 되는 걸이해할 수 없는 세상에서도 이대로라면 행복한 가만히 상상 속에 앉아서,1,0,2,-1,1
306,좋아한다고 말할까 가슴이 뛰는 이유를 온종일 들뜨고 설레는 야릇한 기분 사랑이 시작된 걸까 웃음이 나와 어떡해 뭘 해도 멋져 넌 너무 이뻐 마냥 사랑하게 됐나 사랑하게 됐나 너만 보여 너만 들려 널 기다려 온통 너뿐이야 둘이 있어 행복해 사랑이 너라는 순간이 전부인 것처럼 너에게 빠질래 모든 새롭기만 해 벌써 모든 너로 가득해 어쩌면 네가 처음이야 너뿐인 걸 사랑하게 됐나 너만 보여 들려 널 기다려 온통 너뿐이야 둘이 있어 행복해 사랑이 너라는 순간이 전부인 것처럼 너에게 빠질래,1,0,-4,-6,-10
307,하루에도 몇번씩 니가 보고싶어 사랑한다고 하나뿐이라고 예쁘게 안아준다면 야야야 모든 것이 달라 질거야 야야야 넌 항상 나에게 말했었지 친구일 뿐이라고 언제부턴가 넌 조금씩 내게 달라지는걸 느껴 너의 손길에 들어 있는 느낌들을 네가 알고 싶은 나의 모든것들을 다 네게 보여줄께 당신이 사랑이되고 싶다면 당신의 별이되고 싶어하루에도 몇번씩 니가 보고 싶어 몰래 내게 다가올래 어색하지 않게 말야 야야야 당신이 사랑이되고 싶다면 당신의 별이되고 싶어모른척 새침 떼는 나를 이해해줘 사랑한다고 하나뿐이라고 예쁘게 안아준다면 모든 것이 달라 질거야 넌 알고 있는건지 나의 두근거림을 세상 하나뿐인 너만을 사랑할께 세상 끝날까지 당신이 사랑이되고 싶다면 당신의 별이되고 싶어하루에도 몇번씩 니가 보고 싶어 몰래 내게 다가올래 어색하지 않게 말야 싶어모른척 새침 떼는 나를 이해해줘 사랑한다고 하나뿐이라고 예쁘게 안아준다면 너와함께 부드럽게 웃는 법을 배웠고 너와함께 다정히 속삭이는 법도 알아 너와함께 포근히 감싸 안는 법도 알고 너를 모든것을 바꿔 옛날의 나를 잊겠어 좋은여자 되겠어 너와 함께하는 어디든 내겐 가장 편한 곳이 됐어 싶어모른척 새침 떼는 이해해줘 모든 것이 달라 질거야,1,0,-9,4,-5
308,외로웠던 너는 내게 왔지만 기다렸었던 걸 너는 몰랐었지 이제까지 바랬었던 순간만이 나를 기뻐하게 했었던 거예요 기억하고 있진 않나요 꿈같은 순간 바라는 건 없었지만 혼자만 좋았다면 너를 보내고 망설이지 않았겠지 힘들어도 내게 다가와 없이는 내가 없잖아 매일 보고 있어도 널 볼 수 없지만 이제는 알아 느끼는 있어나는 너를 닮아가 장난스러운 너는 상관없지만 언제부터 두근 걸렸었어 사랑이란 가면은 벅차지만 나를 기쁘게 만들어 주는 거예요 기억하고 있진 않나요 꿈같은 순간 바라는 없었지만 혼자만 좋았다면 너를 보내고 망설이지 않았겠지 힘들어도 내게 다가와 없이는 네가 없잖아 매일 보고 있어도 널 볼 수 없지만 이제는 알아 느끼는 있어나는 닮아가힘들어도 다가와 없이는 네가 없잖아 매일 보고 있어도 널 볼 수 없지만 이제는 알아 느끼는 있어나는 닮아가,1,0,-4,-1,-5
309,외로운 사람들의 마음을 열어줄 거야 메마른 가슴속을 적셔줄 멜로디 슬픔의 기억들에 기쁨을 채워줄 거야 넘치는 음악 속의 리듬을 바람이 살짝 잠을 깨운 꽃잎에 좋아해 말 한마디를 담아서 어젯밤 꼬박 새운 나의 노래에 사랑의 마법을 걸어보네 꿈 꿔왔던 소망과 꼭 간직해온 사랑을 모두가 느낄 수 있도록 마음을 담아 노래할 거야 너를 위한 노래를 예외로운 사람들의 마음을 열어 메마른 가슴속을 적셔줄 멜로디 슬픔의 기억들에 기쁨을 채워줄 넘치는 음악 속의 리듬을 자꾸만 두근 설레는 가슴에 좋아해 말 한마디를 못할 땐 바람에 살짝 띄어 보내 줄게요 사랑의 마법을 담은 노래난 꿈 꿔왔던 소망과 꼭 간직해온 사랑을 모두가 느낄 수 있도록 담아 노래할 너를 위한 노래를 예외로운 사람들의 열어 메마른 가슴속을 적셔줄 멜로디 슬픔의 기억들에 기쁨을 채워줄 넘치는 음악 속의 리듬을 비 갠 오후의 햇살처럼 마음 포근히 감싸줄게 먼 곳에 있어도 들려줄게 노래는 너와 외로운 열어,1,0,-7,-2,-9
310,당신은 너무 달콤합니다 언제나 입가에만 맴돌던 말 저만치 걸어가는 뒷모습 볼 때면 너도 나처럼 마음이 아프니 궁금해 이제 늘 아쉬워하고 때론 미워했는지를 널 사랑했던 거야 감출 수 없어 말을 전해줘 까만 밤 쏟아지던 불꽃놀이 아래 너의 반짝이던 눈을 잊지 못해 어른이었다면 입맞춤할 텐데 나비 우릴 데려가 줘 앨 처음 봤던 순간 같은 자리에 서로 눈 마주쳤던 순간 빠져버렸지 말을 전해줘 나비 마음이 고장 버렸으면 생각이 멈춰버렸으면 해 널 생각하면 이렇게 눈물이 날까 나비 이제 깨달았어 늘 아쉬워하고 때론 미워했는지를 널 사랑했던 거야 감출 수 없어 말을 전해줘 우릴 데려가 줘 앨 처음 봤던 순간 같은 자리에 서로 눈 마주쳤던 빠져버렸지,1,0,2,1,3
311,장난스러운 너의 속삭임 마음을 알아차린 신기루 같은 사랑의 유혹 당신이 사랑의 신의 신의 신의 신들이라면 마법의 이상한 유혹입니다 너에게 나를 가둬둘 수 있도록 당신이 사랑하는 사랑의 신을 신경 쓰지 않으면 사랑이 진실하게 되도록 널 향한 나의 소원이란 사랑이란 걸 그대만의 기적이란 훔쳐볼 순 없는지 우리가 사랑에 있는지 모르겠습니다 달콤한 사랑이여 그대는 신잔인한 사랑이여 그대는 신나 아닌 사람에게도 늘 보란 눈길 주더니 어느새 너의 황금화살에 순간에 당신이 신을 신경 쓰지 않으면 사랑에 깊은 사랑 너에게 나를 가둬둘 수 있도록 신을 신경 쓰지 않으면 사랑이 촉발되도록 하자 널 향한 나의 소원이란 사랑이란 걸 그대만의 기적이란 훔쳐볼 순 없는지 우리가 사랑에 있는지 모르겠습니다 달콤한 사랑이여 그대는 신잔인한 신 달콤한 신잔인한 너에게 나를 가둬둘 수 있도록 사랑하는 사랑이 진실하게 되도록 널 향한 나의 소원이란 사랑이란 걸 사랑하는 진실하게 되도록 장난스러운 너의 속삭임 마음을 알아차린 신기루 같은 유혹 마법의 이상한 유혹이라면 마법의 이상한 유혹의 신인을 않는다,1,0,-4,-2,-6
312,느낌이 오잖아 떨리고 있잖아 언제까지 눈치만 볼 거니 맘을 말해봐 딴청 피우지 말란 말이야 맘 가는 그대로 지금 손을 잡아 어서 손을 잡아 우연히 고개를 돌릴 때마다 눈이 마주치는 건 며칠 밤 내내 꿈속에 나타나 밤새 나를 괴롭히는 건 많은 빈자리 하필 옆자릴 고르는 건 나도 모르게 어느새 실없는 웃음 흘리고 있다는 말 다 했지 뭐 얘기 할까 느낌이 오잖아 떨리고 있잖아 언제까지 눈치만 볼 거니 맘을 말해봐 딴청 피우지 말란 말이야 맘 가는 그대로 지금 손을 잡아 핸드폰 진동에 심장이 덜컥 내려앉는다는 나도 모르게 어느새 짓궂은 말투 듣고 싶은 걸 어떡해 멀리 걸어온다 눈이 마주친다 언제까지 넌 모른척할 거니 사랑이 온 거야 너와 말이야 네가 못 견딜 만큼 그거면 된 거야 더는 생각하지 말란 맘 가는 그대로 느낌이 오잖아 떨리고 있잖아 눈치만 볼 맘을 말해봐 딴청 피우지 지금 그냥,1,0,2,0,2
313,언제나 거침없던 내가 조금씩 눈치를 보고 있어 겉으론 관심 없는 척 차가운 도시의 남자인 척 애써 외면하고 낯선 말투로 널 만나왔어 영화가 아니잖아 드라마의 남자가 아니잖아 이제 맘과 다르게 널 대할 순 없어 네가 솔직한 맘 들어봐 줄래 연애할까나 오랫동안 솔로여서 연애가 서툴지 모르지만 전 남자친구보다 네가 만난 모든 남자보다 가장 널 사랑할 연애할까 내가 머뭇거리는 너에게 쏟아지는 남자들의 관심 가득한 눈빛 친절한 태도 미치겠어애써 외면할까 생각도 했지만 아니요 그럴 순 없어 남자가 아니잖아 이렇게 허무하게 돌아선다면 이제 맘과 다르게 대할 순 없어 네가 솔직한 맘 들어봐 줄래 연애할까나 오랫동안 솔로여서 연애가 서툴지 모르지만 전 남자친구보다 만난 모든 남자보다 가장 사랑할 연애할까 연애할까나 오랫동안 솔로여서 연애가 서툴지 모르지만 전 남자친구보다 만난 모든 남자보다 가장 사랑할 키스할까사랑해이런 달콤한 말 매일 해주고 싶은데 용기 있는 남자 되어 꼭 너를 가지고 싶은데 곁에 있어줄래 시간이 없거나 눈이 높아진 것만은 아닌 거 같아 홀로 누군지도 모를 한 여자의 포로가 되어 나를 기다려 왔어 지금 그게 너라고 말하고 있어 아까 했던 얘기 한 번 해도 될까 키스할까 사랑해 달콤한 말 매일 해주고 싶은데 용기 있는 남자 되어 꼭 너를 가지고 곁에 있어줄래 연애할까,1,0,-4,-2,-6
314,온종일 정신없이 바쁘다가도 틈만 나면 네가 생각나 언제부터 안에 살았니 많이 웃게 돼 어느새 너의 모든 것들이 편해지나 부드러운 미소도 나지막한 목소리도 아직은 얘기할 수 없지만 있잖아 네가 사랑이란 말하긴 어설플지 몰라도 아주 솔직히 그냥 네가 친구들 속에 너와 함께일 때면 조심스레 행복해지고 어쩌다가 옆에 앉으면 세상을 다 가진 기분이 드는 걸 우연히 눈만 마주쳐도 괜스레 발끝만 보게 되고 조금씩 마음이 너에게 가고 있는 걸 세상에 두 사람 너랑 나만 몰랐나 잘 할지는 몰라도 곁에 서고 싶어 하루하루 점점 커져가는 느낌 날 보다 그냥 손잡을 때는 어떨까 둘이 입 맞춘다면 아직은 얘기할 수 없지만 있잖아 사랑이란 말하긴 어설플지 몰라도 아주 솔직히 그냥,1,0,-6,-1,-7
315,음 나를 나를 나를 날 바라봐 바라봐 바라봐 너를 본 마음속에 사랑이 본능이 고백 빨리 하라 해 주위를 둘러싼 수많은 경쟁자 당신을 위한 군인입니다 멘트 장전 발사하기 전에 제군들 입 풀었나 완전 간장콩장콩장장 동등합니다 간 공장장 준비 다 아침이 깨는 소리 아침 바람들은 조화를 이룹니다 저물어가는 달빛은 가자 여물 어가는 로맨스 꿈꾸고 새로운 느낌이야 이건 여기요 일반적인 사랑스럽습니다 아무래도 이거는 이거는 여야 합니다 확실한 비율 당신이 정말로 당신을 원한다는 것을 확실히 정말이야 널 좋아하는데 빨갛게 익은 얼굴이 그걸 증명해 날 딸기처럼 상큼한 사람 어리바리한 그대 주위 사람들은 다 이기주의 밤낮을 걸으며 널 지켜줄 나와 달리 그들은 차 키를 과시하지만 자다가 일어나 잠꼬대로도 널 찾네 아침이 깨는 소리 아침 바람들은 조화를 이룹니다 저물어가는 달빛은 놓아주세요 여물 어가는 로맨스 꿈꾸고 여보세요야디 가는 거니 당신이 거기에 있을 거야 네가 있는 거리 그런 식으로 아직 사이 서먹해도 노력하다는 해봐야지 나라도 여야 합니다 확실한 비율 당신이 정말로 당신을 원한다는 것을 확실히 정말이야 좋아하는데 빨갛게 익은 얼굴이 그걸 증명해 처음이야 기분 멈추질 못하겠어 막 넘쳐 누가 잠가놓은 입은 오물쪼물 안 열려 부름에 뒤를 돌아보는 두 눈을 보니 내일 봐요 자기야 이렇게 끝날 수 없어 누군가 도와주세요 맘을 전할 수 있다면 사실은 제발 좋아하는데 확실해 모던 걸 담은 눈빛이 그걸 증명해 여야 합니다 확실한 비율 정말로 원한다는 것을 확실히 정말이야 빨갛게 익은 얼굴이,1,0,-8,-7,-15
316,내가 이러죠 이상하죠 그대가 없인 하루가 너무 길어요 나라 사랑한 사람은 많이 있었지만 언제나 내겐 귀찮은 일이었는데 사랑을 받는 것만 익숙했던 그대 내게 뭘 했길래 내가 달라질까나조차 궁금하지만 사랑에 빠졌죠나밖에 모르던 못된 내가 나보다 그댈 생각해 요한 사람에게만 이렇게 하려고 그랬나 봐요 아껴둔 맘을 받아요 어제는 말이에요 관심도 없었던 남자 옷들을 고르는 날 발견했죠꼭 배우지 않아도 사랑은 이렇게 날 바꾸네요 그대만 생각하게 사랑을 받는 것만 익숙했던 주고 싶어 그대에게만은 그대도 나와 같나요 사랑에 빠졌죠나밖에 모르던 못된 나보다 그댈 생각해 요한 사람에게만 이렇게 하려고 그랬나 봐요 아껴둔 맘을 받아요 이별이나 말은 없겠죠오 베이비 나에겐 첫사랑인데 사랑이 깨지면 다시는 사랑을 못하게 될지 도난 몰라요 사랑에 빠졌죠 나밖에 모르던 그러던 못된 나보다 그댈 생각해요 그래요 그대에게만 그대에게만 이러려고 그랬나요 아껴둔 맘을 받아요 빠졌죠나밖에 모끄던 생각해요,1,0,-1,1,0
317,좋을 텐데 너의 손 꼭 잡고 그냥 길을 걸었으면 내겐 너뿐인 걸 네가 알았으면 좋을 텐데 전 만난 남자 얘기 오늘만 해도 벌써 번째니 그에게 전화가 왔었다며 조금은 얼굴을 붉히는 집에 돌아오는 길은 포근 한 달빛마저 슬퍼 보여 마음이 아파 나를 위로해줄 네가 있다면 좋을 텐데 너의 손 꼭 잡고 그냥 길을 걸었으면 내겐 너뿐인 걸 네가 알았으면 괜찮은 사람인지 아닌지 한번 본 적도 없는 내가 알아 그에게 선물을 받았다며 유난히 행복해 보이는 집에 돌아오는 길은 포근 한 달빛마저 슬퍼 보여 마음이 아파 나를 위로해줄 있다면 아닌 사람 얘기에 때론 화도 내어 봤으면 너의 곁에 내가 있었으면 모르겠니 애써 지켜온 우정마저 놓칠 것만 같아 기다리던 망설이던 그런 손 꼭 잡고 그냥 길을 걸었으면 내겐 너뿐인 걸 알았으면 아닌 사람 얘기에 때론 화도 내어봤으면 곁에 내가 있었으면 아닌 사람 얘기에 때론화도 내어봤으면,1,0,2,3,5
318,눈부신 눈부신 햇살을 닮았죠 맘에 찾아온 나만의 그대는 그래요 그댈 생각하면 언제나 힘든 하룬 행복으로 느껴지니까 내가 당신을 사랑하는지 당신을 사랑합니다 당신을 사랑합니다 맘이 보이질 않나요 이제는 내게 기대봐요 그대가 쉴 그늘이 돼줄게요 사랑 제발 사랑 말해줘 제발 사랑을 가지 마 삶의 마지막까지 그댈 사랑할게요 사랑 제발 말해줘 사랑을 가지 마 그대의 환한 미소로 내게 대답해줘 간 주 중 내가 사랑하는지 사랑합니다 맘이 보이질 않나요 이제는 내게 기대봐요 그대가 쉴 그늘이 돼줄게요 말해줘 사랑을 가지 마 삶의 마지막까지 그댈 사랑할게요 그대의 환한 미소로 대답해줘 무엇도 두렵지 않아 그대만 있다면 그대의 환한 미소로 받아줘 나의,1,0,-6,-2,-8
319,설레는 바람결에 가벼운 발걸음 너무 기분 응한 멋을 내고서 거릴 거닐어어때 근사하잖니 잘 지금뿐이야 나를 바라봐봐 내게로 아무 생각 하지 말고 느끼는 그대로 제발 제발 머뭇거리니 가까이 다가 와봐니 맘을 보여줘 제발 하얀 셔츠를 입고 환히 웃는 널 보면 너무 기분 음 조금은 어색해도 그건 문제가 안돼 눈이 가는 걸 잘 널 향한 맘을 보여줄게 당신이 저를 원한다고 말해주세요 내게로 아무 생각 하지 말고 느끼는 그대로 머뭇거리니 가까이 다가와 바니 맘을 보여줘 저를 내게로 아무 생각 하지 말고 느끼는 그대로 머뭇거리니 가까이 다가 와봐니 보여줘 다가 와봐니,1,0,-4,-5,-9
320,일요일 싱그런 햇살이 응창 넘어 테이블 위로 따뜻이 내려앉아 오늘 너무도 기다린 약속인 걸요 사랑스러운 향긋한 커피와 응부드런 아침 담아 너만을 위해 베이비 낯익은 멜로디에 안 하던 콧노래가 마음 가볍게 사랑에 빠진 것만 같아요 즐거워 맘은 짜릿하죠 그대 웃음과 장난들 떠올릴 때면 외롭지 않아이런 기분을 노래하죠 노래가 들리나요 동화 속 주인공처럼 그게 나인 것처럼 행복을 노래하죠 모든 일만 귀에 익은 발소리 느낌만으로도 그대 알 수 있는 걸 맘 그대도 알고 있는지 궁금해 날 향한 눈웃음 오늘도 청바지에 하얀 운동화 베이비 가슴 뛰게 하는 얼굴은 아닌데 웃음이 사랑에 빠진 것만 같아요 즐거워 맘은 짜릿하죠 그대 웃음과 장난들 떠올릴 때면 외롭지 않아이런 기분을 노래하죠 노래가 들리나요 동화 속 주인공처럼 그게 나인 것처럼 행복을 평생 마주할 맛있는 매일 아침 따뜻하게 해줄게요 그대만을 맘은 짜릿하죠 웃음과 장난들 떠올릴 때면 외롭지 않아이런 기분을 노래가 들리나요 동화 속 주인공처럼 그게 나인 것처럼 행복을 매일,1,0,-7,3,-4
321,안녕하세요 처음 뵙겠습니다 생각보다 너무 예쁘세요 말씀 많이 들었어요 좋은 사람 요즘 찾는다고 반가워요 처음 뵙겠습니다 생각보다 너무 멋지네요 저도 얘기 들었어요 외로움 타신다고 괜찮은 인연이 될 느낌 그대도 느끼나요 뱃속 가득 나비가 날아든 짜릿한 기분을 내일도 모레도 만나봐요 많이 그댈 알고 싶죠 궁금하고 너무 들뜨네요 아마도 그대가 좋아질 숙면했나요 좋은 꿈 꿨나요 마침 오늘 별일 없는 참에 커피 한잔 살까 되면 만날까요 잘 잤어요 날씨 좋네요 저도 오늘 딱히 별일 없어 무얼 할까 고민했죠 지금 만나요 괜찮은 인연이 될 느낌 그대도 느끼나요 뱃속 가득 나비가 날아든 짜릿한 기분을 내일도 모레도 만나봐요 많이 그댈 알고 싶죠 궁금하고 들뜨네요 아마도 그대가 좋아질 당신과 나와 나와 베이비 베이비나 어쩌면 그댈 만나기 위해 그동안에 아픈 사랑을 연습처럼 해 온 같아 고마워요 우리는 너무나 잘 맞아요 느낌 그대도 느끼겠죠에 세상이 둘을 위한 공원과 같은 기분 부디 천천히 천천히 알아가요 애태워 애태워 매일 처음처럼 처음 만나는 사람인 것처럼 언제나 설레게 노력해요,1,0,-8,1,-7
322,그냥 사랑에 빠지고 싶어 그래에 모든 것만 남이란 상상만으로도 눈부신 낭만의 시작한 잔의 진한 설렘에 향기가 온몸으로 퍼지는 환상의 슬며시 두 볼이 붉어진 연인들이 단풍 잎새처럼 느껴질 쓸쓸함이란 씨앗에 핀 사랑들이 무르익는 계절의 소식 마음에 번지는 흥분과 넘치는 기쁨에 뿜어지는 눈물들이 며칠을 잠을 깨워 깨워 밤새워 애 태워 해 봐도 그리움 못 채워 끄적 편지만 글자 보고 싶은 사람의 얼굴만 자꾸자꾸 떠오 르네 떠오 르네 그냥 쓰고 싶어 보다 외로움 보다 둘의 행복함 워 어어어 낮과 밤은 사라지는 사랑의 기적 요열과 성과 진심으로 전한 사랑의 결과는 기분 좋은 변화로 믿음이라는 굳은살이 박이고 아끼고픈 욕심에 푹 빠지고 살기 좋은 삶이란 이야기만 지나칠 만큼 입에 맴돌아달콤한 말보다 사소함을 챙길 맺는 두 사람의 교감 아주 자주 아픈 말을 낳는 질투가 주는 실수는 비뚤어진 입을 길들여 이해하기 인정하기를 기억하고 실천하길 넓은 가슴이 즐겨 먹는 사랑은 맛있어 달 빛 젖은 햇살 머금은 세상의 선물 워 어어어지켜줄께 아껴줄게 영원의 주문 당신은 나를 새롭게 느끼게 합니다 값진 사랑 반쪽을 갈라 서로 나누어 언제나 가슴에 품고서 모든 순간 함께해 웃음이 번지고 행복함은 넘치고 기쁨도 커지고 모두가 지금이 노래를 부릅니 다사랑은 맛있어 달 빛 젖은 햇살 머금은 세상의 선물 워 어어어지켜줄께 아껴줄게 영원의 주문 당신은 나를 새롭게 느끼게 합니다 값진 사랑 반쪽을 갈라 서로 나누어 언제나 가슴에 품고서 모든 순간 함께해,1,0,-12,4,-8
323,오늘 밤 날 바래다주는 길 내내 내가 변했다고 말하지 널 생각하지 않는다고 너는 투덜대지 언제나 넌 사랑이 설렘이니 내겐 사랑은 익숙함 너를 떠올리는 시간을 따로 두진 않아 늘 널 생각해 널 생각해바쁜 하루의 순간순간 순간도 네가 보여 보여줄 순 없지만 조금은 너도 느끼잖아 늘 생각해 매일 생각해 잠이 들어 꿈꾸는 순간도 앞에 웃는 그런 너를 기억나 내가 처음 고백했던 그날 멋진 이벤트도 없었지만 날 받아준 가슴에 늘 지금처럼 생각해바쁜 하루의 순간순간 순간도 네가 보여 보여줄 순 없지만 조금은 너도 느끼잖아 매일 잠이 들어 꿈꾸는 앞에 웃는 그런 너를 함께한 순간순간 순간이 소중해서 말로 다 할 수는 없지만 조금씩 네게 보여줄게 매일 생각해이른 아침잠에서 깨어나 세상에서 가장 행복한 앞에 웃는 그런 보며 사랑해,1,0,-9,-4,-13
324,사랑 그게 뭔지 아직도 궁금해나는 사랑에 대해 생각하고 있다고 생각하고 생각할수록 답이 멀어져 만 가는 같아 잘 모르겠어돌고 도는 쳇바퀴에 맞춰지는 퍼즐 게임 보드 그걸 원하는 건 아닐 말이야 왔다 가는 그런 인연 스쳐 가는 많은 우연 아직 기다리고 있어 운명 마음은 널 향한 녹색 빛 녹색 빛 머리는 날 향한 빨간색 라이트 레드 라이트 깜빡이는 신호가 날 서두르게 스쳐가는 인연인가 녹색 빛 라이트 우레 레드 우주 좋은 예감보다 앞서버린 희망 은 사랑에 대한 생각을 생각합니다 똑같은 실수 어김없이 반복해 안에 켜져 버린 빨간불 돌고 도는 쳇바퀴에 지쳐가는 마인드 컨트롤 그걸 원하는 건 아닐 말이야 왔다가는 그런 인연 스쳐가는 많은 우연 아직 기다리고 있어 운명 마음은 널 향한 머리는 날 빨간색 레드 깜빡이는 신호가 서두르게 스쳐가는 인연인가 루 붉은 우에 그린라이트 우에 그린라이트 빛에서 빛에서 빛에서 마음은 널 머리는 빨간색 깜빡이는 신호가 서두르게 인연인가 우레 우주,1,0,-3,-1,-4
325,항상 기다리기만 했었던 나도 먼저 연락 한 번 없었던 나도 그렇게 우린 멀어진 거야 처음 만난 시린 계절이 벌써 이렇게 다가왔고 날 재촉하던 너의 전화가 이제는 그리워 보고 싶어 시간이 지날수록 희미해져 서로가 서로를 못 본척하더라도 가끔은 그때를 추억하면서 웃음 지어 미쳐서 사랑했던 기억들이 빛바랜 사진으로만 남더라도 다 좋았으니까 우리니가 선물해 준 작은 인형이 보일 때마다 생각났고 내가 싫어하던 너의 장난도 이제는 그리워 보고 싶어 시간이 지날수록 희미해져 서로가 서로를 못 본척하더라도 가끔은 그때를 추억하면서 웃음 지어 미쳐서 사랑했던 기억들이 빛바랜 사진으로만 남더라도 다 좋았으니까 먼 훗날 우리가 다시 만나면 멈췄던 시간이 다시 흘러간다면 그날에 내가 살았던 못 견디게 행복했었던 기억들만 간직해줬으면 해시 간이 지날수록 선명해져잘해줬던 기억들만 떠올라서 이제야 생각 나날 힘들게 하는 건지 모르겠어미친 사랑했던 둘이 서로 길을 걸어가더라도 행복했었어,1,0,1,1,2
326,핸드폰 없이 살 수 없잖아집을 나가서 살 수 없잖아 당연하게 주고받던 문자 우리가 늘 함께했던 공간 온통 눈에 보이는 온통 귀에 들려오는 너와 나의 흔적 흔적들이라서 아침에도 눈 뜨기가 싫은데 내가 너를 지울 수 있을까 내가 그럴 있을까 마음처럼 쉽게 널 보낼 없어어떻게 하면 하면 하면 널 잊을까 온통 눈에 보이는 나도 모르게 찾고 있는 하나같이 추억 추억들이라서 아침에도 눈 뜨기가 싫은데 내가 너를 지울 있을까 그럴 마음처럼 쉽게 널 보낼 없어어떻게 잊을까 하는 이별이 나에게만 아픈 건지 너를 지울 그럴 마음처럼 쉽게 보낼 없어어떻게 잊을까,1,0,-1,-5,-6
327,사랑했던 나라 가끔은 없이도 영화를 보고 가끔은 혼자서도 술을 마셨어 너와 다툴 때마다 이별 한 여자처럼 나를 향한 마음을 미워했어 그렇게 없이도 살 알았고 그렇게 잊혀 찌게 될 사랑했었던 소중한 추억들을 믿었기에 널 아프게 했어 너와 이별하고 하루 되던 날 괜찮다던 맘이 불안해져 넌 아무것도 할 수 없던 내가 한심해도 네가 안아 줄까 기다렸나 사랑하던 날 그렇게 울고 웃던 날 너밖에 모르던 하나로 살아가던 날내 사랑이 사랑이 공기처럼 곁에서 이별하는 밤 미치게 보고 싶은 밤 접점 너를 잊는 밤 먼지처럼 사라지는 밤내 사랑이 기대 쉴 수 있도록 편하게 쉴 수 있도록 돌아와 너와 이별하고 되던 서랍 속에 사진을 버리고 우연히 널 마주칠까 그게 두려워 누가 일까 너무 행복할까 사랑하던 울고 웃던 너밖에 모르던 하나로 살아가던 날내 공기처럼 곁에서 네가 없는 불러도 대답 없는 너무 보고 싶은 밤눈 감아도 소용없는 밤내 사랑아 사랑아 제발 내게 돌아와 없인 안될 같아 영원히,1,0,1,3,4
328,움직여야 해 뭐라도 해야 해그래야만 해 바쁘게 살아야 해 가만있으면 가만히 있으면 볼 수 없는 그대가 보고 싶기 때문에나 혼자서 여행도 떠나보고 운동도 하고 기대면 잠이 만큼 일에만 매달려도 와중에 와중에 틈 사이로 그대가 나를 찾는다 그대 손에 끌려 걸었던 거리에 서있다 움츠린 목소리로 불러본다 바쁘게 지내도 그대 생각이 와중에게 을러지면 게으름 피우면 볼 수 없는 그대가 떠오르기 평소에 꼭 갖고 싶던 옷을 사고 친구를 만나 너무 행복하다고 말하고 있었는데 와중에 틈 사이로 나를 찾는다 그대 손에 끌려 걸었던 거리에 서있다 행복하냐고 물어본다 떠나보내야 떠나 주는 맞지만 떠날 수 없어 아쉬움만 남아 그댈 보냈던 계절은 가까워지고 얼어붙은 겨울도 따뜻했었고 그대라서 행복했었던 겨울이 다시 올 있을까 바쁘게 지내도 생각이,1,0,-1,7,6
329,오늘 뭐 먹었냐 묻던 너의 뻔한 문자가 보고 싶다는 말인 걸 그때는 몰랐을까 집 앞으로 나를 찾아왔을 내가 기뻐하고 웃어줘야 했는 데 있을 잘할 걸어 외롭지 않게 손을 잡아줄 걸 사랑할 해 걸 미안하단 말을 이제 와서 하는 걸치니가 가자 했던 예쁜 곳들 다 적어 놓고 친구들 만날 시간에 분이라도 볼 맨날 별거 아닌 이유로 화만 미안해널 그렇게 보내서 미안해있을 잘할 걸어 외롭지 않게 손을 잡아줄 사랑할 해 미안하단 말을 이제 와서 하는 걸까 그날 밤 너의 눈물이 마지막 안 산 모르고 후회만 해내가 잡아주고 안아줬다면 우린 지금 달랐을까 한 번만 기횔 줘 내게도 번 실수 없이 너를 사랑할 테니까,1,0,1,-1,0
330,없이는 길도 못 찾고 혼자서는 밥도 못 먹고 나만 보고 나만 보던 넌데 늦은 밤에 집에 갈 때면 무섭다 전화길 붙들고 나만 찾던 너잖아 내가 불러주던 노래 제일 좋다며 빨갛게 오른 두 볼로 졸라댔었던 너였었는데 이별이 될까 이런다고 될까 잊어봤자 생각날 거면서 없던 될까 그게 쉽게 없단 매일 울고 우는 이율 몰랐어나 없이는 옷도 못 사고 선 영화도 보고나만 보고 보던 넌데 항상 날 바래다줄 때면 돌아가기 싫다며 찾던 너잖아 수도 없이 헤어져도 전화 한 통에 미안해 내가 잘할게 한마디에 풀렸었는데 이별이 이런다고 잊어봤자 생각날 거면서 없던 그게 쉽게 없단 매일 울고 우는 이율 몰랐어내 하루에 널 빼면 나도 없는 건데 없이 아무것도 아냐 오늘 다시 처음 만난 것처럼 내일이면 다시 만날 것처럼 다시 돌아가 눈부신 그때로 돌아갈 순 없을까 이별이 없이 살까 안 될 거 알잖아 돌고 돌아 너일 거 알잖아 추억이 뭔데 그런 거 몰라라 거짓말처럼 남겨 놓고 떠나려 하지 마이별이 이런다고 잊어봤자 생각날 거면서 없던 그게 쉽게 없단 매일 울고 우는 이율 몰랐어,1,0,5,3,8
331,답장을 늦게 해도 약속을 미뤄도 항상 웃어주던 너라 내가 잘 몰랐나 봐잠잠한 핸드폰이 익숙해져 갈 때쯤 그때야 늦게 떠난 널 느낀 거야 없이 잘 살 거라 믿어 왔던 무딘 내게 너라는 폭풍이 밀려와 사랑한단 흔한 말이라도 그렇게 좋아하던 작은 꽃이라도 밥은 먹었냐는 흔한 말도 할걸 그랬어이렇게 널 사랑하는 줄은 몰랐어 잘해줄걸 잘해줄 걸 잘해줄 걸 떠나고야 알았어익숙해진 사랑이 너에게는 깊은 상처였는지 우리가 함께했던 긴 반이라도 잘해 걸 그랬어 사랑한단 흔한 말이라도 그렇게 좋아하던 작은 꽃이라도 밥은 먹었냐는 말도 할걸 그랬어이렇게 널 사랑하는 줄은 몰랐어널 부서지게 만들었던 시간을 잘라내조각난 기억들을 다 꿰매고 나면 처음인 것처럼 처음 그때처럼 다시 돌아가 세상에 당연한 너로 머물러 있어주길 없는 일분일초 나의 하루 없는 내일 나의 모든 순간들이너라는 아픈 감각 하나에 망가져간다 아직도 사랑하는 줄은 몰랐어 잘해줄걸 잘해줄 잘해줄걸,1,0,-4,0,-4
332,오늘도 생각 없이 노랠 흥얼대본다 뻔한 가사 말을 부른다 이게 뭐라고 그깟 이별이 대수라고 노래 생각난다 어딘가 익숙했던 노래의 길을 멈춘다 진작 몰랐을까 맘과 똑같다는 걸리게 뭐라고 듣던 노래였는데 이제 귓가를 울린다 누가 이별하고 그리워하나 노래 주인공도 나처럼 아팠나 생각났다 네가 보고 싶다 벌써 며칠째 노래에 기댄 다우리가 사랑할 들리지 않던 가사가 한 글자 남김없이 텅 빈 가슴에 박힌다니가 뭐라고 금세 괜찮겠지 말 다 거짓말 거리에 네가 부르던 멜로디가 누가 이별하고 그리워하나 노래 주인공도 나처럼 아팠나 생각났다 네가 보고 싶다 벌써 며칠째 노래에 기댄 다운 다 노래가 대신 운다 별거 아닌데 나를 미치게 해 노래가 역시 어디선가 들린다면 한 번은 돌아보겠지 추억이 붙잡겠지 너도 나처럼 무너질까 맘이 다 터질 만큼 노랠 부른다니 귀에 닿진 않을까 돌아올까 봐뭘 해도 너뿐이라 보고 싶다 오늘 하루도 노래만 부른다 오늘도 노래가 날 울린다,1,0,3,1,4
333,우연히 널 보게 됐어 예전보다 많이 야윈 얼굴 아직 혼자인 거니 넌 애써 외면하는 우리가 이별보다 아픈 같아 힘들어잊은 알았던 많은 기억한 번에 밀려와밤늦도록 잠들지 못해 마지막 얼굴 말투 표정 날 힘들게 헤맬 밤 널 데려다주던 골목 이제는 걷는데 한 번이라도 널 볼 수 있다면 그럴 수 있다면 다시 내게 돌아와 주길 바라고 있어헤어질 걸 알았더라면 조금만 덜 사랑했다면 우린 어땠을까 돌이킬 수 없단 걸 알지만 너를 안고 싶어 한 땐 나의 전부였는데 마지막 얼굴 말투 표정 날 힘들게 헤맬 밤 데려다주던 골목 이제는 걷는데 한 번이라도 볼 있다면 그럴 다시 내게 돌아와 주길 바라고 있어기다린다는 말도 못 하고 뒤늦은 후회를 하고 있는 나난 못해 두고 사랑 도저히 자신이 없어어떻게 잊어 떠나보내 이별은 멀기만 번이라도 볼 그럴 헤어지던 골목에서 기다릴게,1,0,5,-3,2
334,나를 펑펑 울려요 나라 버리려고 그대의 표정이 말투가 이별이에요 숨 막힐 듯한 공간 시간이 멈춘 듯한 순간이 거짓이기를 꿈 속이기를 바라 헤어지지 말자 다시는 돌아서지는 말자 그토록 굳게 약속해 놓고 날 울리나 봐떠나가나 사랑이 끝났나 그대를 영영 못 볼까 그대 날 돌아선다면 겁부터 걸요 그대를 잃을까 봐요 엉망으로 살겠죠 매일 울다가 웃다 한숨만 어떡하나요 해야 살죠 헤어 지지 말자 다시는 돌아서지는 그토록 굳게 약속해 놓고 날 울리나 봐떠나가나 사랑이 끝났나 봐미치도록 사랑했었던 나를 그렇게 잊지는 막 사랑 안 해도 되다 시는 바라는 것도 없어 곁에 있게 해주면 돼안될 같아 없이 내가 웃을 수가 없잖아 없인 안 되잖아,1,0,2,-1,1
335,그때로 돌아가아픈 기억은 뒤로하고 행복했었던 순간을 찾아가 분명 사랑이었지 헛된 거짓말은 아니었지 널 사랑했고 너도 날 사랑한다 했잖아 꼭 잡은 두 손과 서로의 숨결만으로 모든 충분했던 그때그때로 돌아가널 잊을 수 있는 만큼만 보내줄 수 있는 만큼만 바라보는 거야 그때로 돌아가 너를 좋아한 아니다 너를 사랑한 다날 속여보는 거야 그렇게 떠나고 내게 남겨진 그리움을 지워내는 건 몫인 거라 그때로 돌아가널 잊을 수 있는 만큼만 보내줄 안아보는 거야 돌아가 너를 좋아한 아니다 사랑한 다날 속여보는 너도 내가 그리울까 세상에서 다시 만나 둘만의 영원을 약속하는 상상을 할까 만일까 사랑해난 사랑해난 사랑해 아직도 사랑해난 사랑해 똑같이 끝이 난대도 또다시 만나고 다시 널 보내줄게,1,0,0,-1,-1
336,그대는 날 잊고 잘 지내나요 날 사랑하긴 했나요 아직도 그대를 그리워해요 그대는 이별이 쉬웠나 봐요 가슴 아파할 맘은 생각지 않았나요 아직은 그대를 사랑하며 지내는 나에요 잊지 말아요 사랑했었던 서로를 사랑에 서툴렀던 나의 맘을 안아주었던 따스했던 그대의 맘을 내가 간직할게요 이별에 아파하고 있어 보고 싶다고 그대를 위한 눈물을 담은 작은 편지를 써내려가 보네요 그렇게 모진 말로 내게 상처를 주던 널 뭐가 그리도 보고 싶다고 너를 찾고 있어 사랑에 서툴렀던 나의 맘을 안아주었던 따스했던 그대의 내가 간직할게요 이별에 아파하고 있어 보고 싶다고 위한 눈물을 담은 작은 편지를 써내려가 보네요 가끔 그때로 돌아가는 상상을 해 많이 지치고 힘들어도 네가 있던 그때로 사랑에 서툴렀던 나의 안아주었던 따스했던 그대의 잊을 수가 없어요 이별에 아파하고 위한 눈물을 담은 작은 편지를 써내려가 보네요,1,0,6,4,10
337,더는 애쓰지 않아도 돼 억지로 끌고 가는 마음 너무 잘 알고 있었지만 믿고 싶지 않았어멀어지는 널 바라보며 작은 기대도 내려놓을 게이 미 너에겐 내가 없단 걸 잘 알아야만 놓으면 끝이라는 걸 확신할수록 초라해져빛바랜 너를 보내줄게 내가 상처받는 싫었던 건지 아님 마지막 순간까지 좋은 사람이고 싶었는지 내게 차가운 눈빛으로 텅 빈 사랑한단 말 사실 다 알고 있었지만 말 믿고 싶었어 지금도 멀어지는 널 바라보며 작은 기대도 내려놓을 게이 미 너에겐 내가 없단 걸 잘 알아야만 놓으면 끝이라는 확신할수록 초라해져빛바랜 너를 보내줄게 사랑한단 말은 같아도 다르게 사랑했나 다르게 사랑했나,1,0,-5,1,-4
338,넓은 세상에 수많은 우연이 우릴 만나게 했죠둘도 없던 이제 변해버린 사이에 대해슬픈 얘길 할게요 오늘 서로를 위해 우리의 시간들을 흘려보내기로 찬란했던 기억 서랍 속에 넣어둬요 아름답던 추억으로 간직하기로 우연히 마주치더라도 서로 웃으면서 마주할 수 있게 구름 뒤에 별처럼 작은 순간까지 묻어 둬요 억지로 지우려 애쓰지는 말아요 지나간 계절처럼 다시 올 그날처럼 그렇게 행복하게 살아가면 돼요 잡았던 손을 서로 아프지 않게 놓아주기로 찬란했던 기억 서랍 속에 넣어둬요 아름답던 추억으로 간직하기로 우연히 마주치더라도 서로 웃으면서 마주할 수 있게 살아가면 돼요 날 가슴이 메 올 넘쳐흐르는 눈물을 맘껏 뱉어도 돼요 그대 맘이 시원하게 비워질 수 있도록 그렇게 날 보내면 찬란했던 기억 서랍 속에 넣어둬요 아름답던 추억으로 간직하기로 우연히 마주치더라도 웃으면서 마주할 있게 구름 뒤에 별처럼 작은 순간까지 묻어 둬요 억지로 지우려 애쓰지는 말아요 지나간 계절처럼 다시 올 그날처럼 그렇게 행복하게 살아가면,1,0,2,6,8
339,어떨 같아 남이 된다면 서로를 놓아주게 된다면 다를 있니 지금 우리를 늘 곳만 보고 있잖아나의 전부를 주고도 늘 부족했던 그날들이 그리워질 때면 눈을 감아 근데 맘처럼 되지가 않아서 마음이라는 쉽지가 않아서 잡으려 하면 할수록 점점 멀어지는 우리가 돌아갈 수 있겠어 이별이란 건 남의 얘긴 알았어기다리면 다시 제자리로 돌아갈 거라고 근데 맘처럼 되지가 않아서 마음이라는 쉽지가 잡으려 하면 할수록 점점 멀어지는 우리가 돌아갈 수 있겠어늦었다는 걸 서로 알고 있잖아 기다림도 바램도 못 다 한 이별일 테니까 우리가 뭘 할 수 있을까 아무리 찾아도 하나밖에 없어 그리워하면 할수록 점점 멀어지는 사랑한 날들을 이제는 보내자 어떨 같아 남이 된다면,1,0,1,3,4
340,사랑한다고 거짓말이라도 해줘 오늘따라 힘들었던 이유가 있어 하루 종일 너를 못 봐서 매일 만나서 떡볶이도 먹으며 있을 좋았어 지금은 우리가 멀리 있더라도 다시 만나게 될 거야 사랑한다고 거짓말이라도 해줘 미안해하지 마다지 웃으면서 만날 거니까 믿을게 이해할게 참아볼게 돌아와 줘기다릴게 거짓말이라도 해줘 제발 따뜻했던 눈빛과 미소를 기억 해단 한 번도 잊지 않았어 애써 웃음 지었던 마지막 모습은 너답지 않아 보였어 사랑해 날 사랑하냐고 물었을 뿐 야한 번 듣고 싶은 말이니까 사랑한다고 미안해하지 마다지 웃으면서 만날 거니까 믿을게 이해할게 참아볼게 돌아와 줘기다릴게 제발 흔들렸다고 그렇게 내게 말해줘 지쳐서 나를 밀어내려 했던 거라고 믿을 그냥 시간이 가도 언제나 기다릴 거야 너를,1,0,1,3,4
341,이별하는 가을의 밤은 무릇 아파 많이 사랑했단 말에 다시 눈물만 그랬듯이 슬픔은 익숙하지 않아바랐지만 그댄 내게 머물러 주지 않아 사랑하는 그대여 거기 멈춰 서요 걸음이 따라가긴 너무 느려서 바라만 보네요 두 눈은 흐려져요 나의 눈물 울지 않아 애써 견뎌도 눈썹이 젖어와잊겠다고 말을 해도 다시 너를 생각해 사랑하는 그대여 거기 멈춰 서요 걸음이 따라가긴 너무 느려서 바라만 보네요 두 눈은 흐려져요 나의 눈물 지나야 제자리걸음을 멈출 수 있을까요 떠나가는 그대여 내게 약속해요 돌아오는 길은 부디 잊지 말아요 마음 떠나도 내가 이곳에서 기다려요 계절이 바뀐대도 나를 생각해줘요,1,0,2,-1,1
342,너와의 시간은 여태 멈춰있어 그때의 우릴 추억이나 하듯이 멍하니 어제가 그리워져떠나간 네가 아직까지 받아들여지지 않아 바람이 따듯해서 네가 보고 싶어지는 날 보면 이제 그만 힘들고 싶다고 새어 나온 너를 하염없이 덮어보려 해도 아무것도 지워지지가 않아나의 모든 계절에 흔적들이 남아서 없는데 매일 이별하는 것만 같아짙어져 내게 다가왔던 너의 모든 순간들 어떻게든 네게서 멀어지고 싶은데 그다음 계절이 다가올 때면 또다시 그대가 불어올까 하루 종일 맘 졸이곤 해이 제야 깨달았어내가 좋아했던 계절 다 너여서 가능했었던 거야 나의 모든 계절에 흔적들이 남아서 없는데 매일 이별하는 것만 같아짙어져 내게 다가왔던 너의 순간들 시간이 지나도 온통 너였어 너는 그렇게 날에 스며들어모든 계절들은 너를 내게 데려와날 힘들게 해나의 계절은 너로 가득해날 매일 울리고 이별보다 힘든 하루를 보내짙어져 다가왔던 너의 순간들 어떻게든 네게서 멀어질 수 있을까,1,0,2,5,7
343,너에게 사람이 생겼다는 소식을 듣게 되었어난 하루 종일 복잡한 마음이라서 아무것도 할 수 없었어날 보며 웃는 너의 행복했던 모습이 이제는 아픔이 되고 그렇게 생각은 자꾸만 깊어져 추억 속 어딘가로 날 데려가는데 너에게 사랑을 말할 수 없고 별도 쉽게 못하고 믿기지가 않아난 어떡해야 해 우리의 사랑이 끝났다 해도 다신 볼 수 없어도 하나만 기억해 줘함께 한 시절 우리가 함께했던 모든 순간순간이 이제는 돌아오지 않는데 덩그러니 남겨진 너의 사진 보면 추억 속 그곳에선 함께인 것만 같 아이젠 너에게 사랑을 말할 없고 별도 쉽게 못하고 믿기지가 않아난 어떡해야 해 우리의 사랑이 끝났다 해도 다신 볼 없어도 하나만 기억해 줘함께 한 시절 다 끝인가 봐되돌릴 없는 불난 알고 있지만 사랑을 말할 없다 맘은 아직 널 그리는데 스쳐버린 사람 그런 추억일까 시간이 멀리 널 데려가도 더는 볼 없어도 하나만 기억해줘함께 한 시절,1,0,-3,3,0
344,며칠째 비가 끝도 없이 내리더니 오늘은 청명한 하늘빛에 문득 눈물이 지내 잘 있어 매일 똑같은 날 없이도 흘러는 가더라 아마 넌 이미 결말을 맺었겠지 새로운 이야기 속으로 들어가 누군가의 곁에서 미소를 짓고 떨리는 손길을 나누며 지친 날엔 혼잣말로 널 부르곤 핵 어둑해진 밤이 오면 별빛보다 반짝이던 너를 떠올리며 한참을 뒤척이며 울어 희미한 기억 속함께 있던 작은 방과 두근거리던 심장이 살아있단 걸 가르쳐줬어 시간은 너무 빨리 흘러 이별이 찾아와 이미 잊혔겠지만 있어 지친 날엔 혼잣말로 널 부르곤 핵 어둑해진 밤이 오면 별빛보다 반짝이던 너를 떠올리며 한참을 뒤척이며 울어 오나에겐 끝나지 않은 스토리 오너에겐 오래전 이미 끝난 얘기 잘 지내고 있습니다 슬픈 날엔 혼잣말로 널 부르곤 해 네가 항상 앉아있던 의자 위에 희미하게 남겨진 흔적이 오늘따라 선명해져가,1,0,-1,-4,-5
345,며칠째 비가 끝도 없이 내리더니 오늘은 청명한 하늘빛에 문득 눈물이 지내 잘 있어 매일 똑같은 날 없이도 흘러는 가더라 아마 넌 이미 결말을 맺었겠지 새로운 이야기 속으로 들어가 누군가의 곁에서 미소를 짓고 떨리는 손길을 나누며 있어 지친 날엔 혼잣말로 널 부르곤 핵 어둑해진 밤이 오면 별빛보다 반짝이던 너를 떠올리며 한참을 뒤척이며 울어 희미한 기억 속함께 있던 작은 방과 두근거리던 심장이 살아있단 걸 가르쳐줬어 시간은 너무 빨리 흘러 이별이 찾아와 이미 잊혔겠지만 있어 지친 날엔 혼잣말로 널 부르곤 핵 어둑해진 밤이 오면 별빛보다 반짝이던 너를 떠올리며 한참을 뒤척이며 울어 오나에겐 끝나지 않은 스토리 너에겐 오래전 이미 끝난 얘기 슬픈 날엔 혼잣말로 널 부르곤 해 네가 항상 앉아있던 의자 위에 희미하게 남겨진 흔적이 오늘따라 선명해져가,1,0,-1,1,0
346,반복일 뿐이야 반복일 뿐이야 그렇게 말해도 모르니 다신 안 보기로 했잖니 한번 눈물일 뿐인데 약속한 있잖아 헤어진 맞잖아 이제야 익숙해졌는데 다시 가슴 아프게 하니 반복일 뿐이야 미련일 헤어지고 만나고다 다시 만나도 모든 돌아와도 사랑했대도 그뿐이야 거짓말하던 내가 싫어 네가 우는 모습 힘이 들어아픈 모습 볼 수가 없어이런 맘도 이해해 줄래 미련일 헤어지고 만나고다 순간일 다시 만나도 모든 돌아와도 사랑했대도 그뿐이야 돌아 볼 수 없어흔들릴 나란 걸 아니까 아픔일 미련일 사랑하고 이별하고 시작일 눈물 흘려도 잊을 수가 없어도 죽을 아파도,1,0,7,5,12
347,아기 사랑은 결코 그렇게 좋았다는 느낌이 들지 않고 당신이 나를 붙잡고 있는 것처럼 의심의 여지가 없다 당신을 사랑하고 생명을 사랑하고를 사랑합니다는 결코 그렇게 당신이 나를 붙잡는 것처럼 의심의 여지 가라면 의심의 여지가 없을 것입니다 사랑하는 생명 바빌로프 미친 바 빌 로브는 결코 그렇게 굿바이 바 빌로우 느낌이 절대 느껴지지 않았다고 느꼈다 밤이 될 거야를 기다릴 수 없다 은 좋은 느낌이 너무 선한 너무 좋다고 느꼈습니다,1,0,-3,0,-3
348,세상에서 가장 행복한 말 더욱 듣고픈 말 고마운 말 날 살리는 사랑해 그댈 쑥스러워 평생 못하는 더욱 하고픈 미안한 눈물 사랑해 그댈 사랑해 마음은 굴뚝인데 핑계 핑계로 미뤄뒀지 말이야 말아내 진심은 말이야 너를 나에겐 누구보다 소중한 사람 언제나 곁에 있어서 깜빡 잊고 살지만 지금 눈물 고마운 사람 언제나 그렇게 있어줘 그대 기쁜 맘을 알아줘멋쩍어서 내내 감추는 맘 지금 열고픈 맘 든든한 맘 따뜻한 그댈 마음은 안 툴툴거리고 짜증 냈지 말이야 말아내 진심은 너를 나에겐 누구보다 소중한 사람 언제나 곁에 있어서 깜빡 잊고 살지만 지금 눈물 고마운 그렇게 있어줘 그대 기쁜 맘을 알아줘 이것저것 재지 않아도 별다른 이유 찾지 않아도 날 믿어줄 날 감싸줄 지켜줄 힘이 돼 나의 좋은 너를 사랑 해이 세상 누구보다 소중한 곁에 있어서 깜빡 잊고 살지만 그렇게 있어줘 그대 기쁜 맘을 알아줘,1,0,-8,1,-7
349,햇살이 가득 그댈 향한 가벼운 발걸음 콧노래 부르며 쇼윈도에 비친 모습을 한번 점검해 시간은 충분해 오늘 그대와 얘기를 나눌까 어딜 가볼까 저기에 그녀가 보이네요 오늘은 너무 기분 좋은 날 미소가 가득 나도 모르게 웃음이 그녈 생각하면 지금 모습 그녀 맘에 들지 않을까 신경 쓰여 오늘 그대와 팔짱을 끼면 어떨까 손잡아 볼까 저기에 그녀가 보이네요 오늘은 너무 기분 좋은 날 하늘 위를 기분이 걸까 오글댄 너무 새콤달콤 마음은 두근두근 기분이 분홍빛 장미를 닮은 아름다운 그녀의 모습 오늘은 어떨까 상상만으로 터져버릴 듯한 기분 어쩌면 오늘 그대와 얘기를 나눌까 어딜 가볼까 저기에 그녀가 보이네요 나를 향해 손을 흔드네요 눈앞에 좋은 날,1,0,-5,-1,-6
350,어깨동무까진 괜찮아 치마 손잡는 건 위험해 잘 자란 메세 진 괜찮아그래도 자냐는 메세 진 안 돼심심할 연락해 커피 한 잔은 알았어늦은 술 한 잔은 안 돼가끔 전화는 영상통화는 고맙지 만 사양할 아무래도 어색해서 못해 사이엔 둘만 모르게 그어진 선 같은 있나 친구라 하기엔 가까운 같은데 우린 선 위에 있나 봐넘어와 넘어와 소녀 어색해지면 어쩌지 뻘쭘해지면 어쩌지 넘어와 소년 넘어와 눈 감고 다가가 볼까 살짝 기대는 어깨 거기까지는 사실 지금도 좋은데 다가와도 알았어멀어질까 걱정돼 아직 준비 안 된 같아 사이엔 둘만 모르게 그어진 선 같은 있나 친구라 하기엔 가까운 같은데 우린 위에 사이엔 둘만 모르게 그어진 같은 친구라 하기엔 가까운 같은데 우린 위에 봐넘어와 소년 어색해지면 어쩌지 뻘쭘해지면 소년 소녀 눈 감고 다가가 볼까,1,0,-3,3,0
351,마주치는 눈빛에 왠지 어색해 대체 고개를 숙여봐도 너의 발끝에 맘이 설레 두근대 두근대 두근대네 발이 조금씩 내게로 천천히 한 걸음걸음 가까워지잖아숨길 수 없어진 맘은 커져만 가는데 어서 어서 살며시 고개 들어 너를 보면도 볼에 살짝 입 맞춰줘 당신은 당신이 하시겠습니까 혼자서 아주 오래 바라왔던 동화 같은 그런 순간이 오늘은 꼭 생기길 기도해 볼래한 발 두 발 뛰는 맘 발끝이 닿을 같아나 어떡해야 해 머릿속이 새하얗게 돼 괜스레 장난스레 한 발 물러서 멈춰 서면 넌 다가와 다가와 다가와 점점 커지는 심장의 발걸음 어쩌면 네게 들릴 것만 같아한 가까이 너에게 먼저 다가갈까 어서 살며시 고개 들어 너를 보면도 볼에 살짝 입 맞춰줘 당신은 당신이 하시겠습니까 혼자서 아주 오래 바라왔던 동화 같은 그런 순간이 당신은 당신을 하시겠습니까 오늘은 꼭 생기길 기도해 볼래 망설이지 말아 줘 사랑 갑자기 고개 숙여 나를 향해도 볼에 살짝 입 맞춘 놀라서 들어 너를 보면 아무 말 없이 안아줄래 당신이 품에 포근하게 어쩐지 맘이 간지러워한 쪽 발이 하늘로 날아 당신을 마음도 오를 같아 수줍게 간직했던 가슴속비밀 오늘은 이뤄지길 기도해 볼래,1,0,-1,0,-1
352,네가 맛있었다고 했던 살구빛 샐러드 맛있어서 먹고 싶어 네가 좋아했던 것들을 나에게 자그마한 행복들 달력 안 기념일들로 채워지네 채워지네 네가 좋아했던 살구빛 샐러드 그날은 샐러드 기념일 우후나 좋아하던 멜로디언 소리 그날은 멜로디 기념일 라라라나 예뻤었다고 했던 조그만 고양이 귀여워서 보고 싶어 좋아했던 것들을 나에게 자그마한 고양이들 방에 한가득하게 채워지네 살구빛 그날은 기념일 좋아하던 멜로디언 소리 멜로디 라라라나 좋아하던 멜로디언 소리 멜로디 라라라나,1,0,-4,-5,-9
353,아침에 일어나 너에게 짧은 인사를 보낸다 아무리 멀리 떨어져 있어도 널 생각하고 있어 늦은 밤 졸린 눈 비비며 너에게 편지를 쓸게 반가운 사진 속 표정만큼 아름다운 나날들이기를 찬 바람이 불어와 어깨가 움츠러들 때에도 너를 떠올린다면 씩씩한 표정 할 수 있어 알고 있니 넌 나의 숫자 두근대는 맘은 아직까지 여기에 언제까지나 나의 하나뿐인 좋아한단 말은 나를 웃음 짓게 해 나의 하나뿐인 때로는 지쳐 울어도 눈을 감으니 꼭 곁에 있는 같아 짠 하고 나타날 생각지 못한 날 우연히 문득 뒤돌아 봤을 꼭 내가 있을게 꼭 하고 껴안을게 가장 반가운 얼굴로 눈물이 왈칵 쏟아진다 해도 환하게 웃을 거야 오늘 너에게 서러운 일이 생긴다면 오래전 그날처럼 달려가 안아주고파아름답게 빛나길 알고 있니 넌 숫자 두근대는 맘은 아직까지 여기에 언제까지나 하나뿐인 좋아한단 말은 나를 웃음 짓게 해 때로는 지쳐 울어도 번호 당신과 사랑에 빠지고 싶어 번호 눈을감으니 곁에 있는 같아 기억해줘 넌 숫자 보고 싶은 사람 이만 줄일게 안녕,1,0,-4,2,-2
354,때때로 당신에게서 얻는 사람을 원합니다 되돌아가도 그댄 없네요 무너진 밤은 어떡하나요 사람이 떠나는 사람을 떠나는 명확한 음식을 만들지 않았다 무너진 어떡하나요,1,0,0,-7,-7
355,빈 잔이 차올라 다시 기억 선명해져 생각 안 나길 빌어네 번호 못 누르게 어쩔 수 없다는 걸 알아넌 이미 없는 사람 오늘도 술로 채우네 없는 빈자리를 빨리도 잊는다 빨리도 지운 다우리 했던 사랑한 기억들 아무 없었다는 듯이 빨리도 잊는다손 잡고 걸어가며 웃던 미소 거리에 저리던 팔베개에 잠든 얼굴 방 안에 잊는다 지운 다우리 했던 사랑한 기억들 아무 없었다는 듯이 자석처럼 날 끌리게 하던 향기도 걷던 거리에 남아날 미치게 하는데 잊는다 지운 다우리 했던 사랑한 기억들 아무 없었다는 듯이,1,0,-1,1,0
356,내가 버린 그녀가 노랠 들으면 흩어진 갈색 머리 바람에 젖어 날 생각할까 그녀를 생각하면 노랠 부르면 사랑을 이별로 갚은 어리석은 날 미워할까 내가 버린 거라 믿는지 넌 아직 모르고 맘속 널 보내는 슬픔은 몰라주고 단 한 번 사랑했던 너의 갈색 향기 아직도 사람은 꿈도 못 꾸는 나를 초겨울에 그리움 묻어와 갈색 실 스웨터 보면 걸음 멈추는 나를 내가 버린 거라 믿는지 넌 아직 모르고 맘속 널 보내는 슬픔은 몰라주고 보낸 이율 아는지 다 알고 있는지 버려진 눈물 속에서 지내온 걸 아는지 거라 믿는지 넌 아직 모르고 맘속 널 보내는 슬픔은 몰라주고 보낸 이율 아는지 다 알고 있는지 버려진 눈물 속에서 지내온 걸,1,0,0,2,2
357,오늘도 이렇게 어제처럼 잔을 꺼내나 혼자서 따른 잔에 입술을 기대 눈물 반 소주 반 흘리고 비우고 마셔야 잠들 수 있을까 나를 많이 사랑한 사람 너라서 좋았는데 너보다 나은 남자 못 만날 텐데 술이 뭐길래 잊으려 마신 술인데 술이 뭐길래널 생각나게 해너와 내가 헤어진 늘어버린 두 가지는 술 그리움 오늘도 이렇게 버릇처럼 잔을 꺼내 어제보다 많은 술에 몸을 기대려 해 한숨 반 소주 내쉬고 채우고 마셔야 취할 수 있을까 나를 많이 사랑한 사람 너라서 좋았는데 너보다 나은 여자 못 만날 텐데 술이 뭐길래 잊으려 마신 술인데 뭐길래널 생각나게 해너와 내가 헤어진 늘어버린 두 가지는 술 그리움이나 우린 잘못 헤어져 버려서 꼭 미안하다고 말하고 싶어 뭐길래 잊으려 마신 술인데 뭐길래널 생각나게 해너와 내가 헤어진 늘어버린 두 가지는 술 그리움 더한 번 널 사랑할 수 있길,1,0,0,4,4
358,막차 시간이 다 되어 손을 맞잡고 역에 뛰어가던 넌 항상 다정했어 버스에 나를 태워 보내고 집까지 걸어가던 네가 그리워져 버스정류장 앞을 지나치던 밤 그때의 우리를 꼭 닮은 연인이 손을 잡고 달려가더라 돈이 없었던 열아홉의 우린 행복했어 오늘따라 네가 그리워 버스 지하철 택시 타던 때가 새벽 시 승강장에서 잠을 쫓으며 첫차 기다리던 날 우린 다투었어 반복된 무기력한 상황 속에서 현실의 벽 느끼고 우린 헤어졌나 버스정류장 앞을 지나치던 밤 그때의 우리를 꼭 닮은 연인이 손을 잡고 달려가더라 돈이 없었던 열아홉의 행복했어 오늘따라 네가 그리워 버스 지하철 택시 타던 때가 편히 운전을 하며 다녀도 돌아가고 싶어 난만일 여유로웠다면 서롤 아껴줬을까 헤어지지 않았을까 아님 헤어졌을까 꿈만 같았던 추억은 추억으로 남기고 가끔씩 꺼내어만 볼게 버스 지하철 택시 타던 때를,1,0,-2,7,5
359,사랑은 끝이 이별인 걸까 이별은 준비 없이 오는 걸까 헤어지자는 말이 익숙해서 괜찮을 알았어헤어지기 아쉬워 서로 바래다주던 그날들이 너무 예뻤던 잊지 말아요 사랑했던 순간을 기억해줘요 찬란했던 매일 주고받던 안부도 잘 자란 인사도 이제는 끝인가 봐요 기쁠 땐 웃어주고 내가 아플 땐 안아주던 너무 나도 소중한 날들 잊지 말아요 사랑했던 순간을 기억해줘요 찬란했던 매일 주고받던 안부도 잘 자란 인사도 끝인가 봐요 그댄 어떤가요 미칠 같은데 아무렇지 않나요 지울 수 있나요 행복했던 순간을 잊을 수 있나요 찬란했던 순간 영원할 같던 일상도 순간 모든 날들도 끝인가 봐요,1,0,-2,6,4
360,목소리만 들어도 눈물이 날 같아 아직은 내가 다 버텨낼 힘이 없어 미쳐버릴 같아 변해가는 널 보는 멀어져 가는 맘을 감당하는 차갑게 돌아서도 이별의 말을 해도 알잖아 붙잡지도 못할 나를 서운한 티라도 내면 맘이 힘들까 말 한마디조차 건네는 것도 겁이 아직은 말 하지 말아 줘 내게 조금만 시간을 줘 걸어왔던 시간들이 날 해치지 않게 도와줘 그런 눈빛으로 보지 마 널 잡는 손길도 피하지 마 약속했던 놓아버리지 마 이미 오래된 맘을 말해야 했었는데 눈물에 잠길 널 너무나 잘 알아서 남겨질 맘을 지켜볼 수가 없어서 멀리 돌아온 이해해줘 아직은 말 하지 말아 줘 하지 않아도 내게 조금만 시간을 알고 있잖아 걸어왔던 시간들이 날 해치지 않게 도와줘 그런 눈빛으로 보지 미안한 맘에 잡는 손길도 피하지 약속했던 놓아버리지 우리의 시간은 끝나겠지만 되돌릴 수 없겠지만 아름답게 기억할게 말아줘 내게 조금만 시간을 걸어왔던 시간들이 해치지 않게 도와줘 그런 눈빛으로 보지 잡는 손길도 피하지 약속했던 놓아버리지 목소리만 들어도 눈물이 같아 미안해 놓을 자신이 없어,1,0,3,7,10
361,넌 잘 지내고 있는지 생각이 하는 지난 네가 떠난 하늘을 보며 아무 이유 없이 먹먹하곤 해외 그렇게도 쉽게 날 두고 돌아섰는지 그런 너의 맘은 편했니 아직까지 이해할 수 없어 날아가 버리다 그렇게 넌 먼 곳으로 내가 없는 곳으로 그렇게 넌 그렇게 날아가 버리다 이러는지 쉽게 잊었다 생각했는데 마음에 찾아와서 이렇게 날 흔들고 가는 건지 날아가 버리다 먼 곳으로 내가 없는 너는 멀어진다 곁에 먼 내가 아닌 날아 다니는 날로 날아다니는 날아다니는 날아가는 날아가는 날아가는 날아갑니다 이미 없는데 아파해야,1,0,0,2,2
362,다 그만두자 못되게 말을 던져도 딴청만 피우잖았다 소용없잖았다 괜찮다고 모른 척 웃음 지어도 다 알고 있잖아 사랑하지 않는 걸 미안해 용서 헤더는 후회는 없어좋았던 아팠던 널 사랑했던 그날이 없어다 잊어주라 지워주라 아무 없던 것처럼 서로 몰랐던 것처럼 우연히라도 마주친다면 처음 만난 사람처럼 지나치자 돌아서자 서로 없던 일처럼 잊어주라네 말이 맞아변했단 말이 맞아 아무 예고 없는 갑작스러운 이별에 미안해 미안해 원래 놈이야 원망해 날 미워해우는 널 뒤로 남긴 채 돌아선다다 잊어주라 지워주라 아무 없던 것처럼 서로 몰랐던 우연히라도 마주친다면 처음 만난 사람처럼 지나치자 돌아서자 일처럼 잊어주라 잘 해준 거 없는 놈 뭐가 이리 울어 끝까지 못됐지 꼭 지워주라 내가 준 모든 아픔도 내가 한 모진 말들도 우연히라도 마주친다면 처음 만난 사람처럼 지나치자 돌아서자 일처럼,1,0,3,1,4
363,아무 없이 스쳐가는 하루 흘러가는 구름처럼 아무 없었던 것처럼 잊어버리고 싶어그럴 수만 있다면 누구나 하나쯤은 가지고 있잖아지우고 싶은 괜찮아 다 괜찮아날 위로해도 지워지지 않는 시간을 돌릴 수 있다면 좋겠어 단 한 번만 내가 하는 눈을 감고 잠시라도 두 눈을 감아 잊히기를 아무 없다는 듯이다 괜찮은 척 웃어 보이지만 아주 가끔은 맘대로 뜻대로 되지 않을 때가 있어도 손 모아 하늘에 기도해 오늘이 지나가면 다 괜찮아 지길 기도하는 것이기도 합니다 어두운 밤이 지나가고 내일이 밝아오면 잊히기를 눈을 감고 사라져 버리십시오 시간을 돌릴 수 있다면 좋겠어 단 한 번만 감고 그래요 잠시라도 두 감아 잊혀 지 잊히기를,1,0,3,6,9
364,멀어지는 너를 보면서 한 걸음조차 뗄 수가 없었어 행복했던 추억이 길을 잃은 채 긴 너머로 잊힐까 헤어지자 말하던 마음 되돌릴 수 없겠죠 껌처럼 아무 일도 없던 것처럼 처음 그때처럼 돌아갈 순 없겠죠 친 마음 안고서 너의 곁을 떠날 게나 이렇게 하루 한 달을 버틸 수가 없어지친 나의 가슴에 기대 울어봐도 그렇게 행복했던 순간이 끝이란 걸 그대 따뜻하던 눈빛이 유난히 보고 싶어지면 남몰래 마음속에 숨겨 두었던 그대 그날의 그대를 찾아가도 될까요 지친 마음 안고서 너의 곁을 떠날 게나 이렇게 하루 한 달을 버틸 수가 없어지친 나의 가슴에 기대 울어봐도 그렇게 행복했던 순간이 끝이란 걸 순간들 다시 생각해봤어 그땐 그렇게 사랑했었는데 운명 아닌 우연히 다시 마주한다면 번만이라도 안아봐도 될까 친 안고서 너의 곁을 떠날 게나 이렇게 하루 달을 버틸 없어지친 나의 가슴에 기대 울어봐도 순간이 끝이란 걸,1,0,-1,-2,-3
365,우리를 닮았던 너와 함께했던 그날의 영화 다시 보고 있어 네가 좋아하던 마지막 장면이 첨 본 것처럼 새롭게 보여 나에게 말 하려 했던 건지 이제는 알 같은데 결말인지도 아는데 돌려보는 건네가 내게 하는 말인 같아서 생각하면 그리워지고 너무 아파서 그냥 네가 좋아하는 영화를 다시 보고 있어 네가 좋아했던 장면이 내게 하고 싶은 말이었다면 돌아와 줘 이제 잘할 수 있어 언제나 나에게 좋은 사람이라 항상 말해줬는데 미련 없이 보내주고 싶은데 그게 잘 안돼 너와의 기억이 너무 선명해서 생각하면 그리워지고 너무 아파서 그냥 좋아하는 영화를 다시 보고 좋아했던 장면이 내게 하고 싶은 말이었다면 돌아와 줘 이제 잘할 수 그리워질 때면 떠올라 멈춰있는데 생각하면 그리워지고 미칠 같아서 그냥 좋아하는 영화를 좋아했던 하고 싶은 말이었다면 돌아와 줘 이제 잘할 수,1,0,-2,2,0
366,날 사랑한다는 말 번이나 해줬나요 변치 않는다는 말도 진심인가요 첨엔 나를 좋아한다 했죠 나도 그래요 그댄 나의 꿀 꿀 아기 꿀 베이비 사랑 베이비로 사랑 내게 와줘요 아기 첨엔 나를 좋아한다 했죠 나도 그래요 그대는 나의 아기 베이비 사랑 내게 와줘요 베이비로 내게 와줘요 베이비로,1,0,-1,4,3
367,매일 아침 똑같은 시간에 정류장에 서있는 그대 고개 돌려 눈 마주친 순간 두근거리는 가슴 애써 먼 곳을 바라보면서 콧노래도 불러 보지만 이미 들켜버린 뜨거워진 얼굴 숨어버리고 싶은 기분 그대 일하나요 그대 여자친구 있나요 그댈 조금만이라도 알고 싶은데 이미 사라져버린 버스에 탄 오늘 하루 종일 생각이 아무 일도 손에 안 잡혀 내일 혹시나 그댈 만나면 다시 한번 용길 볼래 이름이 뭔가요 즐겨 듣는 음악 뭔가요 그댈 조금만이라도 알고 싶어요 이미 마음속에 가득 찬 대시 간 있나요 너무 뜬금없는지 두 눈을 깊이 들여다봐요 그대를 향한 나의 진심이 보이나요 노랠 불러요 남자친구도 없어요 우린 좋은 친구가 될 수도 있어요 사람인가요 말해 줘요 조금만이라도 알고 싶어요 시작된 걸까 우리만의,1,0,-2,-2,-4
368,달콤한 초콜릿 무스케이크 새콤한 레몬향 아이스티 온종일 널 위해 준비한 나만의 비장의 무기들 사각사각 네가 눈 속에 밟혀 새록새록 너는 매일 새로워져 모든 걸 빼앗긴 바보는 꿈속에서도 너를 그려다 뜻한 나뭇잎 스웨터 두툼한 파스텔 머플러 겨울이 다 가고 완성해 지금껏 눈치만 보는 사각사각 네가 눈 속에 밟혀 새록새록 너는 매일 새로워져 모든 걸 빼앗긴 바보는 꿈속에서도 너를 그려네 곁에 있어 기분이 둘이라서 기분이 영원히 이대로였으면 소복소복 네가 맘속에 쌓여 사뿐사뿐 너는 맘을 흔들어 모든 걸 빼앗긴 바보는 세상 가득 너뿐이야 사각사각 눈 속에 밟혀 새록새록 매일 새로워져 꿈속에서도 너를 그려,1,0,-1,-2,-3
369,그랬어 가서 차이고 찾지 마 얼굴만 보더니 내가 뭐랬어 이렇게 될 말 들어 뭔 얘긴데 누구를 만나도 맘에 안 드니 뭐가 문제야 맘대로 여자친구가 없지 그만 해 제발 부탁이야 날 언제까지 동생으로만 남자고 너는 여자라고 잔소리쯤은 이겨낼 수 있다고 헤어지는 이유는 한 가지야 처음부터 말곤 없었어 잘난 스펙 봐에 킬로그램 잘 자리 잡은 식스팩 이래도 내가 남자로 안 보여내 특기는 변신술이야 오빠나 동생 친구 뭐 원하면 아빠까지도 솔직히 같은 남자가 어딨어나는 남자고 너는 여자라고 잔소리쯤은 이겨낼 수 있다고 남자고 너는 여자라고 잔소리쯤은 이겨낼 수 있다고 우린 할 거냐고,1,0,1,4,5
370,두근거린 느낌 가슴 설렌 마음 이렇게 멍하게 바라만 어제와 똑같이 널 바래다주면 돌아선 모습에 번이고 고민해 자꾸만 뒤에서 널 바라만 계속 너의 뒤에 서면 용기 있는 멋진 남자 앞에선 쳐다보지도 못해 이제는 걱정 말고 그냥 확 나의 뒤에 서서 망설여 계속 이대로 안을까 말까 안을까 말까 널 오늘은 꼭 따뜻한 가슴에 너를 안을까 말까 너무 망설여져 또네 이건 엄마입니다 보통 뒷모습이 아름다운 여자는 그리 예쁘지 않다고 하던데 넌 어디서 봐도 너무나 예뻐안을까 고민하는 사이 생각을 다 눈치챈 듯이 어느새 멀리 가버린 그대 날 밀고 당기나요 나의 모습 실망하진 않을까 위한 거라고 변명이라도 할까 손잡을 때처럼 그냥 물어볼까 오늘도 수없이 머리가 복잡해 자꾸만 날 보면 방끗 미소를 띠면 준비한 말도 입에서 나오지가 않아 오늘도 이렇게 너를 뒤에서 바라보면 오늘은 아무 생각 말고 그냥 확 나의 뒤에 서서 망설여 계속 이대로 오늘은 꼭 따뜻한 가슴에 너를 너무 망설여져 고민하는 나도 행운이야 같은 여자와 하니까 언제나 할 순 없겠지만 지금 순간은 행복하니까 당신은 행운의 스타입니다 별들은 많잖아 그중에서도 특별한 뭐 말로 표현이 다 안되겠지만 여자 감사합니다 오늘도 이렇게 너의 앞에 서서 널널 향한 마음을 꼭 보여줘 안아 버릴래,1,0,-9,-4,-13
371,걸렸어 널 보는 눈빛이 무심한 척 잘 숨겨왔었는데 땜에 잠도 못 자고 땜에 밤새 설레는데 이제는 솔직히 말해볼래 떨어지는 꽃길만 걷게 해줄게 맘에 쏙 들게 할게 널 알게 된 순간부터 머릿속엔 온통 너뿐이야 항상 널 웃게 해줄게 오랫동안 느껴왔어 누구보다 떨어지는 떨어지는 알겠어 날 보는 눈빛이 너도 바라고 있던 거야 잠 못 들지 마 고민하지도 마 이제는 너만 바라볼게 괜찮은 꽃길만 걷게 해줄게 맘에 쏙 들게 할게 알게 된 순간부터 머릿속엔 온통 너뿐이야 항상 웃게 오랫동안 느껴왔어 누구보다 꽃길 만 걷게 길을 걸을래 매일 설레게 할래 알게 된 순간부터 말하지 못한 아껴왔던 말 꽃길만 오랫동안 꿈꿔왔어 누구보다 꽃길 위를 걸어가는 베이비 베이비 베이비,1,0,-1,4,3
372,너무 아파서 사랑해예쁜 너를 위한 노래 이거 러브 송이 노래의 노래의 노래 넌 괜찮아 부사랑은 달콤 쌉쌀해 넌 나를 밀어내 어딜 가도 꿀린 적 없어 근데 너에겐 무릎 꿇게 돼 작업도 안 통해 넌 날 모른 척 없는 척해 날 자존심도 없는 그런 남자로 생각하겠지만 아픈데 네가 소녀 좋은데 아파 맘을 몰라넌 제발 내게로 와줘 당신을 사랑합니다우쭈쭈쭈쭈쭈 널 안고 싶어온 추 슈츠 추 여자친구 돼줄래 아름다운 여자를 들어보세요 가서 나도 내가 제일 잘나가 남자가 어딨어 요즘 세상에 어머나 세상에 너무나 속상해 자존심 상하게 딴 데 보는 가야 날 봐줘 맘 받아줘 해바라기 같은 몰라줘 가슴 아픈데 좋은 심리는 뭐야 사랑해네 여자 친구가 되세요 나에게 눈길도 안 주는 보는 척 마는 척해 그런 상관없어 결국엔 너는 거 될 테니까 아픈데 네가 소녀 좋은데 아파 맘을 몰라넌 제발 내게로 와줘 당신을 사랑합니다우쭈쭈쭈쭈쭈 널 안고 싶어온 추 슈츠 여자친구 돼줄래 당신을 사랑해 꽉 잡고 싶어 뭐래도 좋아난 네가 소녀 영원히 좋은데 아파 맘을 몰라 널 사랑해 사랑해 갖고 싶어져 슈츠 축내 맘 받아 거니 사랑합니다 당신은 사랑합니다,1,0,-3,0,-3
373,옛날 옛적 언니들과 계모에게 몹시 구박받던 그녀 이름 맘도 몸도 착한 신데렐라 날 밤에 무도회 이쪽저쪽 다니다가 왕자님 만나 첫눈에 반해서 사랑에 빠져 버렸죠 주위를 둘러봐멋진 왕자님 공주님 모두들 우리를 축하해요 아직은 어리지만 그대의 존재를 믿어요 단 한 명의 나만의 왕자님을 그대만의 공주 될래요 그대에게 잘 어울릴난 공주가 될래그래 기분 기억하니 항상 하나의 두 줄을 맞춰 걸어가는 착한 난쟁이들과 행복한 백설공주도 사과를 먹고 죽음과 같은 깊은 잠이 백마 탄 왕자 달콤한 키스로 잠자는 공주를 깨워 주었죠 주위를 둘러봐멋진 왕자님 공주님 모두들 우리를 축하해요 아직은 어리지만 그대의 존재를 믿어요 단 한 명의 나만의 왕자님을 그대만의 공주 될래요 그대에게 잘 어울릴난 공주가 될래그래 공주님은 왕자님의 성으로 마차를 타고서 갔고요 둘은 행복하게 살았다죠 인생에 아직은 백마 탄 왕자님은 없지만 어딘가 그대 있겠죠 언젠가는 거 만나게 될 그댈 기다리며 꿈을 잃지 않아 어리지만그대의 존재를 믿어요 단 한 명의 나만의 왕자님을 그대만의 공주 될래요 그대에게 잘 어울릴난 공주가 될래그래 어리지만 그대의 그대 역시 나를 찾겠죠 만날 그날 올 때까지나 여기에 있어봤어,1,0,-7,-1,-8
374,넌 내가 지킨다 어떡해 마법이 풀리질 않아 어쩌다 어쩌다 이렇게 됐니 태양보다 뜨거운 맘 어쩌면 어쩌면 사랑일 거야 당신은 나를 높이 데려가서 나를 너무 높게 날아라 풍선처럼 두둥실 떠올라 맘을 매우 흔들어 놓아난 너의 기쁨 슬픔 다 꼭 끌어안고 너만 알겠어 사랑보다 깊은 감정을 느껴 지금 누구보다 약하면서도 강해그래 운명 따위는 내가 다 바꿀 당신이 나에게 나쁜 말을 할 아기 아기 눈물이 흘러도 닦아줄게 이별 따위랑은 이제 이별해크게 소리쳐 어린 소녀 말로도 어린 소녀 널 꾸밀 수 없어 사랑보다 사랑 같은 당신은 어린 소녀입니다 세상 모든 걸 소녀다 잃는다 해도 운명보다 운명 같은 날 넌 내가 지킨데 넌 지킨다 지킨다 마법이 풀린대도 어쩌다 그럴지라도 태양이 빛을 다 잃는다 해도 날 믿어 날 믿어 우리는 무언가가 될 수 있습니다 꽃잎이 져도 매일 그대 곁에 있을게 시간이 내게 준 지금이라는 보물 너그래 머리부터 발끝까지 내게 기대 전부를 걸겠어 사랑보다 깊은 감정을 느껴 지금 누구보다 약하면서도 강해그래 운명 따위는 바꿀 당신이 나에게 나쁜 말을 할 아기 눈물이 흘러도 닦아줄게 아름다움 앞에 상냥해지는 소리쳐 소녀 말로도 널 꾸밀 수 없어 사랑 같은 당신은 소녀입니다 세상 모든 걸 소녀다 잃는다 해도 운명보다 더는 없어 외로움과 계절을 뛰어넘어온 세상이 너로 꽉 찼는걸 당신과 소녀를 압니다 널 위한 멜로디 소녀목 터져라 불러 큰 사랑 노래야 소녀입니다 세상이 우릴 속일지라도 운명보다 지킨데 지킨데 너만을,1,0,-1,6,5
375,오늘은 얘기해야 될 거 같아 다시 정리할래 너와 나의 관계 너와 보기도 오래 봤지 우린 좋은 친구야 매일같이 붙어 다녔지 넌 식구야 비밀까지 믿고 말할 수 있는 넌 특별하고 소중한 친구야 친구라 서로 기대고 때로는 취해 치대고 서로의 기대에 못 미쳐 어어 가끔 삐대고 그렇게 넌 모든 걸 다 알았지 하나만 빼고 그동안 꾹 참았지 참고 참았지 말하려다 말았지 널 생각하는 마음은 우정과는 달랐지 혹시나 사이 멀어질까 착각이라고 날 속이면서 살았지 애달프고 닳았지 맘은 겉은 웃지만 힘이 들어 안은 날 똑바로 봐야 이제 네게 얘기를 하고 싶어 주변에서 중심으로 가고 싶어 이제는 말하고 싶은데 여태 있는데 아마 겁이 네가 떠나갈까 곁에서 곁에서 맴돌고만 있어 사실 질투가 났었어 남자와의 연애상담해줄 잘 안되길 바랐어 때론 밤잠도 설쳤어 나도 연인처럼 낮이 아닌 너의 밤을 갖기를 바랐어 너와 걸을 땐 손을 잡고 싶었어,1,0,-3,2,-1
376,날 바라보는 너를 느끼 듯이 네가 남긴 향기엔 그런 느낌이 있지 눈을 감아도 다 보이는 너의 오늘 하루 종일은 내가 없이도 그리도 아름다운지 날 울리는 널 버리는 슬픈 얘긴 하지 마요 둘이 홀로 아름답도록 세상에 날들은 너의 밤들은 같은 끝을 보고 있죠에 기 애호가 눈을 감아요 포기 포기 당신은 빛을 봅니다 안에서야 마음이 그리도 헤맸지만 길을 찾았지 아침에도 함께라면 세상 하늘을 다 끌어안고 모두에게 기쁨을 선물할 텐데 날 울리던 널 버리던 슬픈 얘긴 하지 마요 둘이 홀로 아름다웠던 세상에 날들은 너의 밤들은 같은 끝을 향해있죠에 기 애호가 잠이 들어요 손을 잡고 손을 잡고 긴 잠에 빠지고 긴 잠에 빠지고 편하게 몸을 편하게 몸을 맡기면 돼 맡기면 돼 가슴 아픈 사랑은 이제 그만 널 품고 잠이 들고 싶어 오일 수 있어 네가 원하는 모든 불난 너에게 주고 싶어 오이 밤이 남긴 것은 사랑을 믿는 것뿐 순간 우릴 덮는 슬픔과 깊은 어둠 바라면 돼 바라면 돼바라면 바라면 잘 하면 사랑하는 나라면 돼향기로운 숨결이 내게 닿을 때란 조용히 손을 잡고 눈을 감을래느껴봐 너와 이제 바람이 모던 자유로워 그게 사랑일 울리는 버리는 슬픈 얘긴 하지 마요 둘이 홀로 아름답도록 세상에 날들은 밤들은 같은 끝을 보고 있죠에 기 애호가 감아요 울리던 버리던 아름다웠던 향해있죠에 잠이 들어요 포기 당신은 빛을 봅니다,1,0,-4,-1,-5
377,예쁘네 오늘도 어제만큼 오늘은 예뻐졌네 말을 할 때마다 너는 못 들은 척 늘 딴 얘기를 해의 젠 너무 좋은 꿈을 꿨어 지금 말해주긴 간지러워서 말하기 싫어 건 말하면 안 된대꿈다신 꾸지 못하는 너무 기분 좋은 꿈 네가 꼭 그런 거 같은데 꿈 종일 아른거리는 너무 기분 좋은 꿈 그게 잘 어울린 대나는 그녀가 알고 있다는 것을 안다 사실 내가 봐도 근데 가끔 불안한 기분이 땐 혼자서 울적해 흠 거짓말 마 그렇게 있는 얼굴을 하고 있으면서 듣기엔 좋다 그렇긴 하네 대신 꾸지 못하는 기분 네가 꼭 그런 거 같은데 종일 아른거리는 그게 너글쎄요 당신이라면 달콤한 거짓말 내가 하지 않는다 당신을 믿게 만들 것입니다 지금 그런 눈으로 나를 바라볼 때면 네가 꼭 같은데 다시 잠들고 싶은 그게,1,0,2,8,10
378,깨끗한 느낌 내게 보여준 싱그러운 아침 햇살처럼 상큼한 그대만의 향기가 가슴속에 스며드는데 숙녀 하얀 작은 손을 가진 그대여 가슴 설레게 해 숙녀 따스한 눈길로 나를 보면서 웃어줄 순 없겠니 그대의 귀여운 작은 입술 포근히 느껴지는 환한 미소 긴 밤을 지새우고 싶다고 얘기할 용기가 나질 않아 숙녀 하얀 작은 손을 가진 그대여 가슴 설레게 해 따스한 눈길로 나를 보면서 웃어줄 순 없겠니 하얀 손을 가진 그대여 가슴 설레게 해 따스한 눈길로 나를 보면서 웃어줄 순 없겠니 오늘은 어쩐 일일까 그대가 보이질 않아 가슴은 초조해지고 떨리는 두 손 어떡하나,1,0,-6,-6,-12
379,준비하십시오 내가 준비했어 베이비 당신은 준비되어 있습니까 지금 나와 어디든 가자 지루한 하루 여기까지만 정지 작은 가방 운동화 챙겨 크게 라디오를 높이고 코발트블루 물결 눈부신 바다 달빛 가득 묻은 작은 섬이 야경이 눈부신 도시는 함께라면 어디든 너와 그곳으로 떠나는 거야 상상에 상상에 상상을 더해서 어머 깜짝이야 눈부셔 눈부셔 눈부셔 이건 뭐 안녕하세요 새로운 세상도 손 모아 소리치면 푸른 하늘이 내게로 날아가볼래 상상의 상상의 미래로 가볼까 바람을 타고 새로운 눈빛에 가슴이 붐 붐 붐이 발견했어 우리들만의 파라다이스 흑백영화 같은 하루에 레몬 터지듯 짜릿함이 필요해 지금 널 데려갈게 꿈꿔오던 사진 속 그곳으로 민트 그린 빛 바람 가득한 숲속 달콤한 향기의 칵테일 지도를 벗어나 꿈에 대한 티켓 함께라면 어디든 너와 그곳으로 떠나는 거야 상상에 상상을 더해서 어머 깜짝이야 이건 뭐 안녕하세요 새로운 세상도 손 모아 소리치면 푸른 하늘이 내게로 날아가볼래 상상의 미래로 가볼까 바람을 타고 눈빛에 가슴이 붐 발견했어 우리들만의 파라다이스 나와 나의 비밀스러운 풍경들언제라도 다시 주겠니 은하수 아래 밤새 부른 노래 영원히 잊지 않을 거 속에 영원히 품에 안기고 싶은 걸 단둘이 순간 잠들고 싶은 걸지도 엔 없는 이곳을 꼭 기억해줘 우리들만의 파라다이스 상상을 더해서 어머 깜짝이야 이건 뭐 안녕하세요 세상 처음 만난 세상 속에 나의 가슴이 라 라 라 날아가볼래 미래로 가볼까 바람을 타고 눈빛에 붐이 발견했어 만의 준비하십시오 내가 준비했어 베이비 당신은 준비되어 있습니까,1,0,-2,3,1
380,나랑 결혼해줄래 나랑 평생을 살래 둘이 알콩달콩 서로 사랑하며 닮은 닮은 낳고 천년만년 아프지 말고 살고 싶은데 솔직히 말해서 내가 널 좋아해 남자와 여자 사이에 그게 좋다고 하던데 내가 사랑할게 내가 아껴줄게 눈물이 나고 힘이 때면 아플 때면 아파할게 평생을 사랑할게 평생을 지켜줄게 너만큼 좋은 사람 만난 걸 감사해 매일 너만 사랑하고 싶어 나랑 결혼해줄래 매일이 매일이 행복에 겨워서 괜스레 내일이 기대되는 사람 이리 이리 떨리는 걸까 보고 봐도 내겐 제일인 사람 검은 머리 파뿌리 될 때까지 우리들의 생이 다 끝날 때까지 손에 물은 묻혀도 눈에 눈물 절대 안 묻혀 넌 나의 반쪽 가슴 너의 반쪽 가슴 되어 숨을 쉬는 순간순간 널 사랑해줄게 시간이 지나서 주름이 늘어나도 꼭 지금처럼 너와 영원히 할 거야 사랑할게 아껴줄게 눈물이 나고 힘이 때면 아플 아파할게 지켜줄게 너만큼 좋은 만난 걸 감사해 매일 너만 사랑하고 싶어 너는 어두웠던 삶을 밝혀주는 빛 보글보글 찌개 소리로 반겨주는 집 메말랐던 마음에 내려주는 비 사랑이란 열매가 담겨있는 시 하늘이 정해준 운명의 끈 너와 나의 만남은 천생연분 세상을 다 준대도 바꿀 수 없는 삶엔 평생 너뿐 사랑할 아껴줄게 눈물이 나고 힘이 아플 아파할게 사랑할 지켜줄게 너만큼 좋은 만난 걸 감사해 매일 너만 사랑하고 싶어나랑 결혼해줄래,1,0,-12,-2,-14
381,인생은 노래와 같습니다 매력쟁이 린과 맥몽또 협업 너만을 생각하면 하루 꼬박 밥을 안 먹어도 너무 사랑이란 건 원래 도박 정신이 나갔나 너무 분명 사랑에 빠졌어요 당신에 대해 생각합니다 내가 이럴 수는 없어요 밥을 먹다가도 보다가도 괜히 마음이 찡해져요 가슴도 내가 이럴까요 내게 주문을 걸어 논 거죠 그대가 떠올라요 마음을 간지럽혀요 사랑이 내게 왔나 봐요 생김새는 몽을 닮았고 몸매도 그리 좋진 않지만 보면 볼수록 매력쟁이몽이면 매력쟁이나에게 올인 해봐 나에게 줘 주문을 걸어 줘봐 부리디 밥 박 뭐든지 필요하면 물어봐 당신의 발에 일어서십시오 너와 뗄 수 없는 하나의 빛 그대 고백은 짜릿해우린 너무 비슷해 눈엔 하트가 만개 사랑은 뜨겁게 노래 부르면서 사랑에 빠졌어 이제 손을 잡아줘요 늘 감사해 당신의 발에 일어나서 발에 일어나서 일어나 눈을 봐요 그대 생각을 읽어요 지금 내게 키스하겠죠달콤해요 두 사람 생김새가 몽을 닮아도 몸매 역시 그리 좋진 않아도 사랑해 내겐 멋진 그대여 당신은 아름다워서 당신이 아름다워라는 것을 몰라 노래가 끝나도 우리는 영원히 할 거야 넘어질 수 있습니다 맘을 받아줘 사랑해 내겐 멋진 그대 생각을 읽어요 지금 키스하겠죠달콤해요 두 사람 생김새가 몽을 닮아도 몸매 역시 그리 좋진 않아도 사랑해 내겐 멋진 그대여 널 당신은 아름다워서 당신이 아름다워라는 것을 몰라널 당신이 넘어질 수 있다고 생각합니다 맘을 받아줘 매력쟁이 린과 맥몽또 협업,1,0,-9,1,-8
382,널 기다리던 밤처럼 길고 어둡던 사이 공백이게 끝이 아니길 바라나는 돌아가길 원한다네가 원하던 거 다 고친 지금에야 넌 어디로 갔는 지난 홀로 남아 외로운 오늘따라 부는 바람도 시린 같은데 넌 이리 멀쩡해 보이는 건지 눈치도 없는 너지만 예전처럼만 웃어주면 대 나에겐 하나뿐인 걸어 땜에 아파하는 걸 널 잊으려고 노력해봐도 잘 안돼널 미워하는 건 추억 속 너에겐 못된 일이라 할 수가 없어이렇게 널 그리워하는 날 알고 있는지 나에겐 하나뿐인 걸어 땜에 아파하는 걸 잊으려고 노력해봐도 잘 안돼널 미워하는 전 너무 열심히 너무 어려워날 몰라주는 너도 서러워나는 공식적으로 공식적으로 그리워서 당신을 그리워하고 공식적으로 그리워요 너와 내가 친구 사이로 남아 삶이 진부 하게만 느껴져 실이 빠진 진주 가벼운 티슈 간에 은 없을 거야 넌 아무 느낌도 안 나겠지만 없는 밤이 긴 혼란스럽겠지나 역시 옆구리 시린 그냥 샌들 지루한 스캔들 안티팬들이 되버린니 주위 사람과 불리한 게임을 하기도 전에 위에를 쳤지만 그냥 고통스러워요 사랑 노랠 들어도 멜로디가 있는 곳 행동 하나하나 다 외로움이 돼 당신을 그리워합니다 날 떠난 너지만 아직 날 괴롭히네 나에겐 하나뿐인 걸어 땜에 아파하는 걸 잊으려고 노력해봐도 잘 안돼널 미워하는 건 추억 속 너에겐 못된 일이라 할 수가 없어이렇게 그리워하는 알고 있는지 걸너때매 안돼 건 너무 어려워 몰라주는 너도 서러워 당신을 그리워합니다,1,0,9,7,16
383,네가 필요해 가만히 눈을 감고 있어도 생각나죠 그댄 내게 뜬구름 같은 걸 사랑이란 말로 아직 부족한가요 맘이 위험한가요 그댄 내게 전부가 됐네요 같은 길을 걷고 같은 꿈을 꾸고 혼자만 몰래 상상을 하고 그대 곁에 잠든 연인 그대와 모습 베이비 사랑해 당신이 필요해수줍은 나의 고백 오랫동안 몰래 숨겨왔던 노래난 네가 필요해 순진했던 고백 너도 좋다면 가까이 다가와난 네가 필요해울리지도 않는 전화기를 보게 되죠 그댄 내게 기분 좋은 기대 걸 하루만 기다리면 답이 올까요 고백할까요 한 걸음만 다가와 줘요 길을 걷고 꿈을 꾸고 혼자만 몰래 상상을 하고 그대 곁에 잠든 연인 그대와 모습 베이비 사랑해 당신이 필요해수줍은 나의 고백 오랫동안 숨겨왔던 노래난 필요해 순진했던 너도 좋다면 가까이 다가와 당신이 필요합니다 당신만이 필요합니다 나의 인걸요 당신을 그리워합니다 당신과 사랑에 빠졌습니다 오늘도 내일도 필요해수줍은 오랫동안 숨겨왔던 노래난 순진했던 너도 좋다면 가까이 다가와 필요합니다 수줍은,1,0,0,-7,-7
384,기억 속에서 간단한 소극 아침은 토스트와 차를 타고 가져가서 사랑의 사랑이 나에게 끔찍한 일보다 화려하다고 생각했을 사랑이 갑자기 나에게 갑자기 나에게 갑자기 사랑의 운명이 지연되었을 사랑의 운명에 대한 불쾌감을 느꼈다는 생각을 했을 행복하다고 생각할 기억 속의 간단한 송 날 아침은 토스트와 차를 타고 가져가서 사랑이 행복하다고 생각할 것입니다 위해 노래는 내가 어두운 조용한 방에 앉아있는 시대입니다 토스트와 차는 행복하다고 생각했다 당신은 당신이 나의 하나이고 유일한 사람이 될 것입니다 모자 노래를 꿈꾸고의 이야기를 위해 노래를 부르며 기억 속에 간단한 노래가 가득 찬 마음으로 가득 차서 차를 타고 가져가라는 행복하게 행복하게 생각한다,1,0,-5,-2,-7
385,너는 웃겨 이러는 거 보면 내가 뭐가 좋다고 옆에 있는 걸까 아무것도 없는 남잔데 나를 믿어주는 네가 너무 예뻐멋지게 꽃다발을 주는 법을 몰라 따뜻하게 말 건네지도 않아 미안해 연애라는 것에 익숙하지 못해 사실은 어떡해야 할지 몰라 요즘 무척이나 지쳐 보인다고 남자는 축 처지면 절대 안 된다고 혼자서 중얼거리다 요리책을 맛없어도 다 먹으라고 투정 부려내 작은 기침에도 큰일 것처럼 허둥거리다가 어느샌가 내밀어 뭐 하러 약은 챙겨 필요 없어나는 사랑하는 하나만 있으면 돼 널 사랑 해저 뜨거운 태양만큼 눈부신 하늘만큼 빛나는 별빛처럼 언제나 반짝이고 있어널 사랑해 드넓은 바다만큼 시원한 파도만큼 해맑은 아이처럼 언제나 미소 짓고 있어널 사랑해 담배를 예전보다 줄여야겠어 이제는 술도 마셔야겠어 밤늦게 어디에서 뭐를 하냐고 그런 잔소리까지도 너는 너무 예뻐 누가 나를 챙겼을까 이렇게 행복하게 웃어볼까 되는 대로 살았겠지 네가 언제나 고마 워니가 있어줘서 내가 잘 할게 별 볼 없지만 표현도 못 하는 바보 같은 나지만 절대로 돌아서는 일이 없게 눈에서 눈물 흘릴 일도 없게 숨소리 하나도 귀를 기울이고 작은 거 하나까지 내가 신경 쓸게 지금처럼만 곁에서 약속해 평생을 지켜줄 테니까 널 사랑 해저 뜨거운 태양만큼 눈부신 하늘만큼 빛나는 별빛처럼 반짝이고 있어널 사랑해 드넓은 바다만큼 시원한 파도만큼 해맑은 아이처럼 미소 짓고 사랑 해저 드넓은 바다만큼 시원한 파도만큼 해맑은 아이처럼 미소 짓고,1,0,-9,3,-6
386,키가 작아서 하이힐만 고집하는 피곤한 삶에 손을 건넨 사람 눈이 작아서 진한 라인 그려 넣은 부자연스러운 눈 속에 따뜻한 눈길 건넨 사람 사뿐사뿐 살짝살짝 편 한 맘으로 너에게 갈 거야 오늘도 질리지 않는 사랑 거야 자꾸자꾸 듣고 싶은 음악 같은 사랑을 들려줄게 시간이 다시 듣고픈 목소리로 노랠 불러줄게 내가 소심해 먼저 고백할 수 없어수줍어하는 두 볼에 싱그런 입술을 준 사람 사뿐사뿐 살짝살짝 편 한 맘으로 너에게 갈 거야 오늘도 질리지 않는 사랑 자꾸자꾸 듣고 싶은 음악 같은 사랑을 들려줄게 시간이 다시 듣고픈 목소리로 노랠 불러줄게 너의 손길 너의 눈길 영원히 훔쳐버릴 소곤소곤 몰래몰래 너의 귀에만 속삭여 누구도 비밀을 듣지 못하게 자꾸자꾸 보고 싶은 영화 같은 사랑을 보여줄게 시간이 기억하고픈 추억만 가득 만들어 사뿐사뿐 살짝살짝 편 한 맘으로 너에게 갈 오늘도 질리지 않는 사랑 듣고 음악 들려줄게 다시 듣고픈 목소리로 노랠 불러줄게,1,0,1,2,3
387,사랑의 롤러코스터 날 올렸다 내렸다 사랑의 롤러코스터 타고 싶어서 사랑을 찾아서 떠나요 장미 밭을 지나야 지나겠어요 꽃의 향이 날 안아 뽀뽀하네요 더운 날이 온대도 상관없어요 사랑이 좋아요 힘들 거 알지만 사랑을 찾아서 떠나요 사랑의 롤러코스터 날 올렸다 내렸다 타고 싶어서 사랑을 찾아서 떠나요 장미 밭을 지나야 지나겠어요 꽃의 향이 안아 뽀뽀하네요 더운 날이 온대도 상관없어요 사랑이 좋아요 힘들 거 알지만 올렸다 내렸다 타고 싶어서,1,0,-5,-5,-10
388,해야 할지 몰라웃질 않아도 아름다워 바라만 봐도 너무 죽겠네 코를 골아도 듣기 냄새가 나도 향기로워 씻지 않아도 너무 빛이 나서 죽겠네 이러다 미쳐 돌아 버리면 어쩌나 이러다 진짜 숨이 덜컥 멎으면 어쩌나 그대의 눈가에 눈곱이 내게는 그대의 스타킹 뜯어진 구멍도 너무 멋져요 멋져 요일분 일초가 보석 같아싸울 시간이 나질 않아 사랑만 해도 시간이 모질라서 죽겠네 이러다 미쳐 돌아 버리면 어쩌나 진짜 숨이 덜컥 멎으면 그대의 잇몸에 김가루 내게는 멋져요 가슴이 충분치 않아도 멋져요 좋아어떻게 해야 할지 몰라 웃질 아름다워 바라만 봐도,1,0,-5,4,-1
389,말할 거예요 이제 결혼해요 늦은 저녁 헤어지며 아쉬워하는 그런 일은 없을 거예요 나도 모르게 겁이 나요 꼭 붙어줘 처음부터 시작해요 우리의 당신을 믿을게요 그대에게 반한 같아 말은 안 했지만 너무 멋져 보여요 그대에게 반한 같아 말한 뒤에라도 후회하지 않을게요 두근거려요 마음으로 안아줘요같이 살아가면서 부딪치고 힘들겠죠 걱정 말아요 잘할게요 그대에게 반한 같아 말은 안 했지만 너무 멋져 보여요 말한 뒤에라도 후회하지 않을게요 말할 거예요 이제 결혼해요 늦은 저녁 헤어지며 아쉬워하는 그런 일은 없을 말은 안 했지만 너무 멋져 보여요 말한 뒤에라도 후회하지 않을게요,1,0,3,9,12
390,운명처럼 나를 이끄는 너라는 세계 초대해줘 고마워 사랑받고 싶다 하나부터 열까지 모든 특별해 꿈결만 같아 걱정 마 사라져 버린 것과 비교하지는 마 사랑받고 싶다 놓지 마 이렇게 잡은 두 손을 언제나 너만을 생각해 너를 둘러싼 모든 조금씩 버거울 이게 맞는 길인지도 가끔씩 헷갈릴 널 믿어도 돼 눈을 감고 한 걸음을 떼 너라는 자체만으로 좋으니까 그것 운명 지켜줄게 끝까지 생각해봐 모든 건 우연이 아냐 소중한 것은 너야 그것 운명 지켜줄게 끝까지 무언갈 넘어 높이 높이 날아 전부를 할게 그것 운명 오전 부를 할게 오이 건 우연이 아냐 소중한 것은 너야 푸른 달 타고 우주를 너와 날아 오른쪽 수많은 별들도 우릴 반겨와 비치는 건 태양 같은 너야 점점 끌려가 허공에 허우적대며 제자리걸음일 자욱하게 낀 안개가 눈앞에 펼쳐질 널 믿어도 돼 눈을 감고 한 걸음을 떼 너라는 자체만으로 좋으니까 지켜줄게 끝까지 생각해 우연이 아냐 소중한 것은 무언갈 넘어 높이 날아 전부를 할게 오전 부를 오이 아련히 떠오른 순간이 너와 나의 시간이 스쳐가 이미 바라오던 날들이 현실이 돼가 생각해 무언갈 넘어 이것은 운명입니다 전부를 오더 선명하게 오전 부를 온 자신이 되십시오,2,0,-4,5,1
391,네모 안에 갇힌 사람이야 어딘지 모를 끝을 향해 계속 나아가야 해 열심히 올라가야 해 밤을 새워 오늘은 끝내야 해 포션을 먹고서 오늘 밤을 두 배로 늘려 내일의 잠을 빌려와 내가 선택한 맵 쉽지가 않아 아이템도 먹기가 쉽질 않아 레벨업도 뜻대로 되질 않아 어떡해야 게임 하듯이 살고 있는데 퀘스트 깨듯이 피아노를 치는데 홈 코인도 안 놓치고 먹고 있는데 아무래도 판은 별로야 오늘도 열심히 일을 하네 누가 시키지도 않았는데 배워야 할 건 많고 계속해서 스킬을 익혀야 지름길이 있다면 누가 알려줘 내가 선택한 맵 쉽지가 아이템도 먹기가 쉽질 레벨업도 뜻대로 되질 어떡해야 게임 하듯이 살고 있는데 퀘스트 깨듯이 피아노를 치는데 홈 코인도 안 놓치고 먹고 아무래도 판은 별로야 게임 하듯이 살고 퀘스트 깨듯이 피아노를 치는데 홈 코인도 안 놓치고 먹고 아무래도 판은 별로야,2,0,0,0,0
392,초록 창가 사이 꽉 채워진 무지개 빨주노초파남보 구름 위 둥실둥실 초록 창가 틈새로 날아온 편지지 동쪽 섬 불어온 바람 타고 둥실둥실 날아가 버리다 손가락 끝에 닿는 멜로디를 잡고 흘러나옵니다 발끝을 적시는 파란 물결을 타고 좁고 멀고 험해 네가 가고자 걷는 길은 맘 뜻대로 안 돼 속상하지 네가 알아서 다 할 텐데 뭐가 그리 걱정 불안 불만 의심투성이들인지 믿어줬으면 하지 너의 방은 그렇게도 지저분해 햇빛 한 줄기 들어오지도 않는 쾨쾨한 곳에서 꿈을 꾸밀 계획이었어 남성 알고 싶어 합니다 간절히 원하면 이뤄내리라는 별말도 안 될 소린 누가 지어냈을까 해도 두 손 모아 기도 모르게 너에게 다가가 발자국 소리도 못 듣게 날아가 푸르스름한 손길로 너에게 행운을 빌어줄게 믿어봐 초록 창가 사이 꽉 채워진 무지개 빨주노초파남보 구름 위 둥실둥실 틈새로 날아온 편지지 동쪽 섬 불어온 바람 타고 날아가 버리다 손가락 끝에 닿는 멜로디를 잡고 흘러 나옵니다 발끝을 적시는 파란 물결을 타고난 포기하지 않아 누가 뭐래도 근심 갖지 않아 삼각지 말아 남들이 말하는 앞선 추측에 너의 나가야 할 곳은 환한 밖인 걸 네가 나와야 모든 세상이 바뀌어 뻥치고 있네 이미 속을만큼 속았어 성공한 자들의 성공 후에 과장된 성공담은 이미 불을만큼 불었어 팅팅 큰 코 다 깨지고 낙담한 지 오래인 걸 시간은 계속 떨어지는 모래인 걸 누가 내게 진실을 말해줘 나를 믿고 싶어 광활한 들판에 널 감싼 거짓말 털털 털어 고민 같은 건 민들레 꽃 접시 위에 덜덜 덜어 알고 싶어 합니다 간절히 원하면 이뤄내리라는 별말도 안 될 소린 지어냈어도 한 번 나를 믿어줘 틈새로 날아온 편지지 동쪽 섬 불어온 바람 사이 꽉 채워진 무지개 빨주노초파남보 구름 위,2,0,5,2,7
393,점점 멀어져 갈 오늘은 두 번 다시 돌아오지 않는다고 헛된 꿈이라도 소중하기에 다시 일어서라 말해 나에게 작은 별들도 너의 길을 밝혀 벗이 돼 테니 거친 바다 위 품에 안겨서 힘껏 노를 저어야만 한다고 사람들은 말하지 꿈이라는 건 이뤄질 수 없는 현실이라고 시간이 갈수록 멀어져만 간다고 워 세상이 다 다 너를 비웃어도 앞만 보고 달릴 수밖에 먼 훗날에 웃을 너를 위해 힘겨워질 때면 맘껏 울어도 다 괜찮아 고작 가진 젊음이지만 세상 모든 걸 가진 거니까 항상 너의 곁에 내가 있을게 사람들은 말하지 꿈이라는 건 이뤄질 수 없는 현실이라고 시간이 갈수록 멀어져만 간다고 워 세상이 너를 비웃어도 앞만 보고 달릴 수밖에 두렵고 외로울지라도 힘을 당당할 너의 꿈 꿈속으로 이제 다시 시작,2,0,3,-3,0
394,할 수 말해요 이유는 묻지 말고 그렇게 다짐해요 자신감은 의심하지 말아요 할 수 말해요 안 돼요 최선은 나의 선택 그렇게 외쳐봐요 불안한 맘 할 수 있어요 말해요 새날은 나의 희망 어제보다 값진 선물이 될 테니까 라 랄랄라 언제나 기다림은 내일 보다 멋진 오늘을 테니까 포기하지 말고 웃음 잃지 말고 나와 함께라면 있어요 걱정하지 돌아보지 함께라면 라 랄랄라라 안 돼요 최선은 나의 선택 그렇게 외쳐봐요 불안한 맘 있어요 새날은 희망 어제보다 값진 선물이 될 테니까 라 랄랄라 언제나 기다림은 내일 보다 멋진 오늘을 포기하지 웃음 잃지 나와 함께라면 걱정하지 돌아보지 랄랄라라 포기하지 웃음 잃지 나와 걱정하지 돌아보지 랄랄라라,2,0,0,-11,-11
395,아직도 잘 모르죠 인생이 건지 어딜 향해 가는지 혹 가고 싶은 곳을 알고는 있는 건지 알고 있죠 아픈 건지 어떨 편안한지 날 안아 준 품이 따뜻한지 애써 말하지 않아도 되는 배우지 않아도 이미 다 알고 있는 그걸론 모자란 거라면 이제 누가 내게 가르쳐 주나요 누구도 알 수 없는 그런 인생일지 몰라도 어쩌면 우는 것도 웃는 것도 왠지 별다를 같지 않아요 너무 많은 걸 생각하지 않기 때로는 슬퍼도 안 그런 척 웃어 보기 대단치도 않은 일들이 가끔은 나에게 큰 힘을 주죠 아직도 아이처럼 세상을 모르는지 몰라도 어쩌면 우는 것도 웃는 왠지 별다를 같지 않아요 먼 곳을 바라보기 스스 롤 믿어주기 나도 모르는 있는 날 기꺼이 칭찬해주기 누구도 알 수 없는 그런 인생일지 몰라도 어쩌면 우는 웃는 왠지 별다를 같지 않아요 아직도 아이처럼 세상을 모르는지 언제까지 이렇게만 살아갈 수 있다면은 좋겠죠,2,0,-1,-1,-2
396,조그맣던 어제의 나를 설렘이 빛나던 곳을 찾았어 방 한편에 표시해뒀던 키가 나를 넘어 소년이 꿈꾸던 별에 닿을 때까지 안의 작은 행성 은하수에 몸을 싣고 타올라 뜨겁게 큰 빛을 내는 태양처럼 그것을 좋아한다 그것을 원한다 꿈꾸던 모든 그것을 원한다 그것과 자유롭게 날 거야 꿈을 노래하면 눈앞에 펼쳐져 나의 세계 소행성으로 나와 알고 싶어 떠나고 있어 머나먼 여행 끝에 빛나는 모습을 상상하며 실생활 주름 사랑 튀어 올라 높게 높은 오랫동안 바라던 빛을 방황하던 날들도 불어오는 바람에 몸을 맡겨 피어나 찬란하게 자유로운 혜성처럼 좋아한다 원한다 꿈꾸던 모든 그것과 자유롭게 날 거야 꿈을 노래하면 눈앞에 펼쳐져 나의 세계 소행성으로 나와 좋아한다 내가 사랑하는 모든 소원을 빌어 그것과 자유롭게 날 거야 꿈을 노래하면 눈앞에 펼쳐져 나의 세계 소행성으로 나와 갈 준비가 되었습니다 갈 준비가 되었습니다,2,0,-5,4,-1
397,모양일까 밖에 안될까 가끔 내가 내가 보기 싫어질 때가 있어 같은 건 뭐가 될까 어른이 되기는 할까 키만 자꾸자꾸 큰다고 다 어른인 걸까 온통 나를 향한 걱정들 나를 향한 비난들 나를 향한 자책들 내가 날 믿지 않아 항상 사랑받고 싶어서 미움받기 싫어서 날 숨겨왔었지 말이야 나일뿐이야 이대로 괜찮다고 아무 문제 없다고 이제는 사랑하고 싶어 잃지 않도록 마음은 울고 있는데 겉으론 웃고 있는 미워서 입술을 깨물어 모두들 나만 보니까 희망이라니까 언제부터 아닌 누군가의 나였어 하루하루 지나면 하나하나 나을까 시간마저 나에겐 약이 돼주지 못해 싫어한 미워한 잘못인가 말이야 나일뿐이야 이대로 괜찮다고 아무 문제 없다고 이제는 사랑하고 싶어 꿈을 꿔 짙은 어둠 속에서 별처럼 반짝이고 있을 날 찾아 울지 않아 이제 위한 나야 나답게 피어나서 나만의 노래를 부르고 싶어 나일뿐이야 이대로 충분하다고 끌어안으며 이제는 사랑하고 있어 잃지 않도록,2,0,2,-1,1
398,아른아른 아지랑이 괜히 눈이 부시고 포근해진 얼음은 녹아내릴 것만 같아 동지섣달 기나긴 밤 지나 헤매었던 발걸음 있잖아 까맣고 외로운 날 그때가 기억조차 안 새하얗게 웃던 날을 기억하나요 그대 내가 느낀 모든 걸 너에게 수 있다면 바람아 내게 봄을 데려와 줘 벚꽃 잎이 흩날리듯이 시간아 나의 봄에 스며들어 점점 소리 없이 일렁이며 떨고 있는 초라한 맘은 흐르는 물의 연꽃처럼 멀어져 갈 거야 넌 자리에 그대로 아름다워 새하얗게 웃던 날을 기억하나요 그대 내가 느낀 모든 걸 너에게 수 있다면 바람아 내게 봄을 데려와 줘 벚꽃 잎이 흩날리듯이 시간아 나의 봄에 스며들어 점점 햇살에 깜빡깜빡 미끄러지듯이 우린 사르르 루르 사르르 기지개 펴듯 두 벌린 꽃들처럼 그대 꿈도 이에 아무것도 할 수 없을 같은 마음 혼자만 남아 시들지는 않을까 괜찮아 괜찮아 파랗게 피어날 거야 그런 널 기억할 거야 새하얗게 웃던 날을 기억하나요 내가 느낀 모든 걸 너에게 있다면 바람아 내게 봄을 데려와 줘 벚꽃 잎이 흩날리듯이 시간아 나의 봄에 스며들어 점점 햇살에 깜빡깜빡 미끄러지듯이 우린 사르르 루르 기지개 펴듯 두 벌린 꽃들처럼 꿈도 예에,2,0,3,4,7
399,요 조라 토모 다치 요여긴 거긴 구름 뒤에 파라다이스 오늘 기분이 누군가 닿지 못했던 날을 사는데도 말이야 울며 소리를 질러 응한 나를 버려야 해 인생은 거라고 했잖아 거라고 했잖아 아닌 것만 같았어 내가 살아가면서 내가 날 위해 쓴 시간보다 남을 위해 쓴 시간이 날 죽여 요 조라 토모 다치 요여긴 거긴 구름 뒤에 파라다이스 세상은 장마야 하루 종일 비가 나도 데려가 줘 너의 파라다이스 번을 시도해봤는데 답이 안 나와 대체 뭐야 나다운 어쩌면 인생은 남을 위해 설계된듯해 그래그래그래 이별을 하는 것도 인연을 맺는 것도 모든 무섭고 두렵기만 해 행복할 수 있을까 나를 위한 삶을 살아가며 진짜 웃을 수 있을까 요 조라 토모 다치 요여긴 거긴 구름 뒤에 세상은 장마야 하루 종일 비가 나도 데려가 줘 너의,2,0,0,3,3
400,오랜 기다림 끝이 없는 듯해 내일은 오는데 온 빛과 어둠이 오늘도 반복돼 돌아온 밤 속에 오늘도 너와 바라볼 별 없을 땐 우리의 희망 임을 기억해 너와 순간이 다 지나가면 상승 그리운 추억이 되기를 올려다 본 별은 빛나지 어쩌면 우리는 만질 수 있습니다 나의 시간이 마르지 않아 나의 온몸이 타 들어가도 버티는 열정으로 하루 끝이 가시밭이라 해도 우리들이 흘린 눈물로 기도 피 땀 눈물 그들은 돈을 하지 않습니다 거짓말 고개를 들어 위로 올라와 차고 올라 날아라 계속해서 끝엔 차지할 방식으로 인생 차고 올라 날아라 깊숙이 숨을 쉬십시오 꿈의 보십시오 나의 꿈속에선 가까이 있는 듯해 느낌뿐인데 오너의 날 멀리 보게 해 다가가 볼게 오늘도 너와 마주할 힘조차 없을 땐 우리의 희망 임을 기억해 순간이 다 지나가면 상승 사랑의 추억이 되기를 겁이 난대도 계속 전진해 우리가서뜨겁게 거침없이 노를 저어 다시 항해해 가서 힘차게 내일의 너라서 헤쳐 나갈 수 있어 오늘의 눈물이 우리의 은하가 될 테니 차곡히 쌓여간 모든 시간이 고통 위로 덮여 아름다운 추억돼 빛나리 올라와 차고 올라 날아라 계속해서 끝엔 차지할 방식으로 인생 깊숙이 숨을 쉬십시오 꿈의 보십시오 꿈이란 기억 속에서 이제는 자유로워 우리만이 이룰 수 있는 여정 맘에 찬 바람이 불어도 희망 임을 기억해 순간이 다 지나가면 해돋이 높은 태양의 빛으로 올라와 계속해서 끝엔 차지할 방식으로 인생 깊숙이 숨을 쉬십시오 꿈의 보십시오,2,0,-5,-1,-6
401,행복은 어디쯤에 있나 손으로 만질 수는 없겠지만 눈을 감고 부는 바람을 느껴 시간은 너무 빨리 돌고 늘 제자리에서 맴 맘이 울적할 땐 춤을 추고 노래해 때론 길을 잃고 헤맬 음악에 몸을 맡겨봐 울적할 땐 춤을 추고 노래해 때론 길을 잃고 헤맬 음악에 몸을 맡겨봐 포기하지 마세요 턱을 유지하십시오 행복하십시오 내일은 알 수 없는 미로 때로는 두려울 때도 있지만 하늘을 해가 떠오르고 있어 시간은 너무 빨리 돌고 늘 제자리에 맴 맘이 울적할 땐 춤을 추고 노래해 때론 길을 잃고 헤맬 음악에 몸을 맡겨봐 당신은 잃습니다 친구 한 가지를 기억하십시오 당신이 구름 아래에 있을 음악과 방문하십시오 당신은 잃습니다 친구 한 가지를 기억하십시오 당신이 구름 아래에 있을 음악과 방문하십시오 고개를 들어 하늘을 포기하지 마세요 턱을 유지하십시오 포기하지 마세요 턱을 유지하십시오 행복하십시오,2,0,3,1,4
402,뜨거운 열기 가득한 맘 심장은 뛰고 손에 맺힌 땀 날 수 있을 같아 어둠은 바람에 다 흩어져 세차게 퍼붓던 기억들 멈추면 떠오른 태양이 날 향해 서랍 속 깊은 곳 숨겨둔 용기들 하늘 위로 켜십시오 우리는 올라갑니다 손을 높이 흔들어 멀리 빛나게 새로운 널 위해 워 소리쳐 아픔의 녹아내리고 누군가 부르는 이름 소리 뜨거운 가슴이 두근 데 무거운 세상은 땅 위에 던지고 날아올라 켜십시오 우리는 올라갑니다 손을 높이 흔들어 멀리 빛나게 새로운 널 위해 워 날아봐 높이 우리는 올라갑니다 멀리 빛나게 새로운 널 위해 워 켜십시오 손을 흔들어 빛나는 소리쳐,2,0,-2,1,-1
403,예전 그날의 나를 보면 넌 잘하고 있어 그렇게 말을 해주고 싶어 늘 속상한 날들 불안한 하루 다 눈이 부시게 바뀔 거야 꼭 지금 모습처럼 곳을 가던지 헤매던 길 어딜 가도 똑같이 반복되던 얘기 너무 늦지 않게 너도 다 알게 될 테니 빛나고 있습니다 그것 모든 타이밍 모든 꿈이 이루어집니다 자신을 새롭게 만드십시오널 믿어 꿈은 이루어진다 삶은 아름답다 귀를 기울여 안의 소릴 들어 모든 꿈이 이루어집니다 삶은 아름답다 사랑처럼 느껴집니다 알게 될 거야 사랑처럼 느껴집니다 너야 그래그래 자신과의 경쟁은 없습니다 느낌 전에 잘 하시길 바랍니다 아침에 거울을 쳐다본다 홍채 뒤의 사자를 보십시오 포기하지 말고 너는 너의 뜻대로 가길 오나는 누군지 깊은 고민 믿어야 할 하난 밤이 깊을수록 별은 빛나듯이 때론 보이지 않아도 느낄 수가 있지 분명히 길 끝엔 찾던 답이 있을 테니 빛나고 있습니다 그것 타이밍 꿈이 이루어집니다 자신을 새롭게 만드십시오널 믿어 꿈은 이루어진다 삶은 아름답다 귀를 기울여 안의 소릴 들어 사랑처럼 느껴집니다 알게 될 거야 너야 숨이 차올 때면 앉아서 쉬어도 돼 급할 건 없어 지금처럼 계속 포기하지 않으면 마침내 행복합니다 쳐진 입꼬리를 상하 반전은 미소를 짓습니다 누가 지금 날 멈춰라 맘의 목소리를 따르는 건 작은 걸음이지만 큰 변화야 음지에 겁먹지 말기 불완전해 탓하지 말기 행복한 상상을 매일 하기 매일 제일 중요한 건 자신을 믿기 새로운 느낌 당신의 꿈도 귀를 기울여 안의 소릴 들어 당신을 위한 너야 아름다운 아름다운,2,0,-7,-5,-12
404,어느새 자란 걸까 그동안 잘한 걸까 많은 기억들이 추억으로 바뀌는 과정일 뿐인데 어쩌면 어른이 된다는 건 항상 바라던 모습인데 설렘보다 두려움이 큰 걸까 왠지 네가 멀어지는 것만 같아서 슬퍼진 것뿐이야 소중한 기억들도 다시는 오지 않을 시간일까 너무 두려워진다면 멈춰도 돼 소중한 그때로 다시 되감기 한 걸음씩 내딛다 보면 찾을 거야 널 첨 봤던 그날처럼 되감기 주저하는 가끔 돌아가고 싶다고 많은 추억들이 남겨진 그때에 자리로 왠지 네가 멀어지는 것만 같아서 슬퍼진 것뿐이야 소중한 기억들도 다시는 오지 않을 시간일까 너무 두려워진다면 멈춰도 돼 그때로 다시 되감기 한 걸음씩 내딛다 보면 찾을 거야 널 첨 봤던 그날처럼 없는 텅 빈 방 안에서 가끔 들려오는 소리에 눈을 뜨면 너와 내가 꿈꾸던 속에 널 다시 데리러 너무 두려워진다면 멈춰도 돼 그때로 한 걸음씩 내딛다 보면 찾을 거야널 첨 봤던 그날처럼,2,0,1,0,1
405,어디로 가고 있는지 뭘 원하고 있는지 알지 못했어 괜찮다고 괜찮다고 한참 다독였는데 그게 아닌가 너무 힘든가 별빛이 내린 언덕을 지나 잠이 들면 다 잊힐 거야 아픔도 날엔 밤새 비 내리고 날엔 차가운 눈이 내려도 어느새 이어진 노란 꽃들이 가득 채울 수 있길 잘할 수 없는 걸 알아 파란 하늘도 가끔씩 흐려져 주저앉고 싶을 때면 쉬어도 서두르지 않아도 괜찮을 거야 달빛이 내린 하얀 꿈에서 깨어나면 웃음 짓고 있는 모습이 날엔 밤새 비 내리고 차가운 눈이 내려도 어느새 이어진 노란 꽃들이 가득 채울 수 있길 기적처럼 해낼 있다면 좋겠어 모든 걸 이룰 있게 굳게 닫힌 문이라도 열릴 거란 걸 알잖아 지금까지 잘 해왔는걸 날이 찾아오고 차가운 눈이 내려도 어느새 이어진 노란 꽃들이 가득 채울 있길,2,0,-5,-1,-6
406,끝도 없이 걸어왔어 멀리 웃고 있는 빛을 캄캄한 어둠 속에서 나와 나도 밝게 웃고 싶어서 항상 총구는 위를 향해 나보다 큰 놈을 쏘기 위해 무대 위를 활주로 삼아 도약하며 화려한 비행 타고난 거 없이 꾸준함을 무기로 벼는 익을수록 고개를 숙이고 성장해 어릴 적 방문 앞에 펜으로 그어놓은 검은 선 위로 넘어지고 부딪혀 상처가 나고 가슴이 구멍 나도 우리에게 눈물은 필요 없어 수백 번 쓰러져도 일어나 우리는 올라갈 거야 걱정은 하늘 위로 던져 폭발하다 네겐 우리가 있잖아 일어나라 서로 손을 잡고 위로 들어 손들어 우린 다 이겨낼 거야 우리는에 올라갈 것입니다 하늘로 올라가서 우리는 올라갈 거야 우리는에 것입니다 우리는 꿈꾸지만 잠 자지 않아 성공을 담보로 청춘을 팔아 신발 안에 유리조각 걸음마다 붉은 도장 찍어 오른쪽 우정을 반으로 찢어도 정은 남아 기어코 밟고 오르면서도 밀어줘 개의 손가락 끼고 가다 겁도 없이 올라왔어 위에 반짝이는 별을 쫓아서 어두운 밤하늘에 별처럼 나도 반짝이고 싶어서 좁은 계단 위에 올라 한 걸음 한 걸음이 휘청거리고 무거워진다 해도 우리에게 길 따윈 없어 수백 번 쓰러져도 일어나 걱정은 하늘 던져 폭발하다 네겐 우리가 있잖아 일어나라 서로 손을 잡고 들어 소유 우린 다 이겨낼 우리는에 것입니다 인생은 드라마 지금 순간이 높은 빛 해피엔딩을 바라며 카메라 올라 결국은 똑같아 중요한 건 너와 잃은 것도 이룬 것도 없어 다 올라 걱정은 하늘 던져 폭발하다 네겐 우리가 있잖아 일어나라 서로 손을 잡고 들어 손들어 우린 이겨낼,2,0,2,-4,-2
407,하나쯤 아픈 거 몰라도 되는 되는대로 살아왔었어 그냥 참는 익숙한 일인 걸 가슴 아픈 일이 있어도 괜찮은 척 그냥 웃어 본다 모른다 누구도 맘은 환한 미소 지어 보이며 웃음 짓는다 혼자서 불 꺼진 방에 기대어 오난 눈물을 담는다 친구들과 술자리 안부를 묻는다 이런저런 얘길 나누며 나에게도 작은 꿈 있기는 했었지 시절이 너무 그리워 흐릿하게 추억한다 모른다 누구도 맘은 환한 미소 지어 보이며 웃음 짓는다 혼자서 불 꺼진 방에 기대어 오난 눈물을 담는다 화도 낼 몰랐었던 좋은 사람아 앞만 보며 달려왔지 오늘도 내일도 외로운 밤 오늘도 나에게 주문을 외운다 아무것도 아니라면서 허물을 벗고 혼자서 웃는다 나에게 묻는다 오난 희망을 담는다 거울 속에 이제 안녕 안녕 안녕,2,0,-6,-3,-9
408,아주 멀리 있는 별들의 붕괴와 탄생을 우리가 알아챌 수 없듯이 곁에 있는 서로의 분열과 탄식도 우리는 알아챌 수 없었네 너는 존재하네 짙고 검은 공허 속에서 나의 창백한 푸른 점으로 서로 일으키고 끌어안고 무너뜨리며 나의 창백한 푸른 점으로 빛을 약속된 낙원으론 갈 수 있을까 불타는 숲에 서서 올려다 본 하늘은 푸르지 않아 지진과 해일 무너지는 빙하 폭발하는 분화구 시위와 분노 가난과 질병 아직 우리가 무언가 뭔가 해 볼 있다면 너무 늦었단 건 알고 있어 말하지 마 하지 마 우리는 존재하네 짙고 검은 공허 속에서 하나의 창백한 푸른 점으로 서로 일으키고 끌어안고 다시 무너뜨리며 하나의 나의 빛을,2,0,7,1,8
409,해가 질 때쯤을 아침으로 부르고 나서 하루는 내게만 짧아 누가 나이를 물으면 어색하기만 시간은 점점 빨리 가는 걸까 아무것도 한 없는데 같은 하루를 맴돌다 후회하곤 해 조금만 자고 나면 괜찮아질지 몰라 이대로 잠들까 해 안녕 내가 날아갈 수 있습니까 느려도 괜찮아 바쁘게 헤매봐도 그대로인데 언젠간 너도 알겠지 지금이 아니어도 돼 돼 누군가 던지듯 쉽게 말하곤 했지만 나를 기다리진 않아 괜히 가고 싶어지는 건 일까 누가 맘에 돌을 던진 거야 아무것도 한 없어도 같은 자릴 찾으려 애써보곤 해 조금은 쉬어가도 아무렇지도 않아 언제나 그랬던 것처럼 내가 날아갈 수 있습니까 느려도 괜찮아 바쁘게 헤매봐도 그대로인데 언젠간 너도 알겠지 지금이 아니어도 돼 당신은 날 것입니다 날 밤에서 찾지 않아도 소중한 건 변하지 않아 잊지 않는다면 언젠간 너도 알겠지 잘하지 않아도,2,0,1,-1,0
410,벌써 어른이 됐나 이다음에 커서 뭐가 될까 고민했는데 아직도 가슴속에 숨 쉬고 있는 작은 파랑새 무덤덤한 표정으로 아픔을 이겨내는구나 많이도 고생했구나 어느새 우리는 커서 둥지를 날아가지 새하얀 구름을 벗 삼아 가끔은 그리울 때가 지나간 못 돌려도 그림자처럼 자그마한 목소리로 소년이여 겁내지 말아요 가랑비에 어둠이 스며들고 속절없이 모든 무너져도 시절처럼 아주 강한 목소리로 소년이여 겁내지 말아요 시간이 많이 흘러서 할아버지가 된 후에도 그리워할까 아직도 가슴속에 숨 쉬고 있는 작은 파랑새 소년이여 안녕,2,0,4,2,6
411,맘속엔 어린아이가 있어 오늘도 어려운 하루야 반대로만 가는 너와 좀처럼 좁혀지지 않아 매일 더욱 더욱 더욱 매일 내겐 모던 것이 차갑지만 오네가 있어 외롭지 않아 어린애 같은 있는데 어디에 숨어 버렸을까 슬픔보다 찬란한 매일 너에게 괜찮아 너의 세상은 지금의 그대로 소중하고 소중해서 나와 있어 어른스럽게 웃어넘긴 뒤에 어린애같이 울 때에도 우린 닮았어 함께해 너의 모습 그대로 어른 아이처럼 때론 시간을 낭비해봐도 철이 없다고 그런 너의 모습에서 나를 발견해 넘어지는 내일도 무섭지 않아 함께라 눈물이 두렵지 검게 덮혀진 세상 위로 새하얀 마음을 덧칠해줘 어린애 같은 있는데 어디에 숨어버렸을까 슬픔보다 찬란한 너에게 괜찮아 세상은 지금의 그대로 소중하고 소중해서 나와 어른스럽게 웃어넘긴 뒤에 어린애같이 울 때에도 우린 닮았어 함께해 모습 어른 아이처럼 어른 아이처럼 숨겨진 우리의 슬픔마저 사랑하자 괜찮아 세상은 지금의 소중하고 소중해서 나와 훌쩍 커버린 모습으로 살아갈 내일도 우린 닮았어 함께해 모습,2,0,5,-6,-1
412,요즘 잘 지내는 중이야 좋은 사람들과 하고픈 거 하며 살아 폰은 꺼놨어 미안 비행 중이야 그냥 방해받고 싶지 않아서 여행 중이야 보고 싶었어 지나가버린 시간이 아까워서 어쩔 때는 다시 돌아가 보고 싶어 지나가는 시간이 아쉬워서 움직여야 한다더니 나아진 나로 아직 어른이 되기엔 부족해 나란 사람은 잘 하고 있는 건지 모르겠어 나를 아직 어린앤데 그냥 옛날로 돌아가고 싶어 아니아님 지금에서 멈추고 싶어 날 좋아하는 사람들을 지키고 그렇게 점점 자라고 있어 가끔은 바보 같을 때가 그립고 어쩔 땐 피할 수 없는 무섭고 어쩌면 내게 주어진 짐이 버거워 복잡해 머리가 뒤죽박죽 엉켜와 봄엔 꽃이 피고 겨울엔 꽃이 내리고 그렇게 점점 커가고 소년은 커다란 모험 앞에 서있다 넌 잘 지내 보이나 거긴 그대로야 추억 속에 다 추억들도 하나씩 사라져가 기억을 어디에다 담고 막 내가 봐도 많이 컸어 나어릴 때는 예뻤지,2,0,0,1,1
413,마음은 바쁜데 현실은 더디고 꿈을 좇아 치열한 하루를 견디다 쓰러지듯 잠든 밤에 진짜 꿈을 꿔 내일은 괜찮겠지 나도 별처럼 빛이 날까 언제쯤 억지로 힘을 내지 않아도 될까 그런 날이 내게 와준다면 그땐 괜찮을 수 있을까 편히 쉴 수 있을까 그땐 뛰어가는 길에 보지 못한 걸어갔다면 담을 수 있었을까 욕심만 자라고 아직 자라지 못한 거 같아 아직 어린 거 같아 나도 별처럼 빛이 날까 언제쯤 억지로 힘을 내지 않아도 될까 그런 날이 내게 와준다면 그땐 괜찮을 있을까 편히 쉴 괜찮지 않아도 돼 내겐 어려울까 내가 나를 제일 미워하는 거 같아 고생한 나를 이제 안아주고 싶은데 그게 제일 어려울까 내가 별처럼 빛나서 언제쯤 누군가를 비춰줄 있을 그런 날이 내게 와준다면 나처럼 아프지 않게 환하게 비춰 줄게,2,0,4,-2,2
414,넘어졌지 괜찮아 잡아줄게 많이 걱정했니 아직 처음이잖아 그것쯤은 다 괜찮아 다 그런 거지 원래 다 어른들도 나이 땐 실수하고 연습하며 성장했었대 우린 아직 처음인 것들이 많잖아 괜찮아 우리도 겪어보며 크면 되잖아 울지 마 뒤처지면 쉬어가면 돼 너는 잘 하고 있어 힘들 내가 뛰어줄게 걱정 접고 일어나 팔을 걷어 올려 포기 따윈 접어 넌 잘 하고 있어 오너 잘 하고 있어 응힘내 참으면 돼 내가 곁에 있을게 넌 오너 당신은 시간을 내야 합니다 할 수 있잖아 너는 할 수 멈출까 말까 그만둘까 말까 안되는 걸까 이딴 잡생각은 집어치워 시간에 뛰어 어디가 끝인지도 모른 채 달리는 느낌 지친 몸과 마음의 연속 그러다 포기 앞에 들킴 끝은 네가 정하는 거야 네가 정한 끝은 뭐야 꿈을 향해 달려가는 너의 모습 자체가 충분히 넌 분명 내가 아는 너의 모습 분명 최선을 다하고 그거면 됐어 그렇게 계속 너만의 속도를 유지해가 불안해하지 말고 자신을 자신하고 의지해봐 오너 응힘내 참으면 돼 곁에 있을게 당신은 시간을 내야 합니다 할 수 있잖아 너는 힘들어지고 지쳐도 포기하지 마 널 밀쳐 내지 마 서툰 것뿐이야 시간이 지나 지나 널 돌아봤을 너에게 말해줘 이렇게 응힘내 참으면 곁에 있을게 당신은 시간을 내야 합니다 있잖아,2,0,7,-2,5
415,길었던 하루가 다 지나갈 때쯤 거울 속 스치듯 보여 구겨진 표정은 내가 아닌 것만 같아 애써 웃음 지어본다 냉소적인 사람들 고요한 적막 틈 안에서 굳게 닫혀버린 문 열 수 있을까 해맑게 웃던 지난날의 날 찾고 싶어져 지친 두 눈을 감아 감아 감아 말없이 어린 날의 모습을 보며 잃어버렸던 꿈을 꾸어 본다 불안감 가득한 어둠 속에선 먼지처럼 작아 보여 눈물로 뒤덮인 오늘은 어제와 같아 애써 울음 꾹 참아본다 초라해진 모습 얼어붙어버린 내면의 툭툭 털고 일어나 걸을 수 있을까 해맑게 웃던 지난날의 날 찾고 싶어져 지친 두 눈을 말없이 어린 날의 모습을 보며 잃어버렸던 꿈을 꾸어 본다 희미해진 나의 눈동자 선명히 덧칠하고 싶어 움츠러든 기억은 뒤로 멀리 멀어지는 꿈을 어떻게든 붙잡고 싶어 서서히 사라지는 해맑게 웃던 지난날의 날 찾고 싶어져 지친 두 눈을 말없이 어린 날의 모습을 보며 잃어버렸던 꾸어 본다,2,0,5,-1,4
416,상상해 봤던 장면 같아 꿈결 속의 풍경처럼 걸음 닿는 곳마다 날 물들이듯 순간을 소중하게 새겨둘 거야 끝이 아니란 걸 알아 떠나야 해 영원토록 계속해서 다시 빛납니다 길 위에서 엔딩 없이 계속될 여행을 멈추지 않을게 진짜 무언가를 얻었다 펼쳐낼 때까지 가끔은 헤맨대도 누구보다 행복한 여행을 멈추지 않을게 새까만 밤하늘 같은 날도 있지만 멀리 반짝인 별들이 나를 손짓해 처음의 설렘으로 차오른 감정 속에서 감정 속에서 걸어가 천천히 절대 포기하지 않을 거야 절대 포기하지 않을 거야 끝이 아니란 걸 알아 떠나야 해 영원토록 계속해서 다시 빛납니다 길 위에서 엔딩 없이 계속될 여행을 멈추지 않을게 진짜 무언가를 얻었다 펼쳐낼 때까지 가끔은 헤맨대도 누구보다 행복한 진짜 무언가를 얻었다 펼쳐낼 때까지 가끔은 헤맨대도 누구보다 행복한,2,0,-3,6,3
417,너의 시간을 가져 미루지 말고 어서 너만의 꽃을 가꿔 피어날 테니 복잡했던 날들은 이리 와서 던져 숨을 쉬는 곳 너무 필요했으니 눈을 감고 하늘 위로 올라갈 거야 구름을 넘고 시간을 넘어 날아가 버리다 너라는 가든 속에 꽃이 피어날 거야 향기로운 바람 속에 눈을 감으면 나만의 정원 위에 초록물이 거야 싱그러운 햇살 가득 담은 빛이 너의 생각에 잠겨 힘이 땐 어서 언제나 내게 안겨 늘 기다릴 테니 우울했던 날들은 이리 와서 던져 쉬어가는 곳 너무 필요했으니 눈을 감고 하늘 위로 올라갈 구름을 넘고 시간을 넘어 날아가 버리다 너라는 가든 속에 꽃이 피어날 향기로운 바람 감으면 나만의 정원 위에 초록물이 싱그러운 햇살 가득 담은 빛이 바빴던 하루의 끝에 멍하니 잠 못 든다면 쉬어갈게 괜찮을 너라는 가능성에 꽃이 피어난 향기로운 바람 감으면 한 행성에 환한 빛이 싱그러운 햇살 초록빛에 물이,2,0,-1,0,-1
418,괜찮아 괜찮아 괜찮아 탓이 아니야 잘 될 거야 곁에는 내가 있잖아 쓸쓸하고 힘들 슬프고 외로울 가슴이 답답하고 숨이 막힐 울고 싶을 때는 그냥 울어도 돼 곁엔 내가 있잖아 탓이 아니야 잘 될 거야 곁에는 내가 있잖아 쓸쓸하고 힘들 슬프고 외로울 가슴이 답답하고 숨이 막힐 울고 싶을 때는 그냥 울어도 돼 곁엔 탓이 아니야 잘 될 거야 곁에는,2,0,6,3,9
419,거울 속의 그대 모습을 바라본 적 있는가 부끄럽지 않은 삶인가 뜨거운 눈물 흘려본 적 누굴 위해 살아왔는가 여긴 지금 어딘가 어릴 적 그대의 꿈들은 그대가 만든 소설이었나 한번 생각해봐 그대 안에 널 움츠리지 말고 너의 날개를 너의 미래를 향해 날아보는 거야 아주 작은 새의 몸짓도 세상 봄이 옴을 알게 하는데 완전히 새로운 세상을 볼 수 있습니까 부질없는 그대 몸짓은 누구에게도 느낄 수 없게 해 당신이 느끼는 방식을 모릅니다 아직 늦지 않았어 두 팔을 벌려 너의 날개를 펴고 당신은 날아가서 하늘을 만질 수 있습니다 전설 속의 누군가처럼 그대의 미래를 향해 훨훨 날아봐 한번 생각해봐 안에 널 움츠리지 말고 날개를 미래를 향해 날아보는 거야 아주 작은 새의 몸짓도 세상 봄이 옴을 알게 하는데 완전히 새로운 세상을 볼 있습니까 부질없는 몸짓은 누구에게도 느낄 없게 해 당신이 느끼는 방식을 모릅니다 아직 늦지 않았어 두 팔을 벌려 펴고 당신은 날아가서 하늘을 만질 있습니다 전설 속의 누군가처럼 그대의 훨훨 날아봐 우리는 믿습니다 우리는 당신이 날 있다고 믿습니다 진흙 속에 피는 꽃들도 꽃보다 향기로운데 부질없는 몸짓은 누구에게도 느낄 없게 해 느끼는 방식을 모릅니다 아직 늦지 않았어 두 팔을 벌려 펴고 당신은 날아가서 하늘을 만질 있습니다 전설 누군가처럼 훨훨 날아봐,2,0,1,6,7
420,조금씩 자라난 자책이란 악당들 줄기 밑으로 뻗어나가는데 부서진 화분 속 말라가는 잎새는 그게 생명인 걸 뭐 내가 할 수 있는 할 수 있어요 숨을 쉴 수 없습니다 숨을 쉬십시오 슬픔이란 잡초들 속 넌 손을 뻗어 할 있어요 숨을 쉴 없습니다 쉬십시오에 숨 쉴 없대두 자존감에 물을 줘 자존감에 물을 줘 울음 울음소리를 계속하십시오 고통을 멈추고 원인 눈물 젖은 마음속 자라날 있도록 급수를 계속하십시오 원인 궁금했습니다 눈물이 떨어지면 떨어지는 드롭 떨어지는 드롭 두목 당신은 그것을 멈추지 마십시오 그냥 떨어뜨립니다 사랑하는 사랑의 사랑 없이 우리는 아무것도 없습니다 메마른 숨결 위로 자존감 물 주기 조그만 사랑도 위로가 되질 않고 뿌리박힌 악당 물러나질 않고 오래전 떠나간 사람도 못 놓은 채 지레 겁먹어 숨은 어떡해 있어요 쉬십시오 슬픔이란 욕조 속에 넌 몸을 던져 쉬십시오에 못할 거래도 자존감에 물을 줘 울음 울음소리를 계속하십시오 고통을 멈추고 원인 눈물 젖은 마음속 꽃이 필 있도록 급수를 우리가 꿈을 꾼 후에는 원인입니다 멋진 사람 되어 노래할래요 근데 거울 속 그댄 누구인가요 우물 안 개구리였나요 개구리는 아니니까 괜찮아 비타민 울음소리를 마시십시오 고통을 멈추고 눈물 젖은 마음도 사랑할 있도록 급수를 궁금했습니다 눈물이 떨어지면 떨어지는 드롭 두목 당신은 그것을 멈추지 마십시오 그냥 멈춰 사랑하는 사랑을 사랑하지 않고 사랑합니다 우리는 아무것도 메마른 숨결 위로 자존감 물 주기 아니요 아니오 당신은 그것을 알고 있습니다 자존감 물 주기,2,0,9,1,10
421,나도 숨 쉬고 싶어 나에게는 해도 물도 필요하지 않아 그런 거 없이도 배부르게 살 수 있으니까 나에게는 시들 걱정 필요하지 않아 밟히고 뭉개져도 색을 잃지 않으니까 모든 보여 내가 가진 모든 것이 보인다 보여하지만 내가 행복하지 못했던 이유는 당신은 이유를 알고 있습니다 나도 숨 쉬고 싶어 비를 삼키고 뿌리를 내고 싶어 잔디처럼 잔디처럼 바람이 불면 간지러워하는 들판을 흔들거려도 풀잎은 느껴지지 않아 흙 땅과 맞닿은 맨살에 부끄러워하는 풀들과 다르게 생기가 돌지 그들은 보여 그들이 가진 모든 것이 보인다 보여시들어가는 모습도 아름다운 이유는 당신은 무엇을 알고 있습니다 나도 숨 쉬고 비를 삼키고 뿌리를 내고 잔디처럼 빛 없이 물 없이 영원할 같았던 나의 잔뜩 상해버린 가짜 풀잎이 뜯겨지네 비를 삼키고 뿌리를 내고 느끼고 살아있다고 하늘을 펄럭이고,2,0,0,-3,-3
422,마스크 쓰기 너무 싫죠 벗어 던져버리고만 싶죠 이거 안 쓴다고 문제가 돼 훠이 벗어버리고 싶죠 마스크 쓰기 너무 쉽죠 쓰고 모습도 멋있죠 마스크 쓰면 바이러스도 이겨버려 우리들은 우리가 지키죠 선생님 이거 숨이 잘 안 쉬어져요 선생님 이거 뾰루지는 어떡하죠 선생님 뭐 까먹었는데요 어떡하긴 뭘 어떡해요 마스크는 껴야죠 어렵죠 하루 종일 참고 참고 마스크를 껴봐도 바이러스는 멈추질 않고 내일도 답답함의 반복 그렇게 방심할 틈새가 위험해 그렇게 불편하다는 생각은 접고서 지킬 것은 확실하게 쓰기 너무 싫죠 벗어 던져버리고만 싶죠 안 쓴다고 문제가 돼 훠이 벗어버리고 쉽죠 쓰고 모습도 멋있죠 쓰면 바이러스도 이겨버려 우리들은 우리가 지키죠 없음 나갈 거야 없음 볼 거야 없으면 아무것도 할 거야 없음 나갈 그니까 라테는 말이야 옛날엔 멋으로 막 마스크를 쓰고 다니곤 했는데 엄마가 막 벗으라고 해도 멋이라고 계속 고집하곤 했는데 선생님도 막 벗으라고 내게 잔소리하시고는 했어 이제는 쓰기를 권장하시니 좋은 세상이다 친구들 아라는 말이 너희들에게 위로가 될 수도 있겠지 다 힘든 시기에 형이 해줄 말이 뭐가 있겠니 고맙다는 말을 남겨 불편해도 참아줘서 고마워 있죠 불편해도 잘해줘서 고마워 싫죠 벗어 던져버리고만 쓴다고 문제가 돼 훠이 벗어버리고 쉽죠 모습도 멋있죠 쓰면 바이러스도 이겨버려 우리들은 우리가 지키죠 나갈 볼 없으면 아무것도 할,2,0,0,4,4
423,아직은 넘어져도 돼 뭐라고 너무 어리기 뭐라고 반 오십 먹고 그러냐 꿈을 들이밀지 충분히 어려 담가 새파란 바다에 너의 꿈을 그래그래그래그래 아마 계속해서 철이 안 테니까 무서울 거라곤 없고 걸어가는 중이고 젊음을 증명해 나의 땀방울 수 넘치는 꿈들을 수도 없이 흘려내지 오늘도 조바심은 젊음을 훔쳐 가는 도둑놈 매일같이 꿔대는 몽중몽 꿈속에서조차 나의 꿈을 매일 흠모하곤 해 네가 내게 손가락질해도 그것에 대해 신경 쓰지 않는다 그것에 대해 신경 쓰지 않는다 영원히 젊고 싶어 영원히 젊고 싶어 영원히 젊고 싶어 젊은 젊은이 그래그래그래그래 젊어 아직 어려 올해도 열일곱이 벌써 재미없어 응뭘 해도 스무 살이 되면 술을 마시고 친구랑 클럽에 가기도 하겠지만 학교가 싫어도 아직은 제일 편해 가장 좋아하는 곡을 들으면서 셔틀에 오르고 하루가 시작돼 패션은 별거 없어 커스텀 밴 배낭 목걸이 그거면 돼 분 준비해 시간제한 준수해야 뭘 해도 된다는 엄마의 말 그게 나이에도 적용이 되나요 땡 치면 한 살 먹는다는 무서워요 살 때까지도 떡국을 흡입했는데 이제 조랭이떡이 숫자로 보일까요 피터 팬이 보고 싶은 밤이야 네버랜드는 에버랜드라도 가고 싶은 날이야 네가 내게 손가락질해도 그것에 대해 신경 쓰지 않는다 젊은 젊은이 되고 젊은이 그래그래그래,2,0,0,-3,-3
424,상처가 나았어 흉도 안 남았지 아팠냐는 듯이 새살이 돋은 뽀얀 손가락이 예뻐 창피한 일기를 웃으며 읽곤 해 그때는 나름 잘 버텼네 속에 담긴 너의 이름도 새삼스레 반가운 걸 시간이 지나면 다 될 거라는 어른들의 이야긴 믿지 않았는데 다는 반은 틀렸으니 절반은 정답인 같아 아름다운 인생 아름다운 기억들 내가 쓴 이야기 때로는 틀리고 우습고 어리고 바보만 같던 날 마주 보며 웃을 수 있어 아름다운 날 눈부실 많은 날을 또다시 기다려 확실히 어제보단 자란 같아 길러낸 머리칼도 안에 어딘가도 초승달처럼 손톱이 자랐네 짧고 동그랗게 잘라볼까 기억은 손톱처럼 막 잘라도 자라나지 완전히 사라지진 않더라고 맘에 아직 남아있는 아픔들이 여기저기 거기 근데 그게 나를 찔러대지는 않아 인생 기억들 내가 쓴 이야기 때로는 틀리고 우습고 어리고 바보만 같던 날 마주 보며 웃을 수 있어 눈부실 많은 날을 다시 기다려 확실히 어제보단 자란 같아 길러낸 머리칼도 안에 어딘가도 아래로 내려주세요 볼륨을 내려요 괴롭히는 소리들 켜십시오 볼륨을 높여요 웃게 하는 소리들 부르기 좋은 멜로디가 되는 지나온 시간들이 보며 웃네 인생 숨 가쁜 틈에 피어나는 이야기 때로는 버겁고 두렵고 무겁고 아프게 한 대도 피하지만은 않을 거야 수많은 얘기들로 채워나갈 시간들 확실히 어제보단 오른 바람 부는 거리의 온도도 보는 눈높이도 아래로 내려주세요 볼륨을 내려요 켜십시오 높여요,2,0,5,-1,4
425,이유도 모른 채 열을 앓던 긴 밤들 가려도 비치게 짙게 남은 잔상들 누구도 날 사랑할 수 없는 꺼려지는 당연해 아파하는 날 괴롭혀 왔던 시간들 그댄 가장 감추고 싶었던 상처를 알아보고 위에 입을 맞추고 다정히 어루만져 낫게 해 텅 빈 맘 깊이 스며드는 온기 오래된 상처를 위로해 준 따스히 안아준 커다란 품 고요히 내린 밤비와 덧난 기억을 낫게 해 준 온전히 날 위해 흘린 눈물 아직은 제대로 마주 하긴 힘들지 낯설기는 변해가 조금씩 놀라워 한결같이 그댄 사랑해 주는지 강하고 아름다워 그댈 닮고 싶어 그댄 늘 가장 숨기고 싶었던 감정을 끌어내고 있는 그대로 솔직할 수 있게 다독여 일으켜 텅 빈 맘 깊이 스며드는 온기 오래된 상처를 위로해 준 따스히 안아준 커다란 품 고요히 내린 밤비와 덧난 기억을 낫게 해 온전히 위해 흘린 눈물 틈 없이 작은방 깊이 가둬둔 문을 열고 손 내밀어 편에 다시텅 빈 마미 스며든 온기 오래된 위로해 따스히 안아준 커다란 품 고요히 내린 밤비와 덧난 기억을 온전히 위해 흘린 눈물 크고 따듯한 품이 되어 그댈 안아줄 수 있기를,2,0,2,9,11
426,두근두근 마음속에 남겨둔 얘기 너의 꿈은 끝나지 않았어 눈부시게 빛나는 초록별처럼 용기 보는 거야 마음에 주문을 걸어 당신의 빛이 당신의 마음에 빛나게 하십시오 걸음에 날개를 달아 시작해 보는 거야 어둡고 아픈 어제는 지나갈 거야 눈물은 뒤돌아보지 말아 하루하루 조금씩 나아질 용기 보는 마음에 주문을 걸어 당신의 빛이 빛나게 하십시오 걸음에 날개를 달아 꿈이 계속되도록 하십시오,2,0,2,4,6
427,그해 나와 달 아래서 길을 걷곤 했지 추억은 날 아프게만 하는 그런 감정일지도 믿지 않아 세상 잊히는 거란 쉽지 그날의 뒤로 가슴이 아프다 가시가 박힌 듯이 아프다 더는 손을 댈 수도 돌이킬 수도 없다 애써 괜찮은 척하는 내가 우프다 후회는 안 하련다 뒤돌아보지 않고 가련다 시간은 약이 될지 독이 될지 모른다 그해 그달 그날 아른아른해 이제는 다 무의미해진 먼 훗날 꺼낼 해진 사진 보다 아름다웠다 그날 떠 있는 해 달도 잊지 못할 거다 올해의 달 그날도 그해 나와 달 아래서 길을 걷곤 했지 추억은 날 아프게만 하는 그런 감정일지도 믿지 않아 세상 잊히는 거란 쉽지 그날의 뒤로 잘 가라 안녕 당신이 말하는 사람은 저마다의 생각을 갖고 살지 간혹가다 이게 맞는가 싶기도 하지 하루하루 땅만 보면서 가니 핑계만 늘어놓는 그런 하루살이 우린 거부해 하고 싶다 다시 오지 않을 오늘을 위해 우린 다시 가다 해 우리는 가야 해봐 가자 자기야 해 나와 아래서 길을 걷곤 했지 추억은 날 아프게만 하는 감정일지도 믿지 않아 세상 잊히는 거란 쉽지 그날의 뒤로 잘 가라 안녕 밤하늘 같은 노래에 빛나는 시간을 수놓을게 응지 나온 모든 거리들과 희망찬 소망도 다 넣어서 밤하늘 아래 노래해 우리가 빛날 수 있게 지금도 그때와 같은 후에 기억에 남을 추억이 될 수 있게 우린 평소와 다름없는 말투로 누구보다 빛나고 있었지 넌 넌 그대와 밤하늘의 별이 돼 가겠지,2,0,2,-4,-2
428,밤 하늘의 수많은 별 중에 하나가 된다면 맘 모아 비춰 텐데 하늘 위에 높게 떠 있는 별이 되고 싶어 꿈에 그리던 날 만나길 바라 정신없는 하루하루를 보내고 있지 잘하고 있는 걸까 창밖에 보여 사람들 웃음 짓는 부러워 시간을 거슬러 뒤돌아 봤을 제자리인 것만 같은데 외롭지 않아 맘을 가득히 채우는 꿈이 있으니 웃을 수 있어 밤 하늘의 수많은 별 중에 하나가 된다면 맘 모아 비춰 텐데 하늘 위에 높게 떠 있는 별이 되고 싶어 꿈에 그리던 날 만나길 바라 어두운 방안에 거울 앞 모습 쉽지 않아도 웃음 지어 보려 해 힘들지 않아 맘속 가득히 빛나는 꿈이 있으니 웃을 수 있어 밤 하늘의 수많은 별 중에 하나가 된다면 마음 모아 비춰 텐데 하늘 위에 높게 떠있는 별이 되고 싶어 꿈에 그리던 날 만나길 바라 희미해져만 가는 빛을 붙잡아 언젠간 나도 별을 담게 될 거야 밤하늘의 마음 떠있는 지치지 않길 똑같은 일상 속에 여전한 모습 시간이 계속 흘러 뒤돌아 본다면 후회는 없을 거야 찰나의 순간들 바라고 바라왔던 만나게 되겠지 웃음 짓는 얼굴들 사람들 부러워하지 느낌을 기억해 내가 짓고 있길 계속해서 걸어 지치지 않길,2,0,-1,0,-1
429,눈을 뜨면 한숨만 나고 뜻대로 되는 없을 도로 위 꽉 막힌 자동차처럼 가슴이 답답할 시린 겨울 얼어붙은 밤 외롭고 쓸쓸할 노랠 들어봐요 혼자라는 생각이 때면 들어요 위로가 되어줄 그대 수고 많았어요 오늘 밤 잘 자요 내일이면 괜찮아질 거예요 힘든 일이 겹쳐서 뭐가 힘든지도 모를 요즘은 어떠냐는 흔한 안부에 눈물이 떨어질 남들은 다 앞서가는데 한참 제자리일 노랠 들어봐요 혼자라는 생각이 때면 들어요 위로가 되어줄 그대 수고 많았어요 오늘 밤 잘 자요 그대 곁에 내가 할게요 너와 있을 아기가 당신의 마음을 열어주세요 내일 아침이 오면 다시 웃을 수 있게 오늘까지만 울어요 간절히 노래할게 들어봐요 위로하는 목소리 있어도 항상 있어 숨을 크게 들이쉬고 불러봐요 걱정 마요 다 괜찮아질 거예요 기분인지 다 알아 지치고 힘든 그댈 다시 안아줘 노래를 들어요,2,0,5,0,5
430,서둘러 시간이 흘러 손을 잡아 보드라운 곳이든 아니든 너와 가겠어 이곳을 벗어나 가장 낯선 곳으로 가보기로 해 오늘을 오늘답게 찰나의 순간들을 나와 함께해 그렇게 너와 세상의 테두리 안에 갇혀 지내 잊고 있던 사랑하는 수많은 방식들을 알잖아 시간을 잘게 잘게 나눠서 내일이 없는 것처럼 가장 다운 방식대로 해 방식대로 해 나를 믿어 널 믿을게 손 놓지 마 불안하게 아름답게 헝클어지자 네가 괜찮다면 나도 괜찮아 우리가 무모해질 때를 기억해 숨이 가득 찰 같은 길을 달릴 우린 더욱 빛나 그렇게 너와 세상의 테두리 안에 갇혀 지내 잊고 있던 사랑하는 수많은 방식들을 알잖아 용감했던 눈빛을 기억해 모든 걸 다 잃어도 가장 다운 방식대로,2,0,-7,7,0
431,가끔 하늘을 바라봐 구름을 다시 걸어가 눈물을 닦아 하늘에 별이 그댈 위해 반짝여 어둠을 밝혀줘 절대 포기하지 마다지 두 손을 모아 기도해요 내일이 그댈 기다릴 거예요 그게 내가 필요한 전부입니다 하늘이 내려준 선물 바닷속 숨겨둔 보물 세상에 그대가 있어 그대는 그대라 소중해 그대 반짝이는 두 눈 속엔 자그마한 꿈이 보여 다 이뤄지길 다 이뤄가길 기대하고 응원해 당신은 포기하지 마십시오 하늘이 내려준 선물 바닷속 숨겨둔 보물 세상에 그대가 있어 그대는 그대라 소중해 햇살보다 따뜻한 가슴 별 보다 빛나는 눈빛 세상에 그대가 있어 그대는 그대라 소중해 하루하루가 외로워도 내가 있음을 기억해요 주저앉고 싶을 때면 내가 힘이 되고 싶어 그댈 위해 빛을 위해 기도하겠습니다 기도하다 하늘이 내려준 선물 바닷속 숨겨둔 보물 햇살보다 따뜻한 가슴 별 보다 빛나는 눈빛,2,0,0,3,3
432,그렇게 시작하는 거야 생각처럼 복잡하지 않아 가만히 있을 순 없잖아 해보기 전엔 모르잖아 그렇게 시작하는 거야 생각처럼 복잡하지 않아 가만히 있을 순 없잖아 해보기 전엔 모르잖아 천천히 걷다가 뒤돌아보면 어느새 달라진 널 볼 수 있을 거야 그렇게 시작하는 생각처럼 복잡하지 않아 가만히 순 없잖아 해보기 전엔 모르잖아 자장면 짬뽕 젓가락질 잘 해야만 겁낼 하나도 천천히 걷다가 뒤돌아보면 어느새 달라진 널 볼 수 자장면 짬뽕 젓가락질 잘해야만 겁낼 하나도 모른다니까 자장면 짬뽕 젓가락질 잘해야만 겁낼 하나도,2,0,0,-7,-7
433,어쩌면 서로 만난 건 운명일지 몰라서 우연처럼 필연처럼 우리들은 운명이라 믿었어 더는 외롭지 않을 거야 언제든 기댈 수 있어서 힘들고 지쳐 위로받고 싶어 슬프고 아파 이해되길 바라 세상의 모든 사랑하는 그대 당신의 편이 돼 줄게 더는 외롭지 않을 거야 언제든 기댈 수 있어서 힘들고 지쳐 위로받고 싶어 슬프고 아파 이해되길 바라 세상의 모든 사랑하는 그대 당신의 편이 돼 줄게 세상이란 환한 빛처럼 밝게 비춰 줄게요 힘들고 지쳐 위로받고 싶어 슬프고 아파 이해되길 바라 세상의 모든 사랑하는 그대 당신의 편이 돼 줄게,2,0,-1,5,4
434,걸음이 느려도 하늘은 내게 웃어줘 숨죽인 눈 얼어붙은 맘 너마저 알진 못해도 흩어지던 나의 노래 다시 나를 일으켜 하늘 위를 상상해봐 높이 날아가는 나의 꿈들을 너를 믿어 너의 꿈을 당신은 날아갈 거야 당신의 꿈으로 비행하십시오 지금 보다 소중한 당신은 날아갈 거야 당신의 꿈으로 비행하십시오 너의 꿈을 향해 발을 멈추지 마 다시 두려워하지 마십시오 계속 길을 달려 숨을 멈추지 마 하나뿐이야 꿈 이대로 외로움에 지친 하루 가질 수 없는 바람뿐 넘어지고 무너져 일어설 힘도 없을 고갤 들어 우릴 믿어 너의 곁에 있을게 하늘 위를 상상해 높이 날아가는 꿈들을 너를 믿어 꿈을 당신은 날아갈 거야 당신의 꿈으로 비행하십시오 지금 보다 소중 한 향해 발을 멈추지 마 다시 두려워하지 마십시오 계속 길을 달려 숨을 하나뿐이야 꿈 이대로 뛰어네 꿈속에 같은 바람 우린 너와 되어 이뤄 하늘 위로 너를 꿈들을 지금 보다 소중 한 향해 발을 계속 길을 달려 숨을 하나뿐이야 꿈 이대로 뛰어,2,0,2,2,4
435,뭘 입어도 거울 안에 비친 모습은 하나같이 맘에 들지 못해 만족하지 못해 앞에 서더라도 점점 한없이 작아지고 있는 모습에 인상 찌푸리게 돼 아니요 내가 누구도 인생을 바꿀 수 없습니다 내가 행복해지길 바라 매일 같은 바램 할 수 있는 사람이 없다 날 흔들지는 못해 내가 행복해지길 바라 매일같이 말해 할 수 있는 사람이 없다 날 아껴주진 혹시라도 앞에 비친 모습이 이상할까 아무것도 못 해 아무 말을 못 해 오단 한 번도 속 안에 감정들을 솔직하게 꺼내 놓지 욕하게 돼 아니요 누구도 인생을 바꿀 없습니다 행복해지길 바라 매일 같은 바램 할 사람이 없다 날 흔들지는 매일같이 말해 아껴주진 매일 같은 바램 흔들지는 바래 매일같이 말해 아껴주진,2,0,0,-3,-3
436,시작해볼까 시간만을 기다려 왔네 웃음이 번져 드디어 마주한 거야 한동안 널 휘휘 저었던 졸이고 애태웠던 걱정들 후후 불어 꿀꺽 삼켰던 뜨거운 눈물도 던져봐 오늘은 너의 날이야 축제는 지금부터야 우산을 높여봐 높은 뛰어봐 날아라 날아봐 널 부딪혀볼까 단숨에 맘이 가벼워지네 음악에 취해 흐르는 대로 너를 맡겨봐 한동안 널 살살 녹였던 뜸 들여 살 찌웠던 걱정들 얼음처럼 꽁꽁 얼렸던 그날의 기억도 던져봐 오늘은 너의 날이야 축제는 지금부터야 우산을 높여봐 높은 뛰어봐 날아라 날아봐 당신을 놓아 수 없습니다 오늘뿐이라 해도 망설이지 말고 알려주세요 네가 그리는 대로 오늘은 너의 날이야 축제는 지금부터야 잔을 높여봐 높은 뛰어봐 날아라 날아봐 잊지 마 계속될 거야 소릴 문득 생각해 다 포기 말아,2,0,2,7,9
437,그래그래 바람결 가득 깊게 내어 쉬는 숨 밝은 햇살 아래 나만 아는 거리 방식이 끌어 줘 날아가 버리다 가벼운 기분 걸음걸음에 스치는 모든 속삭이는 걸 여기서 나를 데려가십시오 언제나 상상했던 숲으로 날 데려가 여기서 나를 데려가십시오도 발이 홀린 푸른 들판을 내디뎌봐 숨 쉴 틈 없이 지친 마음을 가두던 골든 케이지 어느새 이미 멀리 떠내려가 날개 달린 운동화도 팔을 벌려 높은 곳에 눈부신 빛으로 날 데려가 달콤히 어쩜 미친왠지 멈추고 싶지 않아 달려볼까 거침없이 자유로운 이동하다 오래된 운동화 아래로 펼쳐 푸르게 번져 영원히 젊습니다 런 런 런 달리기 멈추고 싶지 않아 지루한 여정 따윈 넣어두고 어디로든 떠나 좋은 한동안 닫아뒀던 기억의 문다 활짝 열어 빠져들어 줌다 시 시작되는 꿈 안에 늘 간절했던 행복 찾으러 여기서 나를 데려가십시오 언제나 싱그럽던 숲으로 날 데려가 여기로 데려다 벅차오른 숨소리는 수많은 질문의 답 포근한 느낌 더는 바랄 없도록 행복해 가득히 열린 아름답던 이곳에 반복하다 고요하게 어둠 속에 잠겨가는 순간 빛난 별과 두 눈이 마주친 순간 안에 잊힌 감각들을 하나둘 깨워 깊어갈 밤을 비춰오는 리듬이 들려오는 걸 날개 달린 운동화 쉼 없이 달려 부른 곳에 찬란한 빛으로 날아올라 끝까지 믿어 완전히 미친 알아도 멈추고 싶지 않아 상관없어 뭐든 안에서 이어지는 꿈 오래된 운동화 하늘에 펼쳐 주문을 걸어 영원히 젊습니다 달리기,2,0,-3,3,0
438,코로나 엄청 무섭다던데 아직 우리나라는 뭐 별일 없으니까 괜찮아 금방 다 끝날 일이니까 그냥 조금만 조심하면 되겠지 별일도 아닌 같은데 노래방도 못 가고 이게 일이래 백신 금방 나올 테니까 뭐 괜찮겠지 학교도 못 가고 친구도 못 보고 그렇다고 놀 수도 없고 나갈 수도 없어 답답해 친구 보고 싶다 금방 끝날 알았는데 이게 일이래 갑자기 늘어난 확진자 탓에 가게에 손님이 뚝 끊겼네 힘들긴 했지만 어쨌든 시간은 흘러가 우리를 노래를 부르자 드디어 학교 갈 수 있겠다 오랜만에 친구들 볼 생각에 신나있는데 몇몇 생각 없는 사람들 미뤄졌어 포기해야 하는 걸까 오늘이 어제의 두 배래 힘든데 자기만 아는 사람들 진짜 왠지 상쾌하다면 그건 네가 마스크를 안 쓴 농담이 어이없지만 사실인 걸 언제쯤 마스크 없이 살 수 있을까 입대 개월 째 휴가도 갔는데 밖에서 휴가 가는 사람들 휴가도 나갈 같아 힘들긴 했지만 어쨌든 시간은 흘러가 우리를 노래를 부르자 어쩔 수 없는 일이야 세상 모든 일이 다 워 원하는 대로만 되진 않아 각자의 위치에서 노력을 해야지 근데 핼러윈이라니 다들 까먹은 걸까 지난 우리가 반복했던 실수를 생각이 많아지는 걸 수능 보는 친구들 걱정과 힘들어 폐업하는 가게가 슬프게도 현실이니까 벌써 월이지만 함께라면 것쯤은 이겨낼 있어 다 힘들긴 했지만 어쨌든 시간은 흘러가 우리를 노래를 부르자,2,0,9,0,9
439,쏟아지는 햇살에 시원한 바람까지 다 널 위한 거야 힘을 내봐 더는 두려워하지 말고 다시 털고 일어나 뭐 누구나 한 번쯤은 넘어질 수도 있잖아 조급해 할 필요는 없어 천천히 가도 늘 꿈꿔왔던 순간은 항상 곁에 있어 가자 가자 달려 보자 가자 힘을 하는 거야 아름다운 열정으로 달려 보자 힘을 용기 보는 거야 지금부터 시작이야 가끔 생각지 못한 비바람에 젖어도 맘의 태양이 널 일으켜 꿈이 이루어질 그날을 떠올려봐 상상만으로 가까워지고 있잖아 곁에 항상 있어줄게 천천히 가도 새롭게 펼쳐질 내일이 지금 앞에 있어 달려 보자 하는 아름다운 열정으로 용기 보는 지금부터 시작이야 갑시다 지치고 힘들 이것만 기억해 네겐 너무 소중한 꿈이 있다는 꿈을 찾아 밝게 빛날 너를 향해 하늘 높이 소리쳐봐 꿈을 찾아 용기 보는 지금부터 시작이야 갑시다 꿈을 찾아 하는 아름다운 열정으로 갑시다,2,0,-4,2,-2
440,어둠이 내려 앞이 보이지 않아 길을 잃었어 세상은 아름답기보단 아프기만 한지 많은 사람이 넘어지고 많은 눈물이 넘쳐흘러 우린 필요해요 서로에게 힘이 돼야 해 모두가 필요해 엘영형 이자 형 나도 알아 요새 많이 힘들었지 귀 빌려줄 테니 말해봐 문제가 뭔지 당신을 위해 여기에 있습니다 필요할 때마다 이제 말해줘 어렵지 않아 아기사랑이란 말 아끼지 말고 노래는 당신의 사랑을 보여줍니다 당신의 사랑을 보여주세요 사랑보다 큰 힘은 없어 그것뿐이면 돼 당신의 사랑이 사랑을 말씀하십시오 사랑이 퍼지게 다시 웃을 수 있게 별처럼 옆에 있을 것입니다 어둠을 밝혀 내가 너의 빛이 되어 줄게 두려워하지 마 거짓말 같은 밤도 모든 꿈처럼 희미해질 거야 서로 꼭 안아줘 보여주세요 이제 말해줘 어렵지 않아 아기사랑이란 말 아끼지 말고 노래는 보여줍니다 보여주세요 사랑보다 큰 힘은 없어 그것뿐이면 돼 사랑이 말씀하십시오 퍼지게 다시 웃을 수 있게 ~보다 낫다 강해집니다 우린 필요해 우리는 서로가 필요합니다 힘들다고 약한 건 절대 아니니까 모두가 필요해 가끔 몸을 기울여야 할 사람 당신은 알지 못합니다 삶은 계속됩니다 다시금 온 세상에 필 웃음꽃 사랑소리 높여 노래 불러 크게 소리 질러 온 세상에 닿도록 노래는 보여줍니다 사랑보다 큰 힘은 없어 그것뿐이면 돼 말씀하십시오 퍼지게 다시 웃을 수 있게,2,0,3,3,6
441,여보세요 잘 지내니 거긴 듣고 있니 교복을 입고 있던 교실 어딘가에 말이야 별로 못 지내니 하루빨리 오고 싶니 자유로워질 거라 생각하는 여기로 말이야 지금 이곳도 썩 괜찮은 듯해 네가 꿈꾸던 날과 닿아 있는지 모르지만 듣고 있다면 기억해줄래 그곳의 네가 지금 내가 되기까지 사실 힘들었거든 네가 있는 그곳이 지금 내겐 꿈같은 곳이야 지구 반대편도 갈 수 있는데 말이야 있는 그곳은 해도 갈 수가 없어 친구라 부를 수 있는 사람들이 많았던 썩 외롭지 않았던 그곳의 나에게 편지를 써 이곳도 썩 괜찮은 듯해 꿈꾸던 날과 닮아 있는지 모르지만 듣고 있다면 기억해줄래 그곳의 내가 되기까지 사실 힘들었거든 그곳이 꿈같은 곳이야 오늘이 쌓여서 내가 돼 많이 웃고 울고 넘어지는 걸 두려워하지 마 하늘은 언제나 어두웠다가도 이내 햇살을 드러내며 맑아져 당신은요,2,0,2,5,7
442,돌아보지 마 끝없이 깊어질 거야 여길 벗어나 이대로 그냥 날 믿어줘 가보자 상처받지 마 끝없이 널 가둘 거야 손을 잡아 내겐 너만의 불꽃이 보이니까 꽃처럼 피어나 불처럼 타올라 넌 누구보다 끝없이 높이 한없이 깊이 보게 될 거야 넌 한계 없이 타오를 불꽃처럼 잡게 될 너의 손안에 두 팔을 펼쳐서 날아올라가 높은 곳에서 피어나자 마음에 두지 마 우리는 나아질 상처는 남아 결국엔 너를 강해지게 하잖아 지나갈 쉬어도 되지만 멈추지 말자 내겐 너만의 불꽃이 보이니까 꽃처럼 피어나 불처럼 타올라 넌 누구보다 높이 한없이 깊이 보게 될 한계 없이 타오를 잡게 너만의 꽃으로 피어나 타오를 불꽃처럼 잡게 너의 손안에 두 팔을 펼쳐서 날아올라가 높은 곳에서 피어나자 타올라 날아가 꽃으로,2,0,2,2,4
443,꽤나 고단한 하루죠 걱정은 조금씩 커져만 가고 기분이 이상해 뭐가 잘못된 걸까 그렇게 하루의 끝에 아쉬움을 달래면 잘 될 거라고 슬퍼하지 말라며 위로하며 잠들죠 누구나 맘에 지쳐 기대고 싶고 잘 해낼 거라고 맘을 잡아보고 쉽지는 않아도 괜찮아 빛나는 너이니까 누구나 하는 실수에 맘이 아프고 잘 해낼 수 있을까 걱정도 해보고 쉽지 않을 거야 너도 할 수 있어 빛나는 너이니까 말이야 부족한 많은가 봐요 모든 어색해요 걱정처럼 맘이 조심스러워서 괜스레 눈치를 보죠 고민할 때도 생기겠죠 아마 뒤척이며 밤을 새워도 맘을 먹고 익숙해져가면 괜찮아지겠죠 누구나 맘에 지쳐 기대고 싶고 해낼 거라고 맘을 잡아보고 쉽지는 않아도 괜찮아 빛나는 너이니까 하는 실수에 맘이 아프고 수 있을까 걱정도 해보고 쉽지 않을 거야 너도 할 있어 말이야,2,0,6,1,7
444,이불 밖은 위험해 오늘도 컴퓨터를 켜지 벨이 울려서 반가워 열면 택배 아저씨 죽 피곤이 가시질 않아 바닥과 하나가 되자 핸드폰 사진 속 그들이 사는 세상 속 빼고 즐거워 보여 아침은 항상 해지는 오후 남보다 한 걸음씩 늦어왔지만 내일은 밝아질 거야 긴 꿈일 뿐이야 꿈 꾸는 잉여 덮밥을 시켜 먹을까 버거로 시작해볼까 메뉴를 고를 땐 때보다 진지해 삼십 분 걸린대 아침은 항상 해지는 오후 남보다 한 걸음씩 늦어왔지만 내일은 밝아질 거야 긴 꿈일 뿐이야 꿈쟁이 선풍기 바람이 센 거 같아 미풍으로 맞추고 눈을 감는데 뭔가 더운 같아 창문을 열어 센티만 이불을 감고 잠이 든다 아침은 항상 해지는 오후 남보다 한 걸음씩 늦어왔지만 내일은 밝아질 거야 긴 꿈일 뿐이야 꿈 꾸는 잉여 아무 걱정도 없는 건 아냐 머리 아플 땐 이렇게 쉬고 싶어 오늘은 다 내려놓고서 꿈을 꾸자 꿈 꾸는 잉여,2,0,1,0,1
445,누가 이해할까요 걱정하긴 하나요 알고 있어 너의 잃어버린 미소 울지 마 나락에 있죠 솔직히 무서운 걸 원한다 나은 삶을 찾습니다 괜찮을 것입니다 어둠이 앞을 가릴 자신을 잃어버릴 세상에 혼자라 느껴질 모든 괜찮을 거야 어른이 되어간다는 이리도 추운 건가요 등불에 의지하기엔 시린 곳이 너무나 많죠 두목 잊어버려 지나 넌 웃고 있을 거야 자신을 사랑하십시오 날 가두던 마음 한편의 속 사이로 흘러가 행복한 순간들을 누가 뭐라 할 수도 없죠 소중한 사람 온 세상에 따뜻한 나란 걸 알려줘 나락에서 본 세상 너머 보았죠 기쁨 원한다 나은 삶을 찾습니다 괜찮을 것입니다라도 그런 적 있었단다 방황이란 차가운 바람 파고들 필요했던 사람 없다고 느껴질 무거웠던 맘 아냐 사실 필요했던 거야 말할 용기가 칠흑 같던 머리 안은 새하얀 백지장 다시 차례대로 그려가면 돼 내가 원하는 것을 할 수 있다는 것을 안다 날 가두던 마음 한편의 속 사이로 흘러가 행복한 순간들을 누가 뭐라 할 수도 없죠 소중한 사람 온 세상에 따뜻한 나란 걸 알려줘 나락에서 본 세상 너머 보았죠 기쁨 원한다 나은 삶을 찾습니다 것입니다 어둠이 앞을 가릴 앞에 빛이 보이네 자신을 잃어버릴 사실 알고 있죠 혼자라고 느껴질 너는 혼자가 아니야 당신은 원합니다 당신은 뭐라 수도 없죠 소중한 온 따뜻한 나란 알려줘 나락에서 본 세상 너머 보았죠 기쁨 것입니다,2,0,-6,2,-4
446,당신이 생각을 했는지 알고 있습니다 당신이 무엇을 들었는지 알고 있습니다 그것이 지금 미쳤다는 것을 안다 우리는 문제가 없었습니다 전에는 이것을 좋아하지 않습니다 꽤 빨리 퍼지고 있습니다 오매일 반복되는 날 통제할 수 없는 것입니다 방법을 보여 드리겠습니다 가이 모든 것을 극복할 것인가 나와 손을 씻으십시오 실제로 마스크를 간단하게 넣으십시오 베이비 우리는 이길 수 매일 우리는 간다 힘을 내요 지켜줘 베이비 이길 수 매일 힘을 내요 아기 당신의 사랑을 보여주세요 당신의 사랑을 보여주세요 악수 없이도 안녕하세요 깨끗하게 넌 영웅 가까이 아니요 멀리서 확인 매일 반복되는 날 통제할 없는 것입니다 방법을 보여 드리겠습니다 가이 모든 것을 극복할 것인가 나와 손을 씻으십시오 실제로 마스크를 간단하게 넣으신 시오 베이비 이길 간다 힘을 내요 아기 하나입니다 지켜줘 간다 아기 당신의 역할을 안전하자다 많은 생명을 구해 봅시다 역할을 안전하자다 많은 생명을 구해 봅시다 여기서 손을 씻으십시오 깨끗한 깨끗한 나와 오세요 마스크를 간단하게 붙이십시오 실제로 온 하나입니다 지켜줘 여기로 갑니다,2,0,-6,-3,-9
447,누구나 손가락질 받을 때면 가슴 한편 뜨거워지는 걸 느끼죠 내가 믿는다 고 믿는다 괜찮아 그댄 따뜻한 말 한마디가 필요했다는 걸 알아요 강한 척 밀어내도 어디로 가는지 무거운 발걸음이 많이 지쳐 보여요 언제나 기다릴게요 편히 쉴 수 있도록 집으로 가는 길 매일 걷던 길을 헤매다 길을 잃은 아이처럼 방황의 끝에 있죠 힘들어도 꿈을 잃지 말아요 세상의 모든 그댈 속일지라도 슬퍼 말아요 웃어요 변명이란 이불 덮어줘 않으면 내가 너무 추워 우스워 보이기 싫어서 핑계를 베고 누워 언제나 불안 속에 살아 뜨거워 내게 보내나 차가운 시선 세상 어디도 날 위한 곳은 없어 도망치듯 집으로 두 발을 움직여 중지해 고인 눈물 그만 닦고 일어서 주저앉아 나만 나만 징징대 봤자 하고 일어서 웃겨 나도 못 보면서 남의 눈치 보네 해 보기도 전에 지레 포기하지 따뜻함에 안주하기엔 세상이란 술은 독해 언제부터였는지 힘없는 뒷모습엔 상처만 남있네요 언제나 열어 둘게요 편히 쉴 수 있도록 집으로 가는 길 매일 걷던 길을 헤매다 잃은 아이처럼 방황의 끝에 있죠 힘들어도 꿈을 잃지 말아요 세상의 모든 그댈 속일지라도 슬퍼 걷다 발목을 다쳐도 주저앉아 포기하진 많이 힘들지 괴롭지 매일이 혼자인 것처럼 외롭지 지금 나를 포기하지 마십시오 나와 힘든 걷자 안 돼 가는 길 매일 걷던 헤매다 잃은 아이처럼 방황의 끝에 있죠 힘들어도 끈은 놓지 세상의 모든 그댈 속일지라도 슬퍼 웃어요,2,0,11,-6,5
448,청춘 아프면 병원을 가야지 나이를 먹으면 고치기 힘들어 내가 쉽게 세상이 좀처럼 쉽지가 않아 비싼 옷 입고 좋은 차 타고 넓은 집 있으면 결혼하긴 쉽지 내가 쉽지 않다는 늘 함정이야 매일 아침 눈떠 믿기 싫은 거짓말하다 스물넷에 내가 너무 애 같아 대인데 너무 때가 타 인생은 아름다운 삶은 아름답습니다 겁 없이도 뛰어들 나인데 스물넷 스물넷 겁도 많고 겁도 많아 숨을래 겁 없이도 뛰어들 나인데 학교를 휴학했어 하고 싶은 아냐 성공을 위해 대학 나온 다가 아냐 이건 지극히 주관적 입장 침을 튀기며 욕해봐 굳건하니까 스물넷 알바 늘렸지 쾌적한 환경을 원했지 설거지 하기 싫었어 하며 펜을 잡아 온몸이 젖은 채로 적어냈지 글자 어색했어 랩을 하지 않는 순간이 사장은 물어 대체 갔니 고추장이 멋대로 할 수조차 없는 곳에서 받아 집에 타고 갈 비행깃값을 위해 참아 할 수 있는 하고 싶은 해야만 하는 일은 지금 하는 스물넷의 빠져있었지 알바 랩과 마침내 만들었다 매일 아침 눈떠 믿기 싫은 거짓말하다 스물넷에 너무 애 같아 대인데 때가 타 인생은 아름다운 삶은 아름답습니다 겁 없이도 뛰어들 나인데 겁도 많고 많아 숨을래,2,0,3,-4,-1
449,밉게 우는 건 이제 그만할까 이대로 어디로든 갈까 눈을 감을까 그렇게 아픈 건 잊어지지 않아 시간에 기대어 가만 한낮에 꿈을 꾸듯이 살랑 바람이 가만히 날 어루만져 눈물이 나려 있으면 마음을 읽어주는 사람 사람 없나 비가 내리면 햇살을 대신하는 사람 늘 같은 어디쯤 있나 행여나 곁으로 오면 하루 다 나를 안아주면 그때나 웃어나 볼까 나만 혼자란 생각만 안 들게 해줘 날 웃게 해줘 있으면 마음을 읽어주는 없나 비가 내리면 햇살을 대신하는 늘 같은 어디쯤 있나 행여나 곁으로 오면 하루 다 나를 안아주면 그때나 웃어나 볼까 졸린 책은 덮어두고 한낮에 꿈을 꾸듯이,2,0,7,1,8
450,내게 펼쳐지는 방법 공기마저 산뜻해 아주 먼 곳에 떠나지 않아도 우린 벌써 나은 곳에서 멀리 놓쳐버린 걸어온 길 위의 문득 생각나기는 해도 뭐 딱히 아쉽진 않아 모든 것이 너무 아늑합니다 햇살이 좋은 오후 두 발끝이 이끄는 대로 오늘은 어디로 갈까 지난 일은 후회하지 않아 행복에 한 걸음 가까운 하루 하루 지금 여기서부터 내게 펼쳐지는 방법 공기마저 산뜻해 눈앞에 보인 모든 아름다운 미소 짓기 충분해 지금 날개 달린 듯한 맘 걷는 순간 아주 먼 곳에 떠나지 않아도 우린 벌써 나은 곳에서 복잡한 머릿속 괜찮아 바람 잘 날이 없어 그러게 다 추억이라고 맞지 사는 그렇잖아 힘내요 형 오케이 됐고 바람이나 쐬러 미간에 주름 보톡스 돼 맹세 좋은 데로 우리는 때로 보 다 나아질 수 있습니다 배로 되게 시너지 매료되겠어 이곳이 나은 더는 낭비하지 않아 내일의 날 위해 바꾸는 사고방식 사고방식 지금 여기서부터 ,2,0,-1,3,2
451,아침이 밝아오는 것이 내게는 의미일까 걸어가다 보면 길을 잃을 때도 있는 그때가 어둠일까 이제 그만 다 잊어버려요 아쉬움 등도 품지 말아요 그대 한숨이 깊고 깊어도 하겠네 시련을 피해 사는 것이 나에게 의미인가 때론 눈물이 내겐 거름이 돼 주는 걸 무엇이 기쁨일까 이제 그만 다 잊어버려요 아쉬움 등도 품지 말아요 여정이 길고 길어도 걸어가겠네 험한 길도 그대와 함께라는 걸 이제 그만 다 잊어버려요 아쉬움 등도 품지 말아요 그대 한숨이 깊고 깊어도 함께하겠네 여정이 길고 길어도 걸어가겠네 그대와 가겠네,2,0,5,4,9
452,골칫거리 뒤죽박죽 한 머리 바보스러운 모습 안쓰러워요 힘을 뚜룹뚜룹뚜 뚜룹뚜 힘껏 소리치며 일어나에야 디야 러키 러키 러키 행운 빌어 줄게요 일어나 싸움 싸움 싸움할 수 있을 거예요 이제는 처음부터 새롭게 늘어진 어깰 펴고 하늘을 봐요 괜찮아 스트레스 안고 살지 마세요 날려 버려요 한숨 그만 쉬세요 좋아요 뚜룹뚜룹뚜 뚜룹뚜 이를 꽉 깨물고 일어나 행운 빌어 줄게요 일어나 싸움 싸움할 수 있을 거예요 이제는 처음부터 새롭게 끝까지 힘을 내고 부딪혀 봐요 괜찮아 용기를 내고 말해요 숨어서 눈물 훔치는 당신을 바꿔나가요 이제는 웃어요 행운이 올 거라 믿어요 행운 빌어 줄게요 싸움할 수 있을 거예요 처음부터 새롭게 끝까지 힘을 내고 부딪혀 봐요 괜찮아,2,0,1,0,1
453,천사는 어디에 있습니까 하루의 끝을 드리운 누군가가 와서 나를 구하십시오 제발 지친 하루의 한숨뿐 사람들은 다 행복한가 나를 볼 수 있습니까 파란색이다 회색 거울에 비친 눈물의 의미는 웃음에 감춰진 나의 색깔 파란색 회색 어디서부터 잘못됐는지 잘 모르겠어 나어려서부터 머릿속엔 파란색 물음표 어쩜 치열하게 살았는지 모르지 뒤를 돌아보니 우두커니 서니 나를 집어삼켜버리는 서슬 퍼런 그림자 여전히도 파란색 물음표는 불안인지 우울인지 어쩜 후회의 동물인지 아니면은 외로움이 낳은 나인지 모르겠어 서슬 퍼런 블루 잠식되지 않길 바라 찾을 거야 출구 그냥 행복해지고 싶어 차가운 날 녹여줘 수없이 내민 나의 손 색깔 없는 메아리 땅은 너무 무겁다 혼자서 노래하고 그냥 행복해지고 싶어 이것도 큰 욕심일까 추운 겨울 거리를 걸을 느낀 빨라진 심장의 호흡 소릴 지금도 느끼곤 해 괜찮다고 하지 마 괜찮지 않으니까 제발 두지 말아 줘 너무 아파 늘 걷는 길과 늘 받는 빛 오늘은 왠지 낯선 장면 무뎌진 걸까 무너진 걸까 근데 무겁긴 하다 쇳덩이 다가오는 회색 코뿔소 초점 없이 덩그러니 서있어 나답지 않아 순간 그냥 무섭지가 않아 확신이란 신 안 믿어 색채 같은 말은 간지러워 넓은 지대가 편해 수억 가지 표정의 회색비가 오면 세상 도시 위로 춤춘다 맑은 날엔 안개를 저은 날엔 늘 모든 먼지들 위해 축배를 행복해지고 싶어내 손의 온 길 느껴줘 따뜻하지가 않아서 네가 더욱 필요해 땅은 너무 무겁다 혼자서 노래하고 먼 훗날 내가 웃게 되면 말할게 그랬었다고 허공에 떠도는 말을 몰래 주워 담고 나니 이제 새벽잠이 드네 안녕히 주무세요,2,0,7,1,8
454,어쩌면 우린 높은 절벽 위야 잔 바람에도 휘청거릴 거야 널 가둔 높은 벽을 넘어서 위험이 널 덮치더라도 전진해가 거센 바람에 겁이 겁이 겁이 오너를 믿어 자신을 믿어 어쩌면 우린 후퇴하지 못할 거야 오너를 믿어 자신을 모든 걸 내질러버려 한계를 부숴버려 속 안에 있는 두려웠던 다 어쩌면 우린 높은 절벽 위야 한순간 위험해질 수도 있어 모든 순간이 널 외롭게 그럼에도 두려워하지 마 강해져야 해 거센 바람에 오너를 자신을 후퇴하지 못할 거야 모든 걸 내질러버려 한계를 부숴버려 속 안에 있는 두려웠던 다 위험해 떨어질지도 몰라 손을 잡아 그럼에도 두 벌리고서 펼쳐진 세상을 거센 바람에 후퇴하지 못할 그래그래그래 그래그래그래 그래그래그래,2,0,6,1,7
455,하루가 힘들어 누군가의 품이 그립고 기대고 싶을 아무 말 없이 내게로 숨 막힐 답답한 맘 어루만져 위로가 될게 네가 가진 슬픔의 반 내가 가져가서 너의 노래가 될게 오늘보다 내일이 빛나는 네가 될 거야 흔들리지 말고 지금 모습 그대로 있어주면 돼 혼자라는 생각이 널 가끔 힘들게 하면 가장 사랑하는 사람들과 너를 응원하는 나와 노래가 곁에 있잖아 잠든 밤에 잠에서 깨어나 텅 빈 나의 맘을 애써 감추려고 했었죠 쉴 틈 없이 달려왔던 지난날의 위로가 될게 잠시나마 편히 쉬어 갈 수가 있게 너의 노래가 오늘보다 내일이 빛나는 네가 될 거야 흔들리지 말고 지금 모습 그대로 있어주면 돼 혼자라는 생각이 널 가끔 힘들게 하면 가장 사랑하는 사람들과 너를 응원하는 나와 곁에 있잖아 당신의 친구가 될 것입니다 때로는 혼자서 가는 길이 멀고도 험하겠지만 지금이 느낄 수 없는 오늘 하루하루가 네게 소중할 거야 보이지 않고 지칠 때도 있겠지만 충분히 잘해왔던 너였잖아 널 많이 믿어주면 돼 혼자라 생각하지 마 언제나 곁에 있을게 너무 서두르지 않아도 이미 누구보다 밝게 빛나고 있으니까 너는,2,0,-6,2,-4
456,시간이 지나도 아물지 않는 일들이 있지 내가 날 온전히 사랑하지 못해서 맘이 가난한 밤이야 거울 속에 마주친 얼굴이 어색해서 습관처럼 조용히 눈을 감아 밤이 되면 서둘러 내일로 가고 싶어 수많은 소원 아래 매일 꿈을 꾸던 아이는 그렇게 오랜 내가 되려고 아팠던 걸까 쌓이는 하루만큼 멀어져 우리는 화해할 수 없을 같아 나아지지 않을 같아 어린 날 맘엔 영원히 가물지 않는 바다가 있었지 이제는 흔적만이 남아 희미한 그곳엔 설렘으로 차오르던 나의 숨소리와 머리 위로 선선히 부는 바람 파도가 되어 어디로든 달려가고 싶어 작은 두려움 아래 천천히 두 눈을 뜨면 세상은 그렇게 모든 순간 내게로 눈부신 선물이 되고 숱하게 의심하던 그제야 나에게 대답할 수 있을 같아 선 너머에 기억이 나를 부르고 있어 아주 오랜 잊고 있던 목소리에 물결을 거슬러 돌아가 안의 바다가 태어난 곳으로 휩쓸려 길을 잃어도 자유로워 날 가두는 어둠에 눈 감지 않아 두 번 다시 모른 척하지 않아 그럼에도 가끔은 삶에게 지는 날들도 있겠지 또다시 헤맬지라도 돌아오는 길을 알아,2,0,5,6,11
457,어깨에 기대 눈을 감아도 돼 햇살은 눈썹에 내려앉았고 은 깊은 잠이 들어도 낯선 공기가 날 깨워 우린 역에서 드디어 보게 될 거야 만나게 될 거야 꿈에서처럼 그림 같아 가장 아름다운 세상은 사랑은 물과 같습니다 아픈 곳을 채우는 패인 상처들을 감싸고 꼭 안아줘 널 다시 일어나게 해 정해져있어 우린 서로 채워주고 토닥여 널 낫게 해 수자원처럼 날 살아있게 해 너라는 의미 알아요 당신에게 감사합니다 나를 믿는다 부서지는 몰아쳐도 파동 어느새 바다의 품으로 길의 끝이란 운명처럼 네게 흐르고 있어 날 사랑해줬으면 해에 아픔 나도 느껴져 푹 패인 상처들을 감싸고 안아줄게 널 다시 일어나게 안아 주어야 정해져 있어 우린 서로 채워주고 토닥여 낫게 항상 물을 좋아합니다 넌 나를 비추네 나에게 물을 다시네가 눈 뜰 때쯤엔 다 괜찮을 거야,2,0,-4,2,-2
458,이상해 분명 너를 너무 사랑했는데 뭐든 너에게 맞추고 널 위해 살고 싶었는데 그럴수록 맘속의 폭풍을 견뎌낼 수 없게 돼 웃고 있는가면 속의 진짜 모습을 다 드러내 내가 사랑해야 할 사람입니다 세상에서 빛나는 나를 소중한 영혼을 이제야 깨달아 나를 사랑합니다 부족해도 너무 아름다운 걸 내가 사랑해야 할 사람입니다 흔들리고 두려워도 앞으로 걸어가 폭풍 속에 숨겨뒀던 진짜 너와 만나 이렇게 소중한 날 숨겨두고 싶었는지 뭐가 그리 두려워 진짜 모습을 숨겼는지 빛나는 나를 소중한 영혼을 이제야 깨달아 사랑합니다 부족해도 너무 아름다운 걸 내가 사랑해야 할 사람입니다 조금은 뭉툭하고 부족할지 몰라 수줍은 광채 따윈 안 보일지 몰라 이대로의 나인 걸 지금껏 살아온 팔과 다리 심장 영혼을 사랑하고 싶어 세상에서 빛나는 이제야 깨달아 사랑합니다 부족해도 아름다운,2,0,-5,1,-4
459,안녕 공주 준비됐음 이제 게임 시작 뛰어보기도 전에 너무 겁먹지 말아 감히 두려워하지 마십시오 당신은 그냥 땅에서 날아갈 수 있습니다 거 생각보다 단순하지 뒤돌아 보지 말고 날 따라와 지금 날 따라오세요 숨이 벅차와도 턱 끝까지 차도 끝이 안 보여도 절대 멈추지 마 당신의 버섯이 될 것입니다 널 크게 해줄 날 먹어 당신의 스타 라이트가 될 것입니다 나를 믿고 달려 계속 두드려줘 위아래로 점프하십시오 빛이 다할 때까지 당신의 버섯이 될 것입니다 버섯과 꽃 비 끝에 다다를 때까지 잠깐만 기다려주세요 높이 어렴풋이 뭐가 보이는 걸 하늘로 올라갑니다 당신에게 길을 보여줄 구름을 걸을 수 있습니다 지칠 때면 지름길로 데려다줄게 가고 싶은 곳으로 가십시오 당신이 하고 싶은 일을 하십시오 당신이 말하고 싶은 말을 말씀하십시오 숨이 벅차와도 턱 끝까지 차도 끝이 안 보여도 절대 멈추지 마 버섯이 널 크게 해줄 먹어 스타 라이트가 나를 믿고 달려 계속 두드려줘 위아래로 점프하십시오 빛이 다할 때까지 끝에 다다를 생각에 대한 생각은 멈춰줘 이것도 생각인가 산다는 너무 걱정만 할 필요는 없더라 눈 감고 한 번 시작해 딱히 대단한 없어도 뭐 괜찮아 한 걸음씩 가보는 거야 만화영화 속 주인공 영웅이 아니니까 널 크게 해줄 먹어 스타 라이트가 나를 믿고 달려 계속 두드려줘 위아래로 점프하십시오 빛이 다할 끝에 다다를,2,0,0,-2,-2
460,실수로 물감이 튀었는데 말이야 그게 맘에 들었고 삐끗해 찢어진 부분까지도 걸로 만들었어 세상이 많이 변했고 그들과는 다르단 거 세상이 많이 변해 너도 그들과는 다르잖아 지그재그 흘러가는 대로 살아 지그재그 흘러가는 대로 놔둬 지그재그 흘러가는 대로 살아 놔둬 살아 놔둬 조심스럽게 들어보십시오 이것은 장입니다 교과서엔 없는 그런 잔뜩 새겨 들어 뚜렷한 목표 의식 본질이 늘 첫째 불의 앞엔 외쳐도 돼 눈 크게 떠 턱부터 목선까지의 각도 누구에게 적이 될 땐 끝판 왕이 돼야지 마인 부우 생각 잘 해야 돼 원인 제공은 파인 옷 아니고 시선이란 걸 말해 젠장 숨이 찰 땐 당연히 쉬어도 돼 지금 앞마디처럼 그걸 알아야지 날숨 역시 그루브 박자 사는 것도 크게 안 다르지 템포 떨궜다면 역시 그것대로 작품이 존재하지 ,2,0,0,3,3
461,가끔 그런 날이 있지 어디론가 떠나버리고 싶은 없는 그곳으로 날아가 버리고만 싶네 내가 이러고 싶어서 이러고 있는 아냐 세상 사람들 다 마음일까 문득 궁금해지네 잘하고 있잖아 걱정이야 과정일 뿐인 거야 누구나 다 너만 그런 아냐 어서 훌훌 털어버리고 일어나줄래 새삼 놀랄 것도 없는 변화 가득한 복잡한 세상 속에 덩그러니 남겨진 아이처럼 무엇도 할 수 없네 내가 이러고 싶어서 있는 아냐 세상 사람들 다 마음일까 문득 궁금해지네 잘하고 있잖아 걱정이야 과정일 뿐인 거야 누구나 너만 그런 어서 훌훌 털어버리고 일어나줄래 일어나줄래 잘하고 있잖아 걱정이야 과정일 뿐인 거야 누구나 너만 어서 훌훌 털어버리고,2,0,2,1,3
462,내가 모르는 길들과 전혀 알지 못하는 사람들 속을 헤매고 있어 올 거라 생각도 못 한 예전 약했던 모습 기억이 나네 어리고 집이 그립고 따뜻한 사람의 손이 어색했지 여리고 늘 불안하고 차가운 말들에 상철 받았었지 휘청대고 흔들려도 무너지고 넘어진대도 괜찮아 상처 나고 피가 나도 부서지고 떨어진대도 괜찮아 괜찮아 빛을 계속 걸어가네 끝이 어딘지는 모르지만 가네 계속 가네 어리고 집이 그립고 따뜻한 사람의 손이 어색했지 여리고 늘 불안하고 차가운 말들에 상철 받았었지 워어어어 휘청대고 흔들려도 무너지고 넘어진대도 상처 나고 피가 나도 부서지고 떨어진대도,2,0,1,1,2
463,씨 발견으로 태어날 테니 이렇게만 적을래 깨지고 부딪혀도 가는 길에는 차질 없어 가끔 외롭긴 해도 멀리 푸른 점에 잘 살고 있는 사람들은 끝없이 여길 동경하겠지 살별의 그림자가 돌덩이에 지나지 않더라도 타오를 거야 궤도에 존재하는 이유 비행의 끝에는 분명 너의 소원이 될 거라고 작은 목소리로 우리에 축복을 빌어볼게 질문은 접어두자 지금 순간 의심은 없어 목적을 확실하게 빙빙 맴도냐고 그런 말을 들을 없어 사실이 아니란 걸 알아 살별의 그림자는 뜨겁게 녹아가는 얼음 속에 타오를 거야 궤도에 존재하는 이유 여정의 끝에서 분명 너의 미래가 될 테니까 작은 목소리로 우리에 축복을 빌어줘 한순간에 사라질 무력한 우주 먼지에는 세상에 새겨질 서로 이야기가 있어 하고 싶었던 중요한 얘기가 있어 듣기만 해줘도 돼 영원이란 속에 잠들어 버린대도 나를 잊지 말아 줘 뜨겁게 타오를 때에 곁에 있을게 살별의 그림자가 돌덩이에 지나지 않더라도 밝게 타올라 궤도에 존재하고 싶어 비행의 끝에서 너의 소원을 들어줄게 아마 그건 네가 가졌던 힘과 용기일 거야,2,0,-5,0,-5
464,빛을 잃어가는 마음과는 달리 채워지는 도시의 별은 하나둘씩 늘어가고 자리를 찾아가는 퍼즐처럼 맞춰지는 세상 속을 벗어나고만 싶어 날 향한 시선에 감추기만 했던 마음의 목소리를 소리 외치면 스치는 바람을 더없이 가벼워진 마음은 안의 나를 깨우게 해 잿빛 세상을 등지고 도시를 달려봐 맘 가는 대로 가로질러 가볼래 날 위해 그곳이 어디든 날개를 펼치고 비행 쏟아지듯 펼쳐진 길 위로 모든 걸 던져 런 런 런 높은 플라이 플라이 플라이 클리어 자신을 발견한다다 시 빛나는 나를 높은 클리어리 어둠 속눈을 감고 다시 꿈을 꿔 길을 잃어버린 두 눈과는 달리 선명해진 안의 꿈은 조금씩 커져가고 앞이 보이지 않던 까맣게 번진 어둠도 더는 두렵지 않은 걸 날 향한 시선에 감추기만 했던 마음의 목소리를 소리 외치면 스치는 바람을 더없이 가벼워진 마음은 힘껏 발을 밟게 해 잿빛 세상을 등지고 도시를 달려봐 맘 가는 대로 가로질러 가볼래 위해 그곳이 어디든 날개를 펼치고 비행 쏟아지듯 펼쳐진 길 위로 모든 걸 던져 두려움은 잊고 바람을 느껴 뒤돌아보지 말고 나의 길을 믿어봐 목적지는 없어 핸들을 잡은 건 나니까 잿빛 세상을 등지고 도시를 달려봐 맘 가는 대로 가로질러 가볼래 위해 그곳이 어디든 날개를 펼치고 비행 쏟아지듯 펼쳐진 길 위로 모든 던져 높은 클리어 자신을 발견한다다 시 빛나는 나를 클리어리 어둠 속눈을 감고 다시 꿈을 꿔,2,0,0,-5,-5
465,오늘도 부은 얼굴로 눈을 떠 술 때문인지 하루를 시작해야 해 나이는 먹고 돈은 벌어야 하니까 이렇게 시간은 흘러가 청춘도 그냥 흘러가버리네 그냥 이렇게 지금을 즐기면 돼 순간에 행복하면 돼 흘러 흘러가 시간은 자꾸만 흘러가 아무것도 기다려주지 않아 쉼 없이 계속 흘러 우리의 청춘은 모든 일은 흘러갈 거야 흐르는 대로 둬 뒤돌아봤을 생각하겠지 어렸었구나 내게 주어진 순간에 행복하자 젊음은 흘러가니까 흘러 시간은 자꾸만 아무것도 기다려주지 않아 쉼 없이 계속 우리의 청춘은 모든 일은 흘러갈 거야 흐르는 데로 둬 자꾸만 아무것도 기다려주지 않아 쉼 없이 계속 우리의 청춘은 모든 일은 흘러갈 거야 흐르는 데로 둬,2,0,0,5,5
466,잃어버렸어 날개를 뒤를 돌아봐도 없어 원에서 회전이 길 위에서 헤매다 조금씩 지쳐가 생각나게 합니다 상기시켜 주십시오 복잡한 미로에 갇힌 나의 과거는 미래를 위한 준비라고 주저하지 마 멈춰진 시계를 뒤로 돌려봐 상자를 벗어나 잃었던 나를 찾아 그래그래그래 내가 간다 날 멈출 순 없어 내가 간다 시작과 끝이 없는 고리 안에서 시작해 여기에 간다 망설이지 마 믿음을 가져봐 여기에 원하던 꿈을 이뤄 높이 올라 위로 눈 감고 느껴 하늘 위 푸른 휘파람 때로는 한 번 아래를 모든 손끝에 퍼즐 같아 생각나게 잘 기억해 상기시켜 주십시오 빛나도록 세상은 흐렸다 맑았다 계절처럼 흘러 흰 구름 위로 번지는 빛 응가 끔 나도 겁나 터널처럼 눈앞을 가린 비 결국엔 언제나 태양은 제자리 내가 날 멈출 순 없어 시작과 끝이 없는 고리 안에서 시작해 여기에 망설이지 마 믿음을 가져봐 원하던 꿈을 이뤄 높이 올라 위로 세상 기대해 늘 색다른 꿈을 꿔 어디라도 괜찮아 빛처럼 자유로워 날 멈출 순 시작과 끝이 없는 고리 안에서 시작해 망설이지 믿음을 가져봐 원하던 이뤄 높이 올라,2,0,-2,0,-2
467,잠이 들지 않아 일이 있나요 작은 어깨를 달래주고 있어 작고 여린 날 내가 안아주고 있었나 뺨엔 눈물 흘러 홀로 걷는 길에서 비틀거려도 있는 밤을 안아줄 거야 반짝이는 세상이 내게 밤을 줘도 더욱 아플지도 모르지만 내일이 올 거야 하루 끝 그리움 회색빛 고요함 어두운 단어들이 세상을 덮어버리려 해 하루 끝 좋은 꿈 포근함 좋은 날 예쁜 단어들이 세상을 안아줄 테니까 괜찮아 한여름 비에 젖어도 가을 하늘 맘을 그려봐 얼어있는 겨울에 등을 움츠려 봄에 기대어 하루를 꿈꿔 하루 끝 그리움 회색빛 고요함 어두운 단어들이 세상을 덮어버리려 해 좋은 꿈 포근함 날 예쁜 안아줄 테니까 괜찮아 괜찮아 홀로 세상의 행복을 쫓아가 몰라도 옆에 있어 하루의 온기가 추워도 나의 따스한 위로가 되어 줄게,2,0,-6,1,-5
468,모든 것이 잘 될 것이라 그대 오늘 일은 잊어볼래요 모든 괜찮을 거야 따뜻하게 자장가를 불러 줄게요 사는 어렵죠 힘들죠 바쁘죠 잠에 드는 것조차도 쉽지 않네요 그대의 고민들 내가 안아 줄게요 오늘은 맘 편히 잘 수 있게 말이에요 모든 것이 잘 될 것이라 그대의 지친 눈가에 키스를 하고 괜찮을 거야 포근하게 팔베개를 내어 줄게요 아프면 서럽죠 선 버거워요 그런 밤이 되면 내가 달려갈게요 슬프면 울어요 힘이 땐 말해줘요 따뜻한 밥 한 공기를 지어 것이 될 것이라 그대의 지친 눈가에 키스를 하고 괜찮을 거야 포근하게 팔베개를 내어,2,0,-2,-2,-4
469,그때는 미처 알지 못했다며 후회하는 어른이 되고 싶지 않아서 이유야 뭐가 됐든 최선을 다해 웃어라 울어라 닳지 않는 추억이 될 테니 그것이 유일한 쓸모라 해도 누군가는 비웃는다 해도 나의 지금을 사랑해 지금은 미처 다 알 수 없어도 언젠가는 선명히 보일 그림의 조각을 찾아 이유야 뭐가 됐든 최선을 다해 웃어라 울어라 닳지 않는 추억이 될 테니 그것이 유일한 쓸모라 해도 누군가는 비웃는다 나의 지금을 사랑해 바램 없는 추억이 될 테니 그것이 유일한 쓸모라 누군가는 비웃는다 나의 지금을 사랑해,2,0,0,0,0
470,힘들지 내게만 유난히 쉽지 않았던 세상은 오늘도 이렇게 모질고 이제야 여기까지 달려왔는데 단 한 번의 실수에 무너질 같아 우린 우리가 필요해 서로의 지친 마음을 기댈 너와 내가 말이야 그대의 짙은 어둠을 줘요 모든 빛을 새겨 줄게요 기억해 아직 보이진 않아도 함께한 오늘은 별이 될 거예요 우린 우리가 필요해 텅 빈 하루를 가득 채울 너와 내가 말이야 그대의 짙은 어둠을 줘요 모든 빛을 새겨 줄게요 기억해 손에 닿진 않아도 그대의 곁을 맴도는 작은 빛을 수없이 지샌 밤 사이로 말없이 내가 서있을게요 기억해 아직 보이진 않아도 함께한 오늘은 별이 될 거예요,2,0,4,-5,-1
471,아침 시 졸린 눈을 비비며 내가 밥인지 밥이 나인지 알 수가 없어 피곤해 아직 시 벌써 지치면 안 돼 쌓인 집안일 나만 보는 무엇부터 할까 조금만 힘을 내요 기운 내요 오늘 하루 수고했어 잠들 때면 천사 같은 너의 모습 위로가 되어 지친 하루 끝에 지어지는 미소 그게 행복이죠 예쁜 옷 산 그게 언제였더라 펑퍼짐한 티 고무줄 바지 이게 제일 편해졌어 커피 한 잔의 여유를 찾고 싶어 날씨 좋은 날 나가서 거릴 걷고 싶어 조금만 힘을 내요 기운 오늘 하루 수고했어 잠들 때면 천사 같은 너의 모습 위로가 되어 지친 끝에 지어지는 미소 그게 행복이죠 아빠는 잠들 들어올까 처음부터 다시 시작 아기는 눕히면 일어날까 무겁기만 한 몸은 나아지질 않아 편히 자본 되었을까 너를 볼 때면 너무너무 조금만 힘을 기운 오늘 수고했어 천사 같은 너의 모습 위로가 되어 지친 끝에 지어지는 미소 행복이죠 해 바보가 됐나,2,0,-3,3,0
472,기적을 기다리고 있습니다 보통뿐인 나날에 당신은 나의 기적이 될 것입니다 너에게 늘 감사해 저물어 가는 해는 약속을 하지 않아요 오늘이 지나가도 날 잊지 않길 바라요 기적을 기다리고 있습니다 보통뿐인 나날에 내가 당신의 기적이 되게 해주세요 이미 너를 자랑해 저물어 가는 해는 약속을 하지 않아요 오늘이 지나가도 손을 놓지 말아요 기적을 기다리고 있습니다 보통뿐인 나날에 당신은 나의 기적이 될 것입니다 이미 너를 사랑해 저물어 가는 해는 약속을 하지 않아요 오늘이 지나가도 그대 나와 가요 그대는 나의 그대는 기적이죠 기적이죠 영원을 닮은 기다림 끝에 나를 찾아온 그대 일어나지 않을 것만 같았던 기적 너나는 항상 기적이다 랄라 보통날이 아름다운 건 그대란 기적 때문이죠 하루를 밝혀주는 건 그대란 이름의 빛이죠 너나는 항상 기적이다 너나는 항상 기적이다 이미 그대를 자랑해 그대를 사랑해 그댄 보통나의 기적이죠,2,0,-5,2,-3
473,살다 보니까 그런 날도 있더라 아무것 못 하는 그런 날 안되는 못하는 머릿속 생각만 가득 나만 이런지 이러는지 나도 잘 모르겠어 날 웃어볼래 어제보다 빛날 거야 오늘보다 아직 두려운 많지만 끝이 없는 터널처럼 어두운 길도 빛이 보일 거야 별도 잠드는 지금 새벽 세시 반 나만 잠들지 못해 생각의 생각 생각의 생각 점점 빠져들고 있어 나만 이런지 이러는지 나도 잘 모르겠어 날 웃어볼래 어제보다 빛날 거야 오늘보다 아직 두려운 많지만 끝이 없는 터널처럼 어두운 길도 빛이 보일 숨죽여 울던 시간들 내겐 없어 웃어볼래 어제보다 빛날 오늘보다 매일 주문을 외워볼게 행복하지 않을 이유는 없는 꽃을 피울,2,0,-2,-2,-4
474,어둠만이 나의 전부였던 숨이 벅차도록 달려왔잖아 말하지 않을 저녁을 먹다 경계의 끝자락 끝은 아니니까 울타리 밖에 일렁이는 무언가 모르는 별 일지 몰라 거기에 있고 싶다 거기에 갈 거야 벅찬 맘으로 궤도를 벗어나 허락하다 간 새로운 길의 탐험가 도로 너머 껍질을 깨뜨려버리자 두려움은 이제 거둬 나를 믿어 지금이 날아갈 시간도 눈앞의 끝 사뿐 넘어가 한계 밖의 여행 짜릿하잖아 녹이 슨 심장에 쉼 없이 피는 꿈 무모하대도 믿어 누구도 본 적 없는 낯선 우주 속에 겁 없이 뛰어들어 떨어지다 떨어지다 떨어지다 답답한 가슴 안에 불꽃을 피워낼래 빛나고 밝습니다 잡힐 듯이 반짝이던 무언가 꼭 달릴수록 멀어져도 결코 포기하지 않습니다 좋아지고 있습니다 여정은 이미 시작된 지 오래야 허락하다 간 끝이라 생각한 순간 도로 너머 넓은 세상이 날 감싸 안아 때로는 느릿해도 가끔은 지친대도 멈추지 않고 날아 보자도 눈앞의 끝 사뿐 너무어가 한계 밖의 여행 짜릿하잖아 녹이 슨 심장에 쉼 없이 피는 꿈 무모하대도 믿어 누가 뭐래도 가다 다치고 망가져 버거워진 항해 가다 숨 한 번 고르고 이어가면 확인 구름 너머 세상을 품에 안을래 두 눈앞의 끝 사뿐 넘어가 한계 밖의 여행 짜릿하잖아 녹이 슨 심장에 쉼 피는 꿈 무모하대도 나의 여정을,2,0,3,1,4
475,조금만 올라가면 보일 걸 말을 굳게 믿은 채 다시 살아간다 조그맣게 꿈 꿔온 세상에다 작은 발을 내딛고 다시 살아간다 도무지 알 수 없는 말들에 너무 지쳐 마음의 문을 닫고 사랑이 나의 말들이 조금만 살아간다 쉽게 오지 않을 날에 잔뜩 기대를 걸어두고 밤이 올 울다 부은 눈으로 날을 샌다 그렇게 조금만 올라가면 끝인 걸 말을 굳게 믿은 채 다시 조그맣게 꿈 꿔온 세상에다 힘 빠진 발을 내딛고 도무지 알 수 없는 말들에 너무 지쳐 마음의 문을 닫고 사랑이 나의 말들이 쉽게 오지 않을 날에 잔뜩 기대를 걸어두고 밤이 올 울다 부은 눈으로 날을 샌다 그렇게 힘이 빠진 나를 붙잡고서 마음을 다한 다 찢겨 버린 올라가면 보일 걸 말을 굳게 믿은 채 조그맣게 꿈 꿔온 세상에다 작은 발을 내딛고,2,0,-3,4,1
476,좋은 일이 있을 거야 너도 알잖아 충분히 행복해도 될 사람이란 걸 끝없는 밤은 없을 거니까 너의 아침이 밝을 거야 빠르게 흐르는 속에 매일 똑같은 하루들 채울 수 없는 맘에 쓴 커피 가득 오늘을 기억할 이유가 필요해 좋은 일이 있을 거야 너도 알잖아 충분히 행복해도 될 사람이란 걸 끝없는 밤은 없을 거니까 너의 아침이 밝을 간절히 바래 온 꿈이 어느새 소리 없이 날 찾아와 다 괜찮을 거라고 오랜 날 찾았다고 새로운 세상을 살아가라 하네 좋은 일이 있을 너도 알잖아 충분히 행복해도 될 사람이란 걸 끝없는 밤은 없을 거니까 너의 아침이 밝을 작게 열어둔 문틈 사이로 한 줄기 빛이 온 방 안을 가득히 채워가 사람이니까 밤이 다시 온대도 무섭지 않을 꿈을 꾸게,2,0,-6,-3,-9
477,어땠나요 오늘 하루 웅크린 그대의 한숨 들려줘요 내게 같은 널 어루만지면 서투른 몸짓의 가여운 손길의 떨림 달이 뜨면 은하수 되어 꿈길에 별 비춰줄게요 밤이 깊었어 눈 감아야지 달아날지 몰라 날이 밝으면 아껴뒀던 늑장 부리자 음 겁내지 마 걱정은 내어주자 구름에게 음 노래하자 멀리 바람 태워서 같은 널 바라보다가 발그란 미소의 간지러운 웃음의 설렘 달이 지면 그림자 되어 그대를 기다릴게요 자장자장,2,0,2,2,4
478,맘껏 웃으며 지금 도망가라 힘들다 해도 다시 다시 시도하십시오 누구보다 환하게 빛날 내일을 날아가 버리다 살짝 걸음을 내디뎌 조금씩 앞으로 나아가 두근거리기 시작했어 지금부터 시작이야 내가 이곳에 있는 이유는 너와 있어서인 걸 아무리 힘들다고 해도 다시 한번 일어나서 아무렇지 않은 듯이 내게 웃어주겠니 웃으세요 맘껏 웃으며 지금 도망가라 힘들다 해도 시도하십시오 누구보다 환하게 빛날 내일을 날아가 버리다가끔은 쉬어가도 확인 주저앉아지고 싶을 땐 언제나 곁에서 내가 응원해줄 테니 힘을 꿈 꿔봐 앞으로 만들어갈 너의 모습 아무리 힘들다고 한번 일어나서 아무렇지 않은 듯이 내게 웃어주겠니 웃으세요 지금 맘껏 웃으며 도망가라 힘들다 시도하십시오 누구보다 환하게 빛날 내일을 날아가 버리다가끔은 쉬어가도 확인 주저앉아지고 싶을 땐 언제나 곁에서 내가 응원해줄 테니 힘을 세상 너의 모습 지금은 자그만한 날개라도 머나먼 하늘로 날아올라,2,0,1,-2,-1
479,밤새워 울었지 멀어지기만 하는 꿈이 한심하고 서러워 나를 잊은 같아 날아가는 풍선처럼 중력도 내겐 소용없나 아웃 밀려났다고 생각됐을 알게 되었지 꿈은 가장 멀리서 있을 포기했다 느낄 더욱 선명하게 보인다는 것을 아웃 잊혔다고 생각됐을 알게 되었지 꿈은 더한 어둠 속에 있을 혼자라고 느낄 눈부시게 빛난다는 것을 아웃 두려워하지 마 꿈을 놓지 마 멀리 밀려난 아닌 높이 날고 있음을,2,0,0,-4,-4
480,살며 살아가는 행복 눈을 뜨는 것도 숨이 벅찬 것도 고된 하루가 있다는 행복을 몰랐을까 아직 모르는 많아 내세울 없는 실수투성이 아직 넘어야 할 산은 많지만 그냥 즐기는 거야 가르쳐 주지 않기에 모두가 처음 보기 우리는 세상이란 무대에선 다 같은 아마추어야 지쳐 걸어갈 수 있고 눈을 보며 웃을 수 있고 늦어져도 상관없잖아 그냥 즐기는 거야 가르쳐 주지 않기에 모두가 처음 서보기 우리는 세상이란 무대에선 다 같은 아마추어야 어디로 가야 할지 몰라서 길을 찾아 꿈을 찾아서 나의 길을 가면 꿈이 나를 기다리겠지 가르쳐 주지 않기에 모두가 처음 서보기 우리는 세상이란 무대에선 다 같은 아마추어야 서보기 내가 꿈을 꿀 소원이 할거야 삶에서 꿈이 이루어집니다 내가 꿈을 꿀 소원이 할 거야 삶에서 꿈 꿈은 이루어진다,2,0,-4,-5,-9
481,우리는 다시 상승합니다 심장은 울리고 가슴 가득 채운 큰 꿈이 있잖아 세상을 등지고 꿈 한가운데 힘껏 타올라 원하는 모습과 지금의 나의 모습이 다르게 흐를 하늘을 가슴속에 숨겼던 푸른 꿈을 펼쳐 조금만 힘을 내줘 너의 손을 잡아줄게 다시 한번 힘을 내줘 너의 꿈을 안아줄게 가슴은 뜨겁고 두 눈에 가득 고인 큰 꿈이 있잖아 세상을 흔들어 열정의 빛으로 힘껏 타올라 원하는 모습과 지금의 나의 모습이 다르게 흐를 하늘을 가슴속에 숨겼던 푸른 꿈을 펼쳐 조금만 힘을 내줘 너의 손을 잡아줄게 다시 한번 안아줄게 하늘을 가득 채운 꿈 조금만 손을 잡아줄게 한번 안아줄게 우리는 상승합니다 우리는 상승합니다,2,0,-3,0,-3
482,거친 숨을 한 번 몰아쉬어보고 쉴 틈도 없는 똑같은 하룰 보내고 네모난 틀 속에 갇힌 모습 높아진 벽을 허물고서 달릴 거야 세상 누구가 날 막아도 이겨낼 거야 잔인한 세상 혼자지만 포기 못해 천 번 넘어져도 다시 한번 달려갈 거야 날개를 펴고 훨훨 날아다닐 나의 미랠 향해 높게 파리 어두운 밤도 앞을 막진 못할 하늘 별이 앞을 밝혀 테니까 세상이 날 몰아세워도 숨이 멎을 후회 없이 웃을 세상 누구가 날 막아도 이겨낼 잔인한 혼자지만 포기 못해 천 번 넘어져도 다시 한번 달려갈 날개를 펴고 훨훨 날아다닐 나의 미랠 향해 높게 파리 천 번의 실패 그까짓 거 겁나지 않아 넘어지면 일어설 테니까 다시 한번 도전할 테니까 누가 뭐래도 달리 나를 이겨낼 하늘 위에 새들처럼 자유로워 꿈을 꾸기에 사는 나를 사랑하니까 접었던 가슴을 활짝 펴고 다닐 나의 미랠 향해 높게 파리,2,0,3,2,5
483,몰래 웃고 몰래 울고 모습을 숨기면서 버거운 하루를 보내고 오늘도 겉으로는 말 못 한 마음속으로만 되새긴 힘들어 힘들어 힘들어 힘들 때면 나에게로 안겨도 돼 나도 같아 숨기고 숨겨도 가려지지 않는단 걸 알잖아 서로는 웃을 수 있게 미안하지 마 걱정하지 마 무서워하지 마 울지 나에게는 넌 한없이 너무도 소중한 걸 오늘 하루도 힘들었을 너에게 말해줄래 내가 있다고 수고했다고 사랑한다고 꽉 안아준다고 힘들 때면 나에게로 안겨도 돼 나도 같아 숨기고 숨겨도 가려지지 않는단 걸 알잖아 서로는 웃을 수 있게 미안하지 걱정하지 무서워하지 울지 나에게는 넌 한없이 너무도 소중한 오늘 하루도 힘들었을 너에게 말해줄래 내가 있다고 수고했다고 사랑한다고 꽉 안아준다고,2,0,2,-2,0
484,한걸음 한 걸음이 서툴러서 매일 괜찮을까 잘할까 걱정만 하던 날들 별거 아닌 고민들로 어둠이 드리웠을 낮은 목소리 날 달래던 맘의 멜로디 시간은 나를 홀로 서게 해 좁고 먼 듯한 길 위에 겁도 없이 처음 내딛는 시작의 발걸음 길 끝이 어딜지 거친 오르막인지 대답도 없는 먼 곳을 향해 걸어갈 거야 꽤 먼 길을 걸었을까 가면 닿을까 굽이굽이 돌아가지만 뭐 이대로 나만을 바라보는 소중하고 빛나는 울고 웃는 친구와 나란히 길을 함께라는 이유로 두렵지 않다는 건 눈물 날 만큼 힘이 되는 걸 네가 있다면 말이야 느려도 우리라는 길 끝에 서있는 고마운 사람들과 지나온 얘기 못다 한 얘기 나누고 싶어 함께라는 이유로 두렵지 않다는 건 눈이 부시는 곳을 향해 걸어갈 거야,2,0,0,1,1
485,위로하지 마 동정하지 마 곁에 있어 필요 없어 괜찮으니까 걱정하지 마 신경 쓰지 있는 익숙하니까 듣기 싫어 모든 힘이 되는 말들 현실이 무거워 들지 못해 잠을 채울 걸 찾다가 채워지는 잔들 메마른 감정에 솔직해지지 가끔 무덤덤하지 상황이 와도 혼자인 편할 때도 외로움은 나를 잡고 하고픈 많아도 무기력에 무너져 잘 지내냐는 물음에 답변은 밝은 미소 세상 속 모두가 내게 등을 돌린 듯해 초라한 모습 한없이 작아지네 다가올 외로움에 사무쳤을 눈물을 보게 되면 부디 모른척해 줘 위로하지 동정하지 곁에 있어 필요 없어 괜찮으니까 걱정하지 신경 쓰지 있는 익숙하니까 듣기 싫어 모든 힘이 되는 말들 괜찮은데 유난 떠는지 다들 이별이 날카로워 긁혔을 뿐 금방 나아지겠지 하루 이틀 지나면 침묵의 의미는 꼭 행복하라고 눈물의 의미는 진실로 사랑했다고 그녀 떠나간다고 죽지 않으니 생이 끝난 사람처럼 날 보지 말아 줘 바람이 스치면 낙엽이 흔들리고 파도가 스치면 바다가 흔들리듯 사랑이 스친 나도 흔들렸을 뿐 눈물을 보게 되면 부디 모른척해 줘 위로하지 동정하지 곁에 있어 필요 없어 괜찮으니까 걱정하지 신경 쓰지 있는 익숙하니까 슬픔은 별거 아니라는 웃어넘기려는 네가 원망스러워 날 내버려 두십시오내게 다가오지 어차피 떠나갈 사람 정들까 무서워 아무것도 모르잖아 넌 다 아는 척하지 말아 날 위한다는 말 오지랖도 넓으셔 있고 싶으니 내버려 둬,2,0,-1,3,2
486,내일은 좋을 거야 한 걸음 한 걸음 내가 만들어 갈 테니 절대 잊지 않을래 웃음을 눈물을 나를 있게 한 오늘을 가끔씩은 혼자만 남은 모든 날 낯설게 만들어도 울어도 달콤한 눈물 나를 크게 자라게 하는 거야 아름다운 삶입니다 눈을 뜨면 펼쳐질 멋진 내일을 향해 내가 간다 많은 꿈을 꿀 거야 채워갈 날들이 내겐 너무나 많잖아 높이 바라볼 뒤돌아 보기엔 남은 날들이 많잖아 알 수 없는 내일이 있기에 설레는 오늘이 있는 울어도 달콤한 눈물 나를 크게 자라게 하는 아름다운 삶입니다 눈을 뜨면 펼쳐질 멋진 내일을 향해 내가 간다 들려와 발걸음 소리 꿈꾸던 모습 내게 다가오는 소리가 멋진 날입니다 눈을 뜨면 펼쳐질 내일을 향해 간다,2,0,-5,8,3
487,어디쯤 나아온 걸까 좌표 없는 허공 속을 헤매는 듯해 아득한 꿈일 뿐일까 현실보단 환상에 가까운 채 시야를 가리던 먹구름이 걷힐 쏟아지는 빛에 아찔한 높이의 열기를 실감해 멀리 태양이 나를 환히 비추면 긴 비행 속의 의밀 다시 선명히 깨달아 단 한 번 쉴 새 없는 날갯짓에 날 에워싼 바람이 작게 흔들릴 지구 반대편에 닿아 폭풍이 되지 않아도 날아오를 수만 있다면 그냥 날아갑니다 아름다운 빛을 향해 높이 올라 높이 날다 늘 그려왔던 꿈을 향해 날갤 펼쳐 나비 한계와 마주하며 날아라 날 돌아보니 여기에 너무 높습니다 하염없이 달리니 끝에는 빛들이 기다리고 있어 꿈꿔오던 일들이 펼쳐져 눈앞에서 꿈의 아름다움 속에서 다시 발견한 한계에 닿아도 늘 멈추진 않을래 멈춘 두 발밑은 아찔한 높이의 추락이기에 바람이 밀어주지 않아도 더는 떠밀리지 않고 방향대로 날아 강해진 나의 날갯짓에 나날아 가면 그래날 에워싼 바람이 크게 흔들릴 지구 반대편에 닿아 역풍이 되어 온대도 날아오를 수만 있다면 그냥 날아갑니다 아름다운 빛을 향해 높이 올라 날다 늘 그려왔던 꿈을 날갤 펼쳐 나비 날 이끈 태양이 태우고 삼킨대도 그보다 뜨거워진 심장으로 태양 속을 파리 아름다운 빛을 올라 날다 그려왔던 꿈을 날갤 펼쳐 나비 그냥 날아갑니다,2,0,-1,-1,-2
488,뱉은 숨을 마신 뒤 한숨만 남겨뒀지 네가 나를 떠난 뒤 오늘만 살게 됐지 둥글고 둥글고 둥글다 빌어 네가 뒤돌아보길 나를 높고 낮게 만드는 소리 날 보러 와줘 만나도 문제겠지 말도 없겠으니 마주한 채로 마스크 뒤에 그래그래 당신이 웃고 있는지 궁금합니다 누가 당신이 울고 있는지 궁금합니다 마스크로 물어보겠습니다 외로워하지만 당신이 노력하고 있다면 예라고 말해 빛을 내기 다 타버렸어 너를 내일도 버티겠어 둥글고 둥글다 믿어 네가 날 알아보길 나를 높고 낮게 만드는 소리 기억해내길 눈물 젖어 있겠지 숨을 머금은 채로 나만 바라보면서 마스크 뒤에 그래그래 웃고 있는지 궁금합니다 누가 울고 마스크로 물어보겠습니다 외로워하지만 노력하고 있다면 예라고 말해 이름을 불러줘 예전처럼 다시 한번 거리를 좁혀줘 운명처럼 다시 두 번 비와 통증이 떨어지고 있습니다 하지 마십시오 건조됩니다 보고 싶어 가까이 그들이 말을 하든 텍스트 뒤에 그래요 마스크 그래그래 웃고 누가 울고 마스크로 물어보겠습니다 외로워하지만 노력하고 있다면 예라고 말해 이름을 불러줘 예전처럼 다시 한번 거리를 좁혀줘 운명처럼 두 번,2,0,2,-3,-1
489,아마 나만 길인가 조마조마 맘을 졸여 끝을 떠는 나침반을 쥐고 이리저리 마구 흔들려 짜릿하고 신나지만 조바심도 같은 무게 한 발 한 발 가다 물음표투성이 미로 정답이 따로 없는 퀴즈 채점은 아주 먼 훗날 그마저도 내가 나에게 되물을 뿐 말을 건네게 될까 너머 길의 끝에서 마주할 그날의 내게 우리는 싱글 라이더입니다 여도 외로운 여행 빈칸만 가득한 지도와 편도의 티켓 청춘 꿈꾸는 여행자 닿을 곳을 모르는 비행 어디쯤 날고 있을까 헛걸음해 속 끓이며 헤매던 길에 이리 덩그러니 잰 걸음에 발 덜그럭대 젊음이란 다 그런 거라는데 뭐라 뭐라 멋진 말은 많아 뭐라는진 아직 잘은 몰라 별을 어깨에 메고 무한의 삼각 계단 끝없이 오르고 내리는 아이가 돼 붉은 사막의 오프로드 오목이 패인 새카만 늪 쉬는 곳도 길잡이도 묘해 그럴 때는 눈에 띄질 않아 그러다 문득 고갤 들면 아스라이 일렁이는 투명한 햇살 다시 한 걸음 우리는 싱글 라이더입니다 여도 외로운 여행 빈칸만 가득한 지도와 편도의 티켓 청춘 꿈꾸는 여행자 닿을 곳을 모르는 비행 어디쯤 날고 있을까 눈 감고 바람을 느껴봐 뜨겁게 힘차게 당당히 걸어가 에돌아가더라도 끝내 찾게 될 거야 꼭 맞은 퍼즐처럼 완전한 나의 길을 우리는 싱글 라이더입니다 여도 외로운 여행 빈칸만 가득한 지도와 편도의 티켓 청춘 꿈꾸는 여행자 닿을 곳을 모르는 비행 어디쯤 날고 있을까,2,0,-1,5,4
490,우울한 하루 아래 여린 어깨를 세워 걷는 너의 모습에 슬퍼져 수 없는 하루 속에 너의 얘길 들어줄게 모든 걸 함께해 이렇게 어깨를 떨어뜨리고 걸어가는 뒷모습 슬퍼하지 마 너에게 말하고 우는 너의 옆에 앉아 너에게 하고 싶은 말이 있어 너를 내가 안아줄게 낮과 밤낮으로 좋은 일을 하십시오 너에게로 좋은 낮과 밤낮 낮과 밤낮으로 좋은 일을 하십시오 아프지 말라고 노래해 줄게 슬픔 편에 깊게 묻어둔 말들 들어줄게 내가 손을 잡아 하루들 속에 말 못 할 슬픔 들어줄게 모든 괜찮아질 거야 이렇게 발걸음 떨어뜨리고 걸어와 너에게로 슬픔 안까지 다 아픔 모든 걸 네가 내게 하고 싶었던 말들 내가 이렇게 밤낮으로 일을 하십시오 너에게로 밤낮 아프지 말라고 안아줄 테니 밤낮 아프지 말라고 부르는 노래 부르는 노래 노래해 줄게,2,0,3,-1,2
491,한 발 한 발 걸어갈 때마다 하얀 카펫은 아닐 테지만 그냥 나와 걸어 소녀 길보단 같은 길을 갈 테니까 응수 많은 계절을 지나쳐 온 사이 서로 눈빛은 깊어졌지만 익숙함이란 감정에 한 뼘 다가가 물끄러미 바라보면 속엔 언제나 왔던 길보다 걸어갈 길이 많잖아 당신처럼 노래하십시오 첫 맘 그대로 너를 불러 번 그래요 당신은 ~ 말해줘 당신은 ~ 맘은 변함없이 늘 그때와 같아 길 끝에서 대답해 줘 가볼까 치 앞도 떨리며 내딛지만 문을 나선 그곳의 우릴 그려 걸음이 버거울 때면 온 우릴 돌아봐 눈부실 만큼만 짙은 행복 사이 문득 아픔도 섞여 있겠지만 한발 멀리서 한눈에 다 담아보면 폭의 그림이 돼 속엔 언제나 왔던 길보다 걸어갈 길이 많잖아 당신처럼 노래하십시오 첫 맘 그대로 너를 불러 번 그래요 당신은 ~ 말해줘 맘은 변함없이 늘 그때와 같아 길 끝에서 대답해 줘 가볼까 너와 눈앞에 펼친 긴 축복 속을 향해 걸어 문을 나설 서로의 곁에 지금처럼만 너와 나란히 당신처럼 노래하십시오 눈물 없이 늘 웃음만 가득히 꼭 이대로 영원히 곁엔 언제나 왔던 길보다 길이 많잖아 첫 맘 그대로 너를 불러 번 그래요 말해줘 맘은 변함없이 그때와 같아 길 끝에서 대답해 줘 가볼까 말해 주세요,2,0,-2,-6,-8
492,언제나 찬란한 너에게 형이 해줄 말이 있어 작지만 소중한 너의 꿈은 오늘도 빛나고 있어 세상은 차갑고 숨 막혀도 넌 절대로 혼자가 아니란 걸 언젠가는 잘 될 거라 흔해빠진 위로보다 넌 지금 자신을 잘 모른다고 늦을 수도 있는 거야 거울 속의 너를 봐봐 걱정 마 충분히 너는 잘하고 있어 때로는 외롭고 힘들었어 나도 포기한 적 많아 어쨌든 살겠다며 하루를 견디고서 내일을 언젠가는 잘 될 거라 흔해빠진 위로보다 넌 지금 자신을 모른다고 늦을 수도 있는 거야 거울 속의 너를 봐봐 걱정 마 충분히 너는 잘하고 많이 부딪쳐봐 많이 넘어져 다시 일어서면 된 거야 언젠가는 될 다짐했던 그날처럼 너에겐 향기가 남아있다고 늦을 수도 있는 거지 세상 속에 나갈 걱정 마 충분히 너는 잘하고,2,0,-1,4,3
493,어지러워 어지러워 어제부터 약도 소용없고 오후가 다 되도록 나아지질 않네 서둘러 서둘러일은 해야지 봉합한 알 먹고 오늘도 하루를 시작해 볼까 해 바쁘지만 여유롭게 어긴 한숨은 무의미해 잠깐만 눈을 감고 상상을 해 파도 일렁이는 바다를 잠깐만 눈을 감고 상상을 해 향기 가득한 바람결을 넘치지 않게 에너지를 조절 잘하지 음에 방전이 다 되면 쓰러질지도 몰라 새우잠을 자든 에너지 드링크를 먹든 배터리가 다 닳지 않게 충전을 잘 해야 바쁘지만 여유롭게 어긴 한숨은 무의미해 잠깐만 눈을 감고 상상을 파도 일렁이는 바다를 향기 가득한 바람결을,2,0,2,11,13
494,때론 너무 멀게 느껴져도 우린 할 수 있어 오너는 안된다고 아직 멀었다고 해도 다시 일어나 내겐 이것밖에 없잖아 우린 이뤄낼 거야 이유는 너도 알아 당신이 가야 당신은 가야 합니다 이제는 버릴 수도 한편에 묻을 수도 없잖아 내겐 전부잖아 지금 순간에도 원하고 있잖아 지금 순간에도 가슴이 뛰잖아 모두가 미련하다 해도 끝이 안 보인대도 마음이 가는 대로 나아가 꿈의 꿈 꿈의 꿈 결국엔 결국엔 이룰 거야 꿈의 꿈 꿈이 내겐 더욱 간절한 걸 꼭 꼭 해낼 거야 꿈이 때론 포기하고파도 이겨 낼 수 있어 서툴러도 가끔은 넘어져도 오난 다시 일어나 이것밖에 없잖아 우린 이뤄낼 이유는 너도 알아 당신이 가야 당신은 합니다 이제는 버릴 수도 한편에 묻을 전부잖아 지금 순간에도 원하고 있잖아 가슴이 뛰잖아 모두가 미련하다 해도 끝이 안 보인대도 마음이 가는 대로 나아가 결국엔 이룰 꿈이 더욱 간절한 걸 꼭 해낼 그토록 내가 되고 싶던 나를 조금씩 닮아가 포기하지 마 눈을 뜨는 순간 꿈꿔왔던 너와 가까워져 원하고 있잖아 가슴이 뛰잖아 모두가 미련하다 끝이 안 보인대도 마음이 가는 대로 나아가 이룰 더욱 간절한 걸 해낼,2,0,3,5,8
495,반복되는 일상 속에 맘은 멍투성이네 주위를 둘러봐도 하품만 나오고 잘난 사람들 속에서 울적한 밤을 꾸역 삼키고 회색 바탕에 꿈을 그리네 아름다운 마음 순수했던 추억으로 넘어져 눈을 감고 세상이 날 알아 봐주지 않아도 소리쳐 오고 있습니다 언젠간 알게 될 거야 진심을 아름다운 마음 잘해야 할 같은 부담 이걸 이겨내는 것도 몫인 거 나도 알아 열심히 일합니다 눈물을 삼키네 아름다운 마음 고단했던 추억으로 넘어져 눈을 감고 세상이 날 알아 봐주지 않아도 소리쳐 오고 있습니다 언젠간 알게 될 거야 진심을 반복되는 일상 속에 맘은 멍투성이네,2,0,-2,4,2
496,고요한 널 닮은 파도 흔한 말 그런 말도 하나씩 보내 내가 알던 너완 다를 수밖에 전 괜찮아요 괜찮아 괜찮아널 꽉 안아줄 텐데 그냥 마음을 맞춰줄 메트로놈처럼 가끔 있는 느낌 세상 모두가 기분을 알겠지 아무렇지 않은 듯이 그냥 넘김 커튼을 걷어버리고서 창문 밖을 보지 오늘 하루 꼭 뭘 하지 않아도 돼 좋아하는 영활 보며 맛있는 것도 좋아요 요즘 많이 지쳐 보여 티가 너의 말투 안쓰러워 떠들던 소리들이 사라지고 남은 밤엔 곁에서 너를 위해 노래해 곁에 없다고 느껴질 항상 내가 있다는 걸 잊지 마 쉬어가고 싶다가도 뒤처질까 다시 일어나는 너의 볼을 쓰다듬어 목소릴 베고 눈을 감아 고요한 널 닮은 파도 흔한 말 그런 말도 하나씩 보내 내가 알던 너완 다를 수밖에 전 괜찮아요 괜찮아 괜찮아널 꽉 안아줄 텐데 그냥 마음을 맞춰줄 메트로놈처럼 시간이 필요하면 것까지 가져가 속에서 널 재워주고 싶어 매일 밤 오랫동안 들인 아픈 맘은 어느새 빙판이 되니까 미리미리 녹여내 버리자 우울할 때마다 쓰던 일기장 어느새 비어있어 신기해 존재 자체가 삶에 이유가 돼 나도 너한테 위로가 될게 노력해 남들과 비교하지 않기 넌 충분히 사랑받을 자격 있지 사랑이 가득한 삶을 보내자 매일 떠오른 나쁜 기억은 잠깐이야 감기 고요한 닮은 파도 흔한 말 그런 말도 하나씩 보내 알던 너완 다를 수밖에 전 괜찮아요 괜찮아 괜찮아널 꽉 안아줄 텐데 마음을 맞춰줄 메트로놈처럼,2,0,1,-2,-1
497,지쳐 힘들 때도 있지만 그게 마지막은 아닌 걸 누구보다 잘 아는 네가 안에 있잖아 지금 말 믿기지 않아도 누구보다 잘 알잖아 너는 지금 너에게 힘내라는 말을 하고 싶은 거잖아 한 번 웃어봐 두 번 웃어봐 그렇게 어느새 미소 짓는 네가 될 거야 웃어봐 크게 잊지 마 소중한 건 네가 활짝 웃는 거야 할 수 당신처럼 하지 않습니다 사실 알아 누구보다 힘을 내고 있는 널 알아 웃는 보조개가 예쁜지 한 번 두 그렇게 어느새 미소 짓는 될 거야 크게 잊지 마 소중한 건 활짝 웃는 그렇게 모든 걸 내려놓고 한 번쯤 미친 듯이 크게 기억해 세상 가장 아름다운 미소를,2,0,-4,5,1
498,써버린 것일까 모자란 지금을 손 틈새로 스쳐지나는 바람 같은 시간들 오랜 열병처럼 앓게 하던 사랑과 무릎 휘청이게 하던 세상과 안에 춥게 서있던 어디까지 온 걸까 매달리는 것들과 나를 믿어주는 사람들 큰 바램 같은 없이 할 수 있다면 손 내밀면 점점 멀어지는 내일과 늘 조금씩 아쉬웠던 어제와 막연한 오늘의 지금 어디쯤에 있을까 삶이란 바다 위에 저만치 나를 기다리는 무지개와 같은 꿈을 찾아서 믿을게 지치지 않고 나갈게 사랑하는 사람들과 아직은 것이라 말할 수 없고 끝을 알 수 없는 시간은 먼 바다처럼 펼쳐져 날엔 두려울 만큼 잔잔하고 날엔 사납게 출렁이지 삶이란 그런 날들과 온몸으로 부딪치는 고단한 이야기 내가 사랑하는 사람들 아무 없이 행복하길 눈에 보이지 않는 것의 소중함을 깨닫게 되길 어리석지 않는 두 눈을 갖게 되고 항상 따듯한 두 손을 가지길 옮음과 그름 흔들림 없는 내가 되길 삶이란 바다 위에 어누날 문득 지도에도 없는 나만의 섬 하나를 찾게 되는 평생을 나와 한 하나뿐인 사람을 만나게 될 있기를 만나게 되기를 내가 사랑하는 사람들 아무 없이 행복하길 눈에 보이지 않는 것에 소중함을 깨닫게 되길 어리석지 않은 두 눈을 갖게 되고 항상 따듯한 손을 가지길 옮음과 그림 흔들림 바다 위에,2,0,-3,2,-1
499,지금 온 마음이 우리들을 위로해 지금 온 우주가 우리들을 감싸네 쓸쓸하다고 생각했지 살아가는 건 섬에서 홀로 부르는 노래하지만 비가 오는 날에도 새들은 노래를 멈추지 않는단다 푸른 우울 파도쳐 가슴에 멍이 하나씩은 들었겠지만 지금 온 마음이 우리들을 위로해 실은 우주가 감싸네 바람 불어오는 마침 시원하지 않니 실은 바람이 우릴 위한 선물이야 갈수 없는 길은 없다고 믿고 있었지 믿음은 바위 같았지만 바람 앞에 놓인 촛불처럼 희망이 꺼져버린 날도 있었네 짙은 슬픔 밀려와 가슴에 구멍이 하나씩은 생겼겠지만 마음이 위로해 실은 우주가 감싸주네 바람 불어오는 마침 싱그럽지 않니 바람이 우릴 위한 선물이야 내가 당신의 팬을 걱정하지 마십시오 내가 당신의 팬을 걱정하지 마십시오 내가 당신의 팬을 걱정하지 마십시오,2,0,3,3,6
500,세상이란 장애물이 너의 앞길을 가로막을 날 언제나 너의 곁엔 내가 있어 불안 따윈 도 없을 테니 이렇게 언제나 내가 너를 지켜줄게 나를 믿고 거친 세상이지만 나를 믿고 나와 함께라면 갈 준비가 되었습니다 창밖으로 비쳐오는 태양 시시각각 바뀌는 구름의 모양 공기를 가르며 와닿는 바람의 향기가 느껴지니 이렇게 언제나 내가 너를 지켜줄 테니 나를 믿고 거친 세상이지만 나와 함께라면 갈 준비가 되었습니다 가자 우리가 갈 멀리 떨어져 가십시오 다행이지 나의 옆이 너라서 어깨에 기대어 손을 꼭 잡고 어디로든 가자 거친 세상이지만 나와 함께라면 준비가 되었습니다 가자 우리가 멀리 떨어져 가십시오,2,0,-1,7,6
501,푸른 새벽 잠들지 못하는 널 보며 너의 꿈의 무게를 너의 작은 한숨이 내게 들릴 때면 안아주고 싶었어 사람들은 꿈을 위해서라면 지친 모습도 견디라 노래로 널 지켜줄게 너의 꿈의 무게를 내게 나눠줄래 들어줄게 불안했던 하루가 널 상처 때면 어깨에 기대도 돼 영원히 여기에 있습니다 곁을 지킬 거야 영원히 여기에 있습니다 있잖아 누구보다 마음 잘 알고 있어 외로움 말이야 어두운 밤 안개가 걷히면 앞에 펼쳐질 너만의 날개를 기대해 하늘을 노래로 지켜줄게 꿈의 무게를 내게 나눠줄래 들어줄게 불안했던 하루가 상처 때면 어깨에 기대도 돼 영원히 여기에 있습니다 곁을 지킬 거야 드높은 절벽 위에 서서 두려움이 너를 삼킨대도 용기를 가진 너를 꿈을 가진 너를 길 위의 내가 지켜줄 거야 하늘 위를 날게 되어 무게가 다 사라지는 날 그날이 오면 노래를 기억해줄래 불안했던 날들을 함께했던 노래를,2,0,-3,-3,-6
502,메이데이 귀찮아 다들 날이 한 번쯤은 있잖아 매일매일 뭘 해도 귀찮아 이놈의 낮밤은 좀처럼 맞질 않아 알람을 맞추면 뭐 해 듣질 않아 괜찮아서 중독되어 있습니 맛있는 거 사준다면 언제든 확인 위험해 이불 밖은 상관없어요 내일 일은 잠이나 자야겠네 하루 종일 해도 확인 잘 됐으면 좋겠어 미뤄뒀던 청소도 내일은 할게 넘어가 줘 좋게 좋게 하루 종일 해도 언제나 잘 됐으면 좋겠어 긴가민가 불안하기는 잘 됐으면 좋겠어 그랬으면 작은방 한편을 꾸며놓고 나만의 세상을 칠해 때때로 도망칩니다 오늘의 운세는 좀처럼 맞질 않아 멋진 일은 유독 내게는 오질 익숙해 다 괜찮아 맛있는 거 사준다면 어디든 확인 위험해 이불 밖은 잠이나 자야겠네 하루 종일 미뤄뒀던 청소도 내일은 할게 넘어가 줘 좋게 언제나 긴가민가 불안하기는 그랬으면 눈을 뜨면 그럴 때면 잊고 있던 불안들이 나를 깨워 이럴 때면 미뤄뒀던 잠든 걱정들이 밀려와 위험 위험 위험 어지럽게 날 둘러싸고선 멈춰야 되는 건지 청소도 내일은 할게 넘어가 줘 언제나 긴가민가 불안하기는 그랬으면,2,0,-1,-2,-3
503,이런저런 이유에 완성된 틀 속에 갇혀 있던 자유를 몰랐어 꼭 묶여 있는 맘을 풀어야겠어 나를 막지 마 당신은 할 수 있습니다 지금 나를 멈추십시오 할 수 있는지 같은 일을 한다 맘껏 누리고 싶은데 좋아하는 걸 다 가질 수 있게 마지막까지 도전할 거야 아니에요 무엇을 해야 하는지 말하는 것을 좋아합니다 그것 인생은 규칙을 만들어냅니다 모든 걸 해낼 있어 보여줄게 그렇게 길에 상상했던 세상과 달랐던 현실에 부딪히며 달려가고 있어 바람에 날린 머리가 눈을 가려도 멈출 없어 길 끝까지 할 있는지 같은 일을 한다 아직 잘 하고 있는데 좀만 가보면 빛이 날 텐데 아닐 거라며 나를 막는 거짓말 돈을 하지 않는다 무엇을 해야 하는지 말하는 것을 좋아합니다 그것 인생은 규칙을 만들어냅니다 모든 걸 해낼 있어 보여줄게 그렇게 그냥 자신의 방식으로 가십시오 꿈꾸는 대로 꿈꾸는 대로 그렇게 그들이 말하는 것을 신경 쓰지 마십시오 그들이 말을 하는지 상관없어 돈을 하지 않는다 무엇을 해야 좋아합니다 그것 인생은 규칙을 만들어냅니다 모든 해낼 보여줄게 그냥 가서,2,0,-3,3,0
504,현진아 넌 커서 뭐가 되려고 어릴 때부터 지겹게 그냥 하고 싶은 거 다 살래 그중에 노랜 첫 번째네 쟤는 뭐 돈 안 되는 걸 하려 하네 오냐오냐 커서 내가 뭐 그딴 거에 연연하지 않게 꿈이 많이 커서 날 믿었는데 미워졌네 세상은 넓고 초라해 보였네 그때는 두렵네 좋아하는 잘하는 될 땐 다들 그렇대 늘어나는 사람들의 눈 줄어드는 마음속의 문 나를 짓누르는 책임감 아래 가라앉는 기분 지금 살아가야 해 아냐 지금 살아져 가네 나를 떠받치는 사람들 앞에 그럴듯하게 있기 위해 낯설긴 하네 사랑받는 행복이 넘친 자리엔 불안이 남네 이제는 많이 두렵네 잘하는 해야 하는 될 땐 다들 그렇대 늘어나는 사람들의 눈 줄어드는 마음속의 문 나를 짓누르는 책임감 아래 가라앉는 기분 지금 살아가야 해 아냐 살아져 가네 떠받치는 사람들 앞에 그럴듯하게 있기 위해 꿈을 이루기 위해 울던 아이가 꿈을 이룬 뒤에도 아직 울고 있네 꿈을 그리며 나아가는 두려웠지만 꾸물대다간 날 잃어버리고 말 거야 늘어나는 사람들의 눈 줄어드는 마음속의 문 짓누르는 책임감 아래 가라앉는 기분 살아가야 해 아냐 살아져 가네 떠받치는 사람들 앞에 그럴듯하게 있기,2,0,-2,5,3
505,이야기들 속에 가장 밝게 빛났던 순간 나의 하루는 매일 빠르게 지나가 버렸고 것도 내겐 두려울 없었던 순간 놓쳐버린 그때의 어두운 밤 하늘로 숨은 너를 찾아 구름 사이 보랏빛 길을 걷다 보면 어둠 마지막에야 너와 마주할 수 있을까 순간 놓쳐버린 그때의 밤 멀리 귓가에 들려오던 작은 고래 소리가 있어 하늘 빼곡히 별빛을 수놓던 너는 어디로 사라진 걸까 그리운 나의 고래 수평선 너머로 아득해 보였던 시간은 눈앞에 벌써 오늘이 되었고 잊은 알았던 그때의 하늘 한숨에 앞에 펼쳐지면 어둠은 지고 눈부신 파도 위에 길이 다시 그려진다면 끝에 선 너와 마주할 수 있지 않을까 놓쳐버린 밤 멀리 귓가에 들려오던 작은 고래 소리가 있어 하늘 빼곡히 별빛을 수놓던 너는 어디로 사라진 걸까 그리운 나의 당신을 위해 길을 빛날 것입니다 두목 내가 표류하게 하자 당신은 당신의 빛을 깨울 수 있습니까 순간에 나와 항상 당신을 위해 거기에 있었습니다 이겼다 당신은 당신이 표류할 있게 해줍니다 그것 너무 밝습니다 오늘 밤을 원할 것이다 헤어지기 위해 당신이 그러기를 바란다나를 찾으십시오 멀리 귓가에 들려오던 작은 소리가 있어 빼곡히 별빛을 수놓던 넌 언제나 곁에 있던 거야 영원한,2,0,1,10,11
506,없다 해도 두렵다고 해도 아직까지 많이 남은 날들 속에 바보 해도 망설여진다 그곳에서 나를 찾는 일들 좋은 걸 너무나도 많은 걱정 속에 그렇게 나를 묶어둔 채 살았고 이렇게 나에게 편지를 써 당신이 서십시오 당신이 서있다 당신이 서십시오 서십시오 이렇게 나에게 편지를 써 서두르지 않고 천천히 걷다 보면 나를 둘러싼 세상 끝 어딘가에 두 발을 힘껏 내디뎌 내가 상상했던 내가 꿈 꿔왔던 그곳에 있는 찾게 될 거야 때론 너무나도 많은 걱정 속에 그렇게 묶어 둔 채 살았고 이렇게 너에게 편지를 써 서있다 너에게 서있다 때론 많은 일들이 날 비웃어 대지만 노래는 다시 한번 일으켜 붙잡아 줘 원했던 그곳으로 때론 너무나도 걱정 그렇게 너를 묶어 둔 채 살았고 너에게,2,0,3,1,4
507,우리가 응원하는지 보세요 깊은 바닷속으로 끝없이 들어가는 것처럼 우리가 치열하고 아름답게 완성되고 있어 우린 헤매고 있네 무언가 찾기 아직 그대로인데 멀어지는 듯해 걱정도 다시 찾아왔지 눈 부신 아침 어젯밤 꿈을 산책해 한참을 지나고 보니 아무렇지 않게 여기서 우린 서있네 우리가 응원하는지 보세요 깊은 바닷속으로 끝없이 들어가는 것처럼 치열하고 아름답게 완성되고 있어 우린 가끔 네가 날 안아줬을 백 마디 말보다 용기를 주네 사랑에 빠진다 가끔 너와 마주 볼 말보다 용기를 주네 필요합니다 보릿자루 꿔다 놓은 가만히 앉아있는 것은 토하기 전까지 일하는 것보다도 괴로운 거야 남기자 살아있는 동안의 흔적 깨어있는 말도 안 되는 걸 해야 하니까 잘 자고 잘 먹고 칭찬도 하고 서로 부둥켜도 안고 사랑하면서 응원하는지 보세요 깊은 바닷속으로 끝없이 들어가는 것처럼 치열하고 아름답게 완성되고 있어,2,0,-6,3,-3
508,나의 힘 고등학교 에너지 맑은 땀방울로 세상의 비교와 전혀 무관한 힘 나의 꿈 시너지를 강조하십시오높은 별빛처럼 세상의 가치와 아무 상관없는 꿈 현실의 벽을 넘어 보이겠어 마침내 활짝 웃어 보이겠어 맘껏 나를 믿을 뿐 나를 버리지는 않겠어 자체로 감각 감각 감각이다 나의 충분히 높은 이미지 투명한 눈길로 세상의 경쟁과 무심한 현실의 벽을 넘어 보이겠어 마침내 활짝 웃어 맘껏 나를 믿을 뿐 버리지는 않겠어 자체로 감각 감각이다 힘껏 너를 믿을게 너를 바꾸지는 않겠어 이미 넌 충분히 아름다워 아름다워 당신은 아름답습니다 맘껏 믿을 뿐 버리지는 자체로 감각이다,2,0,-5,4,-1
509,문득 창밖을 바쁜 세상 속에 멈춰서 답을 찾지 못한 채 의미 없이 달려나갔지 날 돌아봤을 땐 사랑할 수 있을까 알아주길 바랐어 나도 노력하고 있단 걸 손을 잡아줘 어두운 안에 너무 외롭지 않게 길을 걷다 문득 하늘을 멍청히 위로라도 하듯 유난히도 파랗구나 날 바라봤을 땐 사랑할 수 있을까 알아주길 바랐어 나도 노력하고 있단 걸 손을 잡아줘 어두운 안에 너무 외롭지 않게 가끔 살다 보면 맘처럼 되지 않을 때도 있죠 모든 걸 헤아릴 순 없겠지만 포기하지 마요 언젠간 알아줄 테니 알아주길 바랐어 나도 노력하고 있단 손을 잡아줘 어두운 안에 너무 외롭지 않게,2,0,0,-1,-1
510,나의 꿈 얘기할게 온통 들떠 있었던 해를 쫓아 위험한 꿈이야 뜨거운 열기도 참으며 힘껏 날개를 저어 올라갔지 눈도 뜰 수 없었지 뭔가 찾아야 했어 노란 폭풍 속에 숨겨진 뭔가를 숨이 막혀와도 참으며 가까이 가까이 그때는 어린아이였지 상상의 나라에 있다는 꿈꾸는 태양 어서 자라나길 이제 날아올라 꿈에 가까워지는 거야 놓칠 수는 없잖아 오늘까지 견뎌낸 모습 있잖아 여린 날개를 펴봐 갈수 있을까 이겨낼 수 있을까 날개가 다 타버리면 모든 사라져 어린 기억을 떠 올리며 가까이 그때는 작고 초라했지 언제나 가야 할 그곳을 꿈꾸며 나를 지켜왔지 이제 날아올라 꿈에 가까워지는 거야 놓칠 수는 없잖아 오늘까지 견뎌낸 모습 있잖아 여린 날개를 펴봐 날 기억한다면 지켜주기를 바랄게요 힘을 줘요 힘을 줘요 이제 날아올라 꿈에 가까워지는 거야 놓칠 수는 없잖아 오늘까지 견뎌낸 모습 있잖아 여린 다시,2,0,3,-1,2
511,여느 때완 달리 쳐져 있는 어깨 위에 세상 모든 근심 짊어진 우울해 보여 늘 사람들의 고민을 해결해 주던 네가 그렇게 힘이 없으니 눈치만 보여 마음속에도 말할 수 없는 고민 있다면 내게 한번 털어놔 항상 편입니다 내가 도울 차례야 웃어넘겨 호호 모든 걸 털어 버리고 어깰 기대 아끼는 사람들에게 싫어 너완 어울리지 않는 걸 당신은 항상 마음에 있습니다 언제든지 힘이 돼줄게 세상 모든 일이 뜻대로만 되진 않는 걸 누구보다 잘 아는 네가 되겠니 열린 가슴으로 친구를 대하라 말하던 네가 고작 정도였니 한심해 보여 마음속에도 말할 수 없는 고민 있다면 내게 한번 털어놔봐 항상 편입니다 내가 도울 차례야 웃어넘겨 호호 털어버리고 어깰 기대 아끼는 사람들에게 싫어 너완 어울리지 않는 당신은 마음에 있습니다 언제든지 힘이 돼줄게 가려진 마음속에 감당하기 힘든 그런 아픔이 있다면 내게 말해줘 호호 털어 버리고 어깰 기대 아끼는 사람들에게 싫어 너완 어울리지 않아 않아,2,0,1,2,3
512,한때 내가 세상에 사라지길 바랐어 온 세상이 너무나 캄캄해 매일 밤을 울던 날 내가 사라지면 마음이 편할까 모두가 날 바라보는 시선이 너무나 두려워 아름답게 아름답던 시절을 아파서 사랑받을 수 없었던 내가 너무나 싫어서 엄마는 아빠는 다 나만 바라보는데 마음은 그런 아닌데 자꾸만 멀어만 어떡해 시간이 약이라는 말이 내게 맞더라고 하루가 지나면 지날수록 나아지더라고 근데 가끔은 너무 행복하면 아파질까 가진 행복들을 누군가가 가져갈까 아름다운 아름답던 기억이 아파서 아픈 만큼 아파해도 사라지지를 않아서 친구들은 사람들은 다 나만 바라보는데 모습은 그런 아닌데 자꾸만 멀어만 어쩌면 세상에 밝은 빛이라도 될까 어쩌면 모든 아픔을 내딛고서라도 짧게 빛을 내볼까 포기할 수가 없어 하루도 맘 편히 잠들 수가 없던 이렇게라도 일어서 보려고 하면 날 찾아줄까 아아아아아아아 아아아아아아아 아아아아아아아 아팠을까 아팠을까 바랬을까,2,0,1,0,1
513,하늘을 볼 때마다 숨이 차는 같아 설레고 불안한 맘 어디쯤 꿈에 닿을 듯하다 멀어지는 같아 희미해져 가는 밤 어디쯤에 오기 대했던 모습이 아니어도 알아요 상상할 수 없는 내일이 좋은 같아 지금 생각 해 뭐가 그리 복잡해 누가 뭐래도 스물 뭐야 스물 뭐야 기다리지 마 내가 가는 거야 지금 생각 해 뭐가 그리 복잡해 누가 뭐래도 스물 뭐야 시작은 지금 내가 하는 거야 바람이 부는 걸까 내가 흔들리는 걸까 헤매는 밤 어디쯤 모르는 걸까 피하는 눈이 반짝였던 어디에 아프고 다친대도 뭐 알아요 다시 일어서기에 좋은 날인 생각 해 뭐가 그리 복잡해 누가 뭐래도 기다리지 마 가는 거야 시작은 하는 나와 같은 마음이라면 너도 나와 같다면 다 뭐야다 멈추지는 마 되는,2,0,6,0,6
514,키는 자라지 않는 같은데 시간은 자꾸만 재촉하네요 어른이 되기엔 아직 이른 저를 날마다 보채요 표정 없는 얼굴 축 처진 어깨 수많은 어른들의 힘겨운 모습이 모습이 될까 늘 겁이 났죠 해야 좋을까요 선생님 가르쳐줘요 서툴기만 한 저도 어른이 될까요 선생님 가르쳐주세요 누구보다 행복하게 살래요 지금처럼 이렇게 말이에요 선생님 커다란 세상에 움츠러들면 어쩌죠 어렴풋하게 그려왔던 상상 속 멋진 모습은 아니더라도 어깨를 펼게요 아주 작은 고민과 약간의 걱정 말곤 모든 즐거운 지금의 모습이 사라져버릴까 늘 겁이 나요 해야 좋을까요 가르쳐줘요 서툴기만 한 저도 어른이 될까요 가르쳐주세요 누구보다 행복하게 살래요 지금처럼 알 수 없는 미래는 누구에게나 두렵겠지만 괜찮을 같아 보여 지금 행복하다면 되어도 그렇게 다르지 않을 걸 모든 그렇듯 행복도 습관이거든 가르쳐줘요 서툴기만 한 저도 될까요 당신은 하나가 될 수 있습니다 가르쳐주세요 누구보다 행복하게 당신은 할 수 있습니다 당신은 합니다 계속 가라 살래요 지금처럼 이렇게 말이에요,2,0,-4,3,-1
515,우리는 어립니다 일으키면 다시 넘어지고 우리는 야생입니다 텄던 길도 헤매고 우리는 자유 롭습니다방황인지 날갯짓인지도 알 수가 없는 어지러운 날들 지금은 끝이 없을 것만 같은 순간이 명장면이 될 잘 할 수 아름다운 오늘은 잠들 수 없어 끝이 없는 밤 아름다운 아침은 멀고 밤은 젊습니다 곁엔 그대가 있고 아름다워 아름다워 어립니다 넘어져도 무너지진 않고 야생입니다 가면 길이 되는 걸 자유 롭습니다붕 떠있는 것처럼 보여도 사실은 날아오르고 있는 걸 알기에 아름다운 날들 지금 순간이 끝내 명장면이 될 잘 할 수 오늘은 잠들 없어 끝이 없는 밤 아침은 멀고 밤은 젊습니다 곁엔 그대가 있고 쓰러지지 않습니다 별처럼 하늘에서 높습니다 곁엔 그대가 있어 여긴 아름다움이 있어 아름다움이 있어 깨질 듯하지만 나약하지만 오늘은 잠들 없어 밤 아침은 멀고 밤은 젊습니다 있고 쓰러지지 않습니다 별처럼 하늘에서 높습니다,2,0,-4,3,-1
516,터벅터벅 발걸음에 집으로 돌아간다 허전한 마음 채울 수 없어 멍하니 하늘 본다 나를 감싸는 별빛의 위로 따뜻한 너의 노래 수고했어요 그대여 오늘도 전쟁 같은 하룰 견뎌냈죠 내일은 나을 거라는 기대를 안고 좋은 꿈 꾸길 바래요 잘해야 하는 부담 속에 살얼음 같은 하루 언제부턴지 숨기만 하는 겁쟁이 같아졌어 나를 감싸는 별빛의 위로 따뜻한 너의 노래 수고했어요 그대여 오늘도 전쟁 같은 하룰 견뎌냈죠 내일은 나을 거라는 기대를 안고 좋은 꿈 꾸길 바래요 망쳐버린 하루더라도 작아질 필요는 없어요 누구나 괜찮아 수고했어요 그대여 오늘도 전쟁 하룰 견뎌냈죠 내일은 나을 거라는 기대를 안고 좋은 꿈 꾸길 바래요 어어 예에 우우우우우 웃을 꿈의 꿈의 꿈에서 숨을 쉬십시오 드림 드림 드림,2,0,-2,1,-1
517,고개를 떨구면 시선에 닿은 색 바랜 운동화 끝은 어차피 닳는 거 슬플 필요 없다며 나를 토닥여 잘나 보이지 않은 나의 작은 한숨마저 나를 짓누르고 무거운 세상이 쌓여가 그림자도 버거울 땐 그땐 꼭 행복하지 않아도 돼 아픈 걸 참지 않아도 돼 느지막한 저녁 어스레한 티브이 소리 날 기다리다 잠이 든 감은 눈에 무너져 등을 돌려 괜찮은 척 웃어내느라 별거한 거 없이 한껏 지쳐가고 무거운 세상이 쌓여가 그림자도 버거울 땐 그땐 꼭 행복하지 않아도 돼 아픈 걸 참지 짓눌린 맘이 뭔가에 강요받듯 애써 견뎌내 보며 아무렇지 않은 척해봐도 다 닳아가는 나의 진심은 솔직해지길 바라고 있으니까 꼭 행복하지 누구나 다 그럴 수 있잖아,2,0,5,-2,3
518,알고 싶어 너의 하루는 어땠나요 괜찮아요 다 청소년을 위해 무작정 그냥 걸었어 부는 바람은 마음 알 같아서 다 큰 어른처럼 별거 아닌 것처럼 다 견뎌낼 수 있어 끝이 없는 길에서 헤매지 않길 간절히 빌었어 다시 눈을 뜨면 돌아가고 싶어 가끔은 그리워 소년 절대 울지 말아야 한다 거울 속에 비친 내가 낯설어 사라지지 않아 눈부시던 날로 매일 가고 싶어알고 싶어 너의 하루는 어땠나요 괜찮아요 때론 힘들고 때론 아파도 내게는 좋았던 기억 너와 기억 돌아가고 싶은 그런 날들은 영원처럼 가슴 깊이 남아 잊지 마 꺼지지 않는 걸 그토록 빛나던 젊음을 기억하십시오 그것은 당신입니다 빛나 당신을 위해 젊음 청소년 그것은 당신입니다 변하지 않아 당신을 위해 젊음 시간은 이기적이야 네가 아무리 발버둥 쳐봐야 무심코 너를 지나가 높이 있던 목표치와 현실과 부딪치는 괴리감 우린 어른이 되는 걸까 세상을 놀래 버리자던 다짐 간직했던 약속 그날처럼 태양은,2,0,4,3,7
519,누군가 삶 우리는 간다 항상 홀로 살아가려고 했어 하루하루가 솔로 만의 이야기였어 무인도에서도 잘만 지냈었지 벽까지 쌓으려고 했어 잡지 않는다고 이렇게 자유로 느껴졌지 어리석은 내게 착각한 우물 속에서 나와 나만을 보살펴 그런 나에게 손을 내밀던 손을 잡아 누군가 필요할 누군가가 될 것이다 우리는 인생을 위해 이것에 있습니다 나만 바라봐 어깨가 필요할 누군가가 될 것이다 우리는 인생을 위해 이것에 있습니다 외로움이고 회사입니다 팀입니다 성냥과 휘발유 꼭 가위가 양쪽 팔이 필요한 것처럼 내게 기대 기대어 당신이 항상 등을 돌려받았다는 것을 알고 있습니다 당신은 내가 알고 항상 당신을 돌아왔습니다 이제부터 누가 내게 네가 뭐라고 해도 옆자리엔 내가 있을게 당신은 그것이 사실임을 알고 널 만난 뒤에 눈이 떠졌어 공허한 곳만 보여 빈 공간을 채 웁니다 남을 위해 살아 간다는 행복을 몰랐어 이제는 거기에 있을 것이다 손을 잡아 누군가 필요할 누군가가 될 인생을 이것에 나만 바라봐 어깨가 눈물과 걱정도 다 맡겨놔 전화할 때마다 당신은 내가 옳다는 것을 옆에 거기에 있을 잡아봐 나만 바라봐 어깨가 상황에서도 눈물 흘리지 마요 한 방울 한 방울이 아까워 기대어 봐요 잡아 줄게요 세상이 등을 돌린다 해도,2,0,0,-1,-1
520,아른대는 떠나고픈 감정 거울 속엔 지친 얼굴길 잃은 맘의 갈피 반복되는 문제 필요해 미룰 수 없잖아 생명을 원인 너무 짧습니다 망설이다 흘러가 일이 벌어질까 궁금해 훌쩍 떠난 순간 방식대로 갈래 하지 않는다 간호 당신이 그것에 대해 말하는 것이 어차피 중 그렇게 하든 아니든 꿈꿔온 어딘가로 내가 멈출까요 단순하게 갈래 아니요 간호 당신이 그것에 대해 말하는 거 걸음이 닿는 대로 내가 원하는 방법 거기가 어디라도 내가 멈출까요 나만 아는 이야기 혼자만의 전기 꾸며볼래 평생 머물고픈 순간 속에 영원할 모습 남겨둘래 모든 두려워하지 마 생명을 원인 너무 짧습니다 후회 없이 걸어가 때론 비가 쏟아져도 아니에요 간호 쉬어갈 수 있는 걸 방식대로 갈래 하지 않는다 당신이 그것에 대해 말하는 것이 어차피 중 그렇게 하든 아니든 꿈꿔온 어딘가로 멈출까요 단순하게 아니요 거 걸음이 다혜는 대로 원하는 방법 거기가 어디라도 방식대로 단순하게 멋진 오늘이 곁에 있는 걸 당신은 시간을 낭비하고 있습니까 단 한 걸음으로 달라진 하룬 눈부시게 변해가 자유롭길 바라 수없이 펼쳐질 모든 날이 인생은 한 번인 걸 지금 하십시오 빛날 세상으로 늦기 전에 시간을 멈출 순 없을 테니 때로는 서툴러도 원하는 방법 거기가 어디라도 삶어 무 짧습니다 삶어 무 자유롭길 바라 늦기 전에,2,0,5,3,8
521,하루의 시작이 늘 불안해 잠들기 싫은 밤 생각하기 싫어서 온종일 아프고 싶은 날 내가 너무 미워 나와 한참 싸우고 어딘가에 있을 끝을 찾아 숨었죠 어느새 안은 너무 무거워져서 작은 몸부림도 허락할 수 없어요 천천히 고개를 들던 마음의 꽃이 시든 건 아닐까요 꺾인 꽃을 사랑스럽다고 믿어주면 덜 아플까요 날 향한 위로가 서럽게만 들리고 모진 말 들었던 기억 속에 갇혀요 어디쯤 왔을까 가늠조차 안돼서 제자리에 멈춰 한 걸음도 못 가요 천천히 고개를 들던 마음의 꽃이 시든 건 아닐까요 꺾인 꽃을 사랑스럽다고 믿어주면 덜 아플까요 초라하기만 한 나의 작은 손으로도 눈물을 가릴 수 있나요 아프게 밟히던 맘 속 어딘가는 날 사랑하고 있을까요,2,0,9,0,9
522,잠이 오지 않아서 새벽달이 길어서 밤을 헤매는 네가 편히 잘 수 있기를 바라 멍든 마음이 아파서 빛을 다 쓴 추억에 갇혀 괴로운 너의 고통이 이제는 끝나길 바라 네가 어디에 있었고 어딜 향해 걷고 있던지 무얼 잃으면서 살았고 꿈을 꾸며 살던지 마음이 힘겨웠던 시간을 안아서 노래를 듣고 있을 너에게 전할게 위로 위로 모르게 이불 속에 숨어서 눈물 흘리는 네가 다시 웃어주기를 바라 텅 빈 방 안에 혼자서 울다 지친 마음이 닫혀 외로운 너의 빈 곳이 채워지길 어디에 있었고 어딜 향해 걷고 있던지 무얼 잃으면서 살았고 꿈을 꾸며 살던지 힘겨웠던 시간을 안아서 노래를 듣고 있을 너에게 전할게 위로 여러 가지 이유가 있겠지 지금 노랠 듣는 사람들 그런 날엔 이유가 있겠지 왠지 눈가는 젖고 마를 내가 어디에 있었고 어딜 향해 걷고 있던지 무얼 잃으면서 살았고 꿈을 꾸며 살던지 힘 겨었던 시간을 안아서 노래를 듣고 있을 너에게 전할게 네게,2,0,7,1,8
523,내가 어딜 향해 가고 있는지 무얼 사는 건지 길을 잃은 채 바보처럼 헤매온 지난날 강한 척 괜찮은 척 웃고 있어도 가슴은 언제나 텅 빈 사막 세상도 사람도 믿지 않았었지 깊은 상처 삶의 히어로 다시 한번 일어설 거야 보석처럼 빛나는 꿈들이 나를 불러 꿈꾸는 히어로 끝까지 달려갈 거야 두렵지 않아 곁에 이렇게 네가 있으니까 자신의 가려있을 거짓 속에서 모르는 나의 상처 그렇게 마음을 닫은 채 살았어 못난 겁쟁이처럼 삶의 히어로 다시 한 번 일어설 거야 보석처럼 빛나는 꿈들이 나를 불러 꿈꾸는 끝까지 달려갈 두렵지 않아 곁에 이렇게 네가 있으니까 너의 따스한 마음에 나의 모든 슬픔 녹듯이 내가 너의 아픔 아물게 해줄게 내일의 다시 한 번 힘을 낼 햇살처럼 눈부신 희망이 나를 비춰 꿈꾸는 험한 세상 이겨낼 할 수 있는 걸 언제나 이렇게 너와 함께라면,2,0,9,-3,6
524,너의 두 눈은 하늘의 별처럼 반짝이고 가득 찬 달처럼 찬란하게 비추네 아무것도 보이지 않는 어두운 이곳에 사라질 멀어져 가는 내일의 빛이 되어줘 저물어가는 오늘의 나와 밝게 빛나는 내일의 네가 너의 몸짓은 저다지의 드넓은 세상이 되고 날아가는 새처럼 자유로이 춤추네 아무것도 보이지 않는 어두운 이곳에 사라질 멀어져 가는 내일의 빛이 되어줘 저물어가는 오늘의 나와 밝게 빛나는 네가 손을 잡고 춤을 추네 손을 잡고 춤을 추네 저물어가는 오늘의 나와 밝게 빛나는 네가 손을 잡고 춤을 추네,2,0,-3,10,7
525,언제까지 숨어 지낼래 나의 별의 빛은 꺼진지 오래야 캄캄한 나의 맘 환하게 비춰줄 네가 오길 간절히 기다리고 있어 두 손 꼭 잡고 다시 훨훨 날아다니고 싶어 수많은 별들 사이를 가로지르며 다시 예전처럼 날아다니고 싶어 힘들 땐 어깨에 기대 쉬어도 돼 슬플 땐 마음에 기대 울어도 돼 부족한 너의 반쪽을 채워줄게 나의 별을 밝혀줘 밤하늘이 되어줄게 숨겨진 스타 스타 스타 두려워하지 말고 손을 잡아줘 숨겨진 상처받지 않게 내가 널 지킬게 숨겨진 별 힘들 땐 어깨에 기대 쉬어도 돼 슬플 마음에 울어도 부족한 너의 반쪽을 채워줄게 별을 밝혀줘 밤하늘이 되어줄게 너와 나를 이어주는 한줄기 빛처럼 빛을 헤엄쳐 널 만나러 간절한 바람이 너에게 전해질까 무엇이든 간에 문제없어 기다리고 있어 두려워하지 말고 손을 잡아줘 상처받지 않게 내가 널 지킬게 별 별내가 지킬게 별,2,0,5,-3,2
526,넘어지면 그대로 누워버리고 하늘을 덕분에 별들을 보네 아픈 것도 잊네 혹 비가 내려 온몸이 젖어버리면 춤을 춰 도망갈 이유가 없어 언젠가는 그쳐 세상의 간단한 순서처럼 겨울 그다음 봄 날 믿어볼래 셀 수도 없는 별 중에 굳이 살아있기에 왠지 모든 힘들어지면 쉬운 거 믿을래 우연히 태양이 있는 아냐 나도 길 고양이가 왜인지 보이지 않아 잘 지내니 뒤늦게 이름을 준다 기억할 수 있게 너의 살아있음이 위로였어 말 해줄 걸 날 믿어볼래 셀 수도 없는 별 중에 굳이 살아있기에 왠지 모든 힘들어지면 쉬운 거 믿을래 우연히 태양이 있는 아냐 모든 것은 지나간다는 어른들의 얘기처럼 밤 그다음엔 아침이란 걸 거기에 답이 있는데 그걸 믿는 쉽지가 않아 그럴 땐 나를 믿을래 걸 버텨준 날 누군가의 위로일지도 모를 나를 그런 내게 누군가 기대올 수 있게 가장 어두운 밤을 지나 태양이 온다,2,0,0,0,0
527,아주 작은 상자 속에 살고 있어 움직여도 벽에 닿는 듯해 웬일인지 답답하지는 않아 작은 상자 속에 사는 상상을 해 깨끗한 바람나를 감싸는 넓은 들판 위 내가 있는 거라고 세상은 내가 보고 싶은 대로 볼 수 있지 않을까 내가 하고 싶은 대로 그냥 맘껏 살아봐 빠바밤 밥빠밥 밥빠밥 주위를 둘러보면 밥빠밥 맘 같은 세상이야 어려울 없어 내일의 웃을 거야 괜한 걱정 하지 말고 세상은 보고 싶은 대로 볼 수 있지 않을까 하고 그냥 맘껏 살아봐 빠바밤 주위를 둘러보면 맘 같은 세상이야 어려울 없어 세상엔 아름다운 것들이 아직 많이 있는데 마음이 지쳐서 놓쳐버린 건 아닐까 빠바밤 주위를 둘러보면 맘 같은 세상이야 어려울 없어,2,0,1,-3,-2
528,오랜만에 만나는 친구들은 줄어들고 하고픈 얘기들은 늘어나고 각자의 고민을 꺼내고서 나이를 하나둘씩 세어 가는 우리들은 나를 꺼내어 보는 시간의 벽에 부딪혀 자나 깨나 용기가 넘쳤던 우린 눈앞이 어두워 너무도 어두워 꺼내 볼래 마음의 나침반을 흔들리는 나침반이 답답해도 라면 다 알지 못해도 다 알 수 있어요 뜻대로 안 되는 하루하루가 안개처럼 흐릿하지만 수많은 길이 앞에 있어 세상이 돌아가더라도 우린 절대 길을 잃지 않고 똑바로 걸어갈 거예요 가요 오똑 같은 오전과 똑같은 노을 지는 하루가 예쁘지만 쳇바퀴를 도는 기분이 들어 보기 좋은 청춘이란 이름을 알기에 앞으로 걸어가기 좋기에 아무렴 뭔들 못해라는 생각을 해보지만 그게 그렇게 쉽지 않아서 눈앞이 어두워 너무도 꺼내 볼래 마음의 나침반을 흔들리는 나침반이 답답해도 라면 다 알지 못해도 알 수 있어요 뜻대로 안 되는 하루하루가 안개처럼 흐릿하지만 수많은 길이 앞에 있어 세상이 돌아가더라도 우린 절대 길을 잃지 않고 똑바로 걸어갈 거예요 가요 오지 나치는 이름 모를 사람들처럼 의미 없게 지금 우리가 잊힌다면 쓸쓸할 같아 매일 속에 날 숨차게 지나가는 내일의 날 세상이 돌아갈지라도 뜻대로 안 되는 하루하루가 안개처럼 흐릿하지만 수많은 길이 앞에 있어 돌아가더라도 절대 길을 잃지 않고 똑바로 걸어갈 거예요 가요,2,0,-2,1,-1
529,기분 좋은 상상을 하면 어떨까 모두가 날 좋아한다고 몸에 좋은 생각을 하면 어떨까 보기보다 괜찮다고 반복되는 엄마의 잔 소린 멋진 생활의 지혜 놀러 나갈 교통비가 없는 건 방 청소하라는 개시 허구한 날 밤늦은 야근은 집 난방비 절약 여태 내가 백수인 비밀 대기만성형 기분 좋은 상상을 하면 어떨까 모두가 날 좋아한다고 몸에 생각을 보기보다 괜찮다고 연락 두절된 썸남의 이유는 가족과 보내라는 배려 여태 내가 솔로인 비밀 만날 천생연분 때문 기분 상상을 모두가 좋아한다고 몸에 생각을 보기보다 괜찮다고 언제나 많은 일들이 속상하게 해 행복해지는 방법 알고 있어요 다 잘 될 거라고 다 잘 될 거라고,2,0,-7,3,-4
530,당신이 원하는 대로 당신이 원하는 모든 가벼운 발걸음은 바람 날아올라 왠지 예감이 좋은 날 달콤해 색다른 느낌 설레는 맘 가득해 순간 말해줘 다 말해줘 너의 마음 다 망각 이뤄져 이제 좋은 일들만 이렇게 네가 바라는 대로 느낌이 오는 대로 들어줄게 무엇이든 곁에만 있을게 이대로 이름을 불러줘 괜찮은 언제나 너를 만나러 갈 거야 호별 헤는 아름다운 밤 조금씩 물들어가 벅차올라 이루어지길 너의 소원 다 나에겐 말해 들어줄게 거친 바람에도 흔들리지 않아 손잡아 이루리 이루리 라일리 이루리 라 이뤄질 거야 나를 느껴봐 우린 원해 원해 사랑 해어 둔 밤 속에서 빛을 찾을 거야 라나를 꺼내줘 네가 바라는 걸 날 위해 말해줘 어둠 안에서 너를 비춰 이루리다 너를 피우리라 맘에 약속해 순간 영원해 이대로 향해 빛을 이렇게 네가 바라는 꿈꿔왔던 그대로 보여줄게 무엇이든 이제 곁에만 머물러줘 지금처럼 나를 바라봐 줘 언제나 우린 할 호별 헤는 아름다운 밤 조금씩 물들어가 벅차올라 이루어지길 너의 소원 나에겐 말해 들어줄게 거친 바람에도 흔들리지 않아 손잡아 라일리 라 이뤄질 나를 느껴봐 우린 원해 사랑 해어 둔 속에서 빛을 찾을 라도 번 다시는 오지 않아 세계로 던져 더는 망설이지 마 절대 맘을 내게 보여줘 믿어 하늘 위로 날아올라 라고 세계로 느껴봐 사랑 해어 둔 속에서 찾을 라는 감아 네게 보여줄게 내어서 우리만의 세계 라고 언제나 변치 않길 라일리 라,2,0,-8,-2,-10
531,어제는 맑은 날 오늘은 흐린 날 내일의 날씨를 아시나요 일기예보는 늘 맞질 않고 하늘은 까만 채로 말이 없네 여긴 비가 와요 안에 비가 와요 구름은 늘 흐르고 그래해는 항상 뜨고 지고 그래그래그래 불안해지는 젊은 날이라도 괜찮다고 말해줘요 그래그래그래 흐린 거라고 얘기해줘요 바다를 보면 겁날 때가 있죠 아름답다고 말하지만 한없이 작아진 모습 두려워 파도가 밀려오면 뒷걸음을 쳐 너무 깊은 바다 너무나 넓은 바다 파도는 오고 가고 너머엔 땅이 있고 그래그래그래 두려워지는 젊은 날이라도 괜찮다고 말해줘요 두 손을 잡지 않을래요 나와 가고 싶은 데는 다르대도 순간을 걸어요 한 걸음 한 걸음 달라지고 있죠 아직 느리게만 보인대도 구름은 늘 흐르고 그래해는 항상 뜨고 지고 그래그래 그래비가 오는 밤도 나쁘지 않네요 그대 날씬 어떤가요 왠지 내일 아침은 맑을 같아요,2,0,2,0,2
532,햇살 눈 부신 하늘 속 하얀 구름마저도 뭔가 특별한 느낌 심장 소린 커지고 찰나 빛이 터지고 뭔가 이뤄질 듯한 떨림 믿을 수 없어 그것 마법 오도 눈에 펼쳐진 꿈속에서 새로운 세상에 외쳐 찬란히 맘에 새겨 감춰왔던 안의 조그만 속삭임 불어온 바람에 담긴 나만의 향기로 퍼진 아름다운 환상 속 완벽한 날 힘껏 손을 뻗어도 텅 빈 꿈만 같았던 점점 아득해지는 하루 속가슴 벅차올 만큼 가득 담은 숨결로 다시 선명해지는 그림 올 기다려왔던 그것 마법 오가 까이 다가온 꿈속에서 새로운 세상에 외쳐 찬란히 맘에 새겨 감춰왔던 안의 조그만 속삭임 불어온 바람에 담긴 나만의 향기로 퍼진 아름다운 환상 속 완벽한 날 완벽한 날 영원히 기억해줄래 올 꿈꿔온 커져간 세상을 한 뼘 자라난 맘 잠들었던 안의 깨워 완벽히 달라진 공기 새롭게 피워낸 향기 찬란하게 떠오를,2,0,-3,-2,-5
533,걱정 마 아무런 생각 마 지금 넌 혼자가 아냐 눈물도 흘리지 않아도 돼 넌 웃기만 해도 돼 세상이 널 밝혀주잖아 너의 환한 미소 이제 따뜻한 손길로 찾아줄게 가슴속 상처 아물 때까지 내가 있을게 걱정 마 두려워하지 아무 없을 테니까 눈앞에 마주친 시련들도 다 잊힐 거야 미래가 널 기다리잖아 너의 환한 미소 이제 따뜻한 손길로 찾아줄게 가슴속 상처 아물 때까지 내가 있을게 네가 행복할 수 있도록 마음 편해지도록 너를 지킬게 언제나 너의 환한 미소 다신 잃어버리지 영원토록 눈에 안 보여도 곁에 있을게 아무 걱정,2,0,0,7,7
534,가만히 눈을 감으면 아직도 선명한 느낌 어른이 돼도 가슴은 두근대 내가 꿈을 꾸는 나를 찾아가는 너에게 보여줄게 멋진 세상을 따라와봐 선생님도 꼬맹이 시절에는 숙제를 하곤 했지 장래희망엔 걸 적어야 할까 무얼 좋아할까 고민하며 떠올린 것들이 많았지 아마 별 특별할 없는 그런 재능이었지만 늘 특별한 하루를 선물하던 꿈들을 예쁘게 접어 어린 시절에 걸어두고는 너희를 꿈 꾸며 지금 길을 걸었어 우린 너희에게 세상을 보여줘 네가 꿈을 향해 걸어갈 길을 알려줘 너희와 걸어가며 세상에서 꿈꾸는 법을 배울게 너희와 할게 꿈을 꾸는 자만이 희망을 볼 수 있기 가만히 눈을 감으면 아직도 선명한 느낌 어른이 돼도 가슴은 두근대 내가 꾸는 나를 찾아가는 너에게 보여줄게 멋진 세상을 따라와봐 스물다섯 평짜리 작고 네모난 자리 사람들은 우린 여기에서만 가만히 살아야 한다 생각하나 걸음을 멈추면 내가 만나는 세상이 작아지겠지 우리가 너의 몰라줄 거야 교실을 나서면 세상의 많은 도전에 넘어지겠지 서로 손을 잡아줄 거야 우린 너희에게 보여줘 네가 향해 걸어갈 길을 알려줘 너희와 걸어가며 세상에서 꿈꾸는 법을 배울게 할게 자만이 희망을 볼 수 있기 눈을 감고서 너에게 귀 기울여봐 가슴이 말하는 대로 용기를 내봐 나를 찾아가는 함께할게 멋진 열어줄게,2,0,-11,-4,-15
535,코 오늘 밤 별 불을 피우는 것을 지켜보십시오 밤을 다시 설정하십시오 신발을 마시십시오 우유 컵 록 앤 롤 킹 콩은 드럼을 차다 롤링 스톤처럼 구르는 내가 노래를 부를 집으로 걷는 탑 르브론으로 뛰어올라 딩 동은 전화로 전화해 아이스티와 탁구 게임 이것은 무거워지고 있습니다 베이스 붐을 들을 수 있습니까 준비 인생은 꿀처럼 달콤합니다 그레이 이길 차 칭 돈처럼 디스코 과부하로 그게 나가서 다행입니다 당신이 내가 빛나는 다이아몬드입니다 간 코 오늘 밤 별 불을 피우는 것을 지켜보십시오 밤을 다시 설정하십시오 도시를 통해 빛납니다 작은 펑크와 영혼으로 나를 밝힙니다 다이너마이트와 이처럼 친구가 군중과 합류하십시오 오고 싶은 사람 말을 하라 우리가 벽에서 벗어난 것처럼 움직입니다 낮이나 밤 하늘 우리는 새벽의 휴식 시간에 춤을 추고 있습니다 신사 숙녀 약을 얻었다 당신은 나중에,2,0,-1,0,-1
536,아직은 모를 거야 아마도 소중한 너인지 속의 너만은 잊지 않길 바라 너의 모든 순간순간을 이렇게 네게 말하면 알 수 있을까 네가 걸어온 길들이 아름답단 걸 멈춰 돌아보면 알 거야 네가 남긴 예쁜 순간들을 너의 한순간 순간 너인 걸 있는 그곳이 어디든 아프지 않게 내가 안아줄게 네가 날 안아준 그날처럼 너의 순간순간 사랑해 옆에 없는 날이 온대도 작은 기억으로 네게 남는대도 괜찮아 순간인 걸 가끔 지금이 그리워지면 어떨까 아마도 생각에 웃고 있겠지 함께였던 지나온 날들 내게 있어서 다행이야 한순간 순간 나인걸 있는 그곳이 어디든 아프지 않게 내가 안아줄게 날 안아준 그날처럼 늘 그날처럼 인생에 행복을 남겨준 널 만나 감사해 어려운 일들이 와도 지금을 기억할게 언제나 우린 함께일 거야 지금 순간순간 기억해 찾아낸 행복이 아프지 않게 널 안아줄 언제나 서로가 그랬듯이 너와 한 날들 순간이 되고 늘 한 날들 떠나도 서로의 순간이었던 지난날들을 사랑해 순간순간,2,0,-8,-1,-9
537,나도 알아 멍청한 짓인지 알고 있어 알고 있어 사람들이 손가락질할 더더욱 강해질 거야 오늘도 어김없이 꿈을 꿔 하늘을 날아오르는 자유로운 손을 뻗으면 닿을 높이 날갯짓을 해 두렵더라도 절대 포기하지 못해 쓰러지지 못해 꿈을 한곳만 바라봐 포기하지 않아 쓰러지지 않아 온몸이 타올라 부서져도 두려워질 때마다 날 믿어준 사람들을 위해 그것을 증명할 것이다 눈 감고 싶을 때마다 끝에 있을 나를 상상해 불분명한 길이겠지만 날아올라 날아올라 빛을 수많은 그림을 그려 한계를 느껴도 오늘도 어김없이 꿈을 꿔 하늘을 날아오르는 이룬 손을 뻗으면 닿을 높이 날갯짓을 해 하늘 위까지 절대 포기하지 못해 쓰러지지 한곳만 바라봐 않아 온몸이 타올라 부서져도 누구보다 먼저 올라 손 뻗을게 너도 나와 있길 파란 하늘 높이 올라 너도 느낄 수 있게 날개를 펼 수 있게 절대 한곳만 바라봐 온몸이 타올라 부서져도 두려워질 때마다 날 믿어준 사람들을 위해 그것을 증명할 것이다 눈 감고 싶을 끝에 있을 나를 상상해,2,0,2,3,5
538,받아쓰길 잘하는 자랑이 아니게 되고 키는 한참 자랐는데 자랑할 일은 사라져가네 차를 타고 달릴 때면 날 따라오던 별들도 빛나질 않고 키는 한참 자랐는데 하늘은 점점 높게만 느껴지는지 사람들은 날 어른이라 하는데 아닌 것들만 점점 늘어가 모두들 날 보고 다 컸다 하는데 작아져만 가는지 사진 속 웃고 있는 아인 지금 어디에 있는 걸까 어른이 된다는 건 이렇게 슬퍼도 웃어야 하는 걸까 크면 다 알게 된단 말을 아직까지도 잘 모르겠어 참고 참으며 하루를 사는 다들 말하는 어른이 된다는 걸까 사는 다 그런 거지 뭐 알 것도 같은데 남은 내일이 많아 많던 별들은 지금 어디에 있을까 너도 어른이 된 사람들은 어른이라 하는데 아닌 것들만 점점 늘어가 모두들 보고 컸다 작아져만 가는지 사진 속 웃고 있는 아인 지금 어디에 된다는 건 이렇게 슬퍼도 웃어야 하는 크면 알게 된단 말을 아직까지도 잘 모르겠어 참고 참으며 하루를 사는 다들 말하는 사진 속 웃고 아인 건 이렇게 슬퍼도 웃어야 하는 거울에 비친 모습은 내가 알았던 나인 할 수 말이 줄어드는 다들 말하는,2,0,-2,2,0
539,너의 하루가 기나긴 한숨 같아 떠나고 싶은 거니 기대하고 휘청이며 버티고 있는 거니 때로는 세상이 봄날 같고 때로는 안개만 자욱하지 반짝였다 어두워졌다 삶이란 그런 거야 가야 할 길 있기에 헤매던 날들 꽃처럼 피우려고 모질던 바람 힘내란 말은 하지 않을게 이것만은 기억해줘 거센 강물처럼 지나가리라 누군갈 위해 박수만 치는 내가 지겨워 지진 않니 가까운 이의 다독인 말도 들리지 않는 거니 그치지 않는 비는 없잖아 언제나 햇살일 순 없잖아 부딪치며 깨달아가는 삶이란 그런 거야 가야 할 길 있기에 헤매던 날들 꽃처럼 피우려고 모질던 바람 힘내란 말은 하지 않을게 이것만은 기억해줘 거센 강물처럼 지나가리라 괜찮아질 거라 위로하는 아냐 나도 걸어온 길인 거치적거린 세상을 두려워 마 모든 사랑도 모든 상처도 괜찮아 너를 찬란하게 너답게 만들 테니 누군갈 사랑해서 빛났던 날들 누군갈 잊기 위해 떠나온 아픔을 겪어야 시작되는 순간이 있다는 걸 지금 아프다면 너의 계절이 오는 거야 거친 바람은 그렇게 꽃을 피운다,2,0,3,1,4
540,살며시 다가가 조용히 귀를 기울여봐 바람처럼 잡힐 듯한 맘 한구석 작은 섬 안에 숨 쉬고 있는 사라질 것만 같은 어린 맘속비밀 한 방울 떨어진 빗방울처럼 내게 와줄래 그렇게 오면 돼 지친 내게 단비가 되어 내려줘 꿈을 꾸고 있습니다 꿈 여기에서 처음처럼 변치 않는 맘으로 채워도 채워지지 않는 텅 빈 맘 깊은 곳 한줄기 빛으로 채워줘 그렇게 내게 와줘 이제 마이 꿈도 눈을 감고서 하나둘씩 떠올려봐 손끝에 닿을 듯한 작은 꿈 너무 아파 몰래 참아온 비밀 새어 나와 안에 커져가 창문을 두드린 빗소리처럼 와줄래 그렇게 오면 돼 닫힌 맘을 두드려줘 울지 마 꿈을 꾸고 있습니다 꿈 여기에서 처음처럼 변치 않는 맘으로 채워도 채워지지 텅 빈 맘 깊은 곳 한줄기 빛으로 채워줘 두 손을 꼭 잡아줘 이제 마이 혼자가 아니야 온 힘을 다하면 꼭 이뤄질 거야 숨길 수 없을 만큼 커다란 빛으로 두 눈을 감으면 두 손이 닿으면 속삭여줘 베이비 돈 꿈의 꿈을 꾸고 있습니다 여기에서 처음처럼 변치 맘으로 채워도 채워지지 텅 빈 깊은 곳 눈부신 가득히 자신을 믿는다 언제나,2,0,1,-5,-4
541,숨소리만 들어도 느낄 수 있어 어깨의 작은 뒤척임까지도 밤새 얼룩진 머리맡에 앉아서 가만히 너의 머릴 쓸어주고 싶어 내게만 말해봐 마음속 가득한 걱정들 아기에게 말해줘 혼자서 울지 말고 너의 아픔도 나눠 가질게 잘 자요 아무런 걱정 말고 잘 자요 나의 그대 그럴 땐 날 불러 왠지 잠이 안 올 한숨이 날 조그만 인형처럼 말없이 기대어 누구에게도 아직 한 번도 다 보여준 적 없었던 맘의 뒷면까지 어루만져 줄게 내게만 말해봐 서랍 속 깊숙한 비밀들 아기에게 말해줘 혼자서 울지 말고 너의 아픔도 나눠 가질게 잘 자요 아무런 걱정 나의 그대 아기에게 말해줘숨기려 하지 그늘도 감싸 안을게 살며시 내게 안겨 나의 그대 사랑 아무런 걱정 좋은 밤 되세요 숨소리만 들어도 느낄 수 있어 어깨의 작은 뒤척임까지도 밤새 얼룩진 머리맡에 앉아서 가만히 머릴 쓸어주고 싶어,2,0,0,0,0
542,달빛 내리는 밤 얘기하지 떠나고만 싶어 밝은 빛 너머 어딘가로 지친 사람의 숲 엉킨 오해들로 머뭇머뭇 대던 여기를 떠나 안의 나를 만날래 민트빛 바다로 투명한 바람 좌표는 몰라 마음이 흐르는 곳 지구는 돌아가 한동안 없다 해도 주문을 외워봐 오늘부터 행복한 웃어넘길 많은 후회들을 그렇게 꼭 안고 한숨만 지며 그러진 마 하룰 산다 해도 세상 끝인 듯이 작은 꽃 하나에 우주를 보듯 살아갈 거야 민트빛 바다로 투명한 바람 좌표는 몰라 마음이 흐르는 곳 지구는 돌아가 한동안 없다 해도 주문을 외워봐 오늘부터 행복한 달빛 내리는 밤 얘기하지 떠나고만 싶어 밝은 빛 너머 어딘가로 지친 사람의 숲 엉킨 오해들로 머뭇머뭇 대던 여기를 떠나 안의 나를 만날래 하룰 산다 세상 끝인 듯이 작은 꽃 하나에 우주를 보듯 행복한,2,0,2,3,5
543,오늘처럼 흐린 햇살마저 눈부신 날이면 주머니에 가득한 먼지를 탁탁 털어 버리지 해묵은 한숨을 털어 내고 때묻은 상처를 지우고 나면 날아가 버릴 같아 눈물이 이렇게 어렵지 않은 수고로도 가벼워져 버릴 만큼 강해져 있어 장난처럼 널 떠올릴 수도 있는 걸 아무렇지도 않게 콧노랠 부르며 오늘처럼 흐린 햇살마저 눈부신 날이면 주머니에 가득한 먼지를 탁탁 털어 버리지 해묵은 한숨을 내고 때묻은 상처를 지우고 나면 날아가 버릴 같아 눈물이 이렇게 어렵지 않은 수고로도 가벼워져 만큼 강해져 있어 장난처럼 널 떠올릴 수도 있는 걸 아무렇지도 않게 라라라 랄라 이렇게 어렵지 않은 수고로도 가벼워져 만큼 강해져 있어 장난처럼 널 떠올릴 수도 있는 걸 아무렇지도 않게 콧노랠 부르며,2,0,9,2,11
544,예쁘게 차려입고 예쁜 구두 신고 예쁜 거리를 걷고 싶어요 마스크 안 쓰고 맑은 공기 맡고 싶어요 놀이터에서 신나게 놀고 싶어요 지치고 힘든 하루하루 지내고 있나요 혼자라는 생각에 슬픈가요 그렇다면 얘기 들어 보세요 지치고 힘든 하루하루 지내고 있나요 혼자라는 생각에 슬픈가요 그렇다면 얘기 들어 보세요 모두가 힘을 내요 힘을 조금만 웃어봐요 찡그린 얼굴을 지우고 다 웃어봐요 모두가 힘을 내요 조금만 웃어봐요 내일은 오늘보다 행복해질 거예요 모두가 내요 조금만 찡그린 얼굴을 지우고 다 내일은 오늘보다 행복해질 거예요 찡그린 얼굴을 지우고 다 내일은 오늘보다 행복해질 거예요,2,0,0,7,7
545,누구나 할 없이 빠르게 돌아가는 세상 속에서 살아가는 사람들 갈 길은 멀구나 가끔은 힘들어도 아닌 척 웃어 보이는 내가 애처로워 보일 때쯤 무얼 할 수 있을까 너무 힘들어 모든 걸 포기하고 싶을 곁에 있는 사랑하는 사람들을 하나둘씩 기억해 힘내라는 한마디가 크게 와닿을 살아있음을 기억해 기댈 곳 없이 홀로 걸어가는 세상 속에서 지나가는 많은 사람들 생각을 할까 가끔은 무너져도 무던히 지나쳐가는 내가 지쳐 주저앉아 버릴 때쯤 무얼 할 수 있을까 너무 힘들어 모든 걸 포기하고 싶을 곁에 있는 사랑하는 사람들을 하나둘씩 기억해 힘내라는 한마디가 크게 와닿을 살아있음을 너무 힘들어 나조차 포기하고 싶을 곁에 있는 소중한 사람들을 하나둘씩 사랑한다 한마디가 나를 울릴 살아있음을,2,0,2,3,5
546,울지 마라 지나간다 버티고 버텨라 사는 힘들어도 절대로 기죽지 마라 벼랑 끝 인생은 잃을 것도 없다 막혀버린 현실에 갇혀 살아도 나를 위한 태양이 떠오를 거야 울지 마라 지나간다 외롭게 살아도 한 세상 잘 살았다 누가 뭐래도 걱정 지나간다 힘겨운 나날들 꼭 온다 좋은 날이 버티고 버텨라 막혀버린 현실에 갇혀 살아도 나를 위한 태양이 떠오를 거야 울지 외롭게 한 세상 잘 살았다 누가 뭐래도 걱정 힘겨운 나날들 꼭 온다 좋은 날이 버티고 버텨라 꼭 온다 좋은 날이,2,0,2,5,7
547,어른들은 자꾸만 내게 말하죠 아직 너는 어려서 잘 모른다고 산다는 건 그렇게 쉽지 않다고 전쟁 같은 그런 현실이라고 그런 건가요 영화 같은 그런 세상은 없나요 믿어요 꿈을 꿔요 동화 속 이야기처럼 눈부신 세상이 앞에 펼쳐질 거라고 꿈을 꾸면 마주 보면 행복해질 수 있죠 기적을 믿어요 언제까지나 기다릴 거예요 해피엔딩 살다 보면 알게 된다고 상처뿐인 현실이라고 건가요 영화 같은 세상은 없나요 믿어요 꿈을 꿔요 동화 속 이야기처럼 눈부신 세상이 앞에 펼쳐질 거라고 꾸면 마주 보면 행복해질 수 있죠 기적을 언제까지나 해피엔딩 두 손 모아 기도할게요 마음이 닿을 수 있도록 날 꿈꿔 봐요 동화 속 이야기처럼 눈부신 세상이 앞에 펼쳐질 거라고 꾸면 마주 행복해질 있죠 기적을 언제까지나 기다릴 거예요 해피엔딩,2,0,1,1,2
548,뛰놀던 봄을 기억하니 지난여름을 기억하니 가을바람을 기억하니 겨울 추위를 잊지 마라 떨쳐낼 수 없는 불안도 쓰라린 상처 깊은 아픔도 나아지지 않는 통증도 기약 없는 작별 인사도 잊자 놀자 원을 그리며 달을 잊어버리고 돌자 원을 그리며 달을 잊자 잊자 놀자 원을 그리며 달을 잊어버리고 돌자 놀자 낮이 오면은 꽃은 질 테니 잊어버리고 돌자 별의 부스러기를 낙원으로 가자 뛰놀던 봄을 지난여름을 가을바람을 겨울 추위를 잊지 마라,2,0,6,-2,4
549,늘 버리고 싶었어 한 치 앞도 모를 끝 어딘가로 웅크리며 숨었고 기댈 곳마저 없었어 빛이 그리운 나였던 걸 소곤소곤 뒤로 나만 모르던 이야기가 조각조각 나누어진 입들로 만든 영화가 되고 숨 쉬지 못할 고통이었던 한 푼 서러움에 울기만 했던 어리고 어렸던 시간들이 눈을 떠 날 언제나 넌 쿨한 척 위해주는 척 아니요 겉과 속은 달랐어 배부른 말 한 술에 독 두른 한숨으로 서서히 새겨지네 흙탕물이 튀어도 툭툭툭 털어내 갈 길이야 단 물조차 없어도 길 하나면 돼 면 돼 숨 쉬지 못할 고통이었던 푼 서러움에 울기만 했던 어리고 어렸던 시간들이 눈을 떠 날 안고 얹고 걸어가 한없이 가벼운 무기도 아무것도 아냐 아무렇지 않아 이대로 그대로 홀로 숨 쉬지 못할 고통이었던 푼 서러움에 울기만 했던 어리고 어렸던 시간들이 눈을 떠 날,2,0,5,-1,4
550,그림처럼 앉아 새어 나오는 한숨에 선명하지 않아 다 나의 뒤에 서있네 초라한 청춘이 비스듬하게 빛나면 푸석이는 그림자 나를 닮은 아무 뜻도 없이 사라질 거야 이야기는 계속될 수 있어 끌어안아줘 그냥 날 괜찮다 말해줘 불안해 반대로만 좁은 젊음에 무너져 끝이 노래가 될 수는 없는 걸 날 불러줘 한 뼘 가까이 바라보면 외로운 사람 흐린 거울 속 웃고 있는 너는 내가 아냐 있는 그대로를 날 이야기는 계속될 수 있어 끌어안아줘 그냥 괜찮다 말해줘 불안해 반대로만 좁은 젊음에 무너져 끝이 노래가 될 수는 없는 걸 불러줘 이야기는 계속될 수 있어 끌어안아줘 그냥 괜찮다 말해줘 불안해 반대로만 좁은 젊음에 무너져 끝이 노래가 될 수는 없는 걸 불러줘 계속,2,0,3,1,4
551,싫어하는 걱정 가득함을 안고 드라이브를 통해한 번 태어나고 한 번 맞는 죽음 기억 못 해 너의 하루는 나를 용서해 줘 나에게 나의 젊음 나의 젊음 한때 곤두세운 나의 감정 젊음 돌아보면 남아있는 상처 그냥 느껴보고 싶어 온전히 그랬었지 말고 지금 눈 깜빡할 사이에 도착 많은 고민들의 흔적이 묻어나길 내가 나를 너무나도 싫어하다가 지나치게 사랑하네 무던하게 하나하나 쌓아가는 거지 살짝 얹어 놓은 땀들이 쌓여도 안개처럼 멀리 흩어지기 전에 사랑하고 싶어 필요하지 많은 돈다발 그까짓 거 위해 보지 못하잖아 지금 아닌 내일 살아가 영원히 행복하지 못하잖아 흘러가다 맞는 내일 보다 젊은 오늘 가득하던 전을 그리워하며 괜찮은 척 선물을 포장하다 잊고 있지 싫어하는 걱정 가득함을 안고 드라이브를 통해한 번 태어나고 한 맞는 죽음 기억 못 해 너의 하루는 나를 용서해 줘 나에게 한때 곤두세운 감정 돌아보면 남아있는 상처 그냥 느껴보고 싶어 온전히 그랬었지 말고 지금 돈만 좇다 보니 서른을 어느새 뭐가 남았을까 지나가 버린 젊음엔 널 사랑하지 못했던 내가 미웠어 너를 멀리 밀었어 뭐 어쩌니 내가 걸 그렇다고 후회하며 살기엔 아까워 알잖아 인생이란 건 단 한 순간이라는 거는 파도 잡으려 해도 잡히지가 않아 추억해 지나갈 뿐이란 걸 잘 알면서도 그러질 못하잖아 시간은 잡아먹어 버려 우리의 기억 시간은 기다리고 있어 우릴 아직도 남겨놓고 갈게 이름 죽음은 삶이란 불에게 있어 기름 뜨겁게 태워버려,2,0,1,1,2
552,집에 가자 맛있는 과자 양손에 무겁게 가자 맥주도 사자 아끼지 말자 다 들고서 집으로 가자 하루 종일 열심히 일했으니까 쉬러 간다 넌 어땠니 분명히 고단할 테니까 너도 쉬러 고생한 날 안아주자 집에 맛있는 과자 양손에 무겁게 맥주도 사자 아끼지 말자 다 들고서 집으로 집에 누워만 있자 열 번은 본 영화를 보자 울다가 웃자 말이 맞아 그러다가 스륵 잠들자 이렇게 하루가 간다 고생한 널 안아주자 맛있는 과자 양손에 무겁게 맥주도 사자 아끼지 말자 다 들고서 집으로 누워만 있자 열 번은 본 영화를 보자 울다가 웃자 말이 맞아 그러다가 스륵 잠들자,2,0,2,-1,1
553,나의 기차는 갈 곳이 많은지 표도 많고 너무 빨라 놓치는 많아요 가끔은 갈 수 없는 곳 그리움을 만나러 가야만 살아지는 날이 있다고요 아이보다 어린 어른의 떳떳하지 못한 숨바꼭질 닮아야 뒤처질게요 언젠가는 꿈꿔온 어른이 되어 투명한 위로를 건네는 사람이고 싶어 숨을 죽여 우는 아이의 슬픈 등을 재우리 사랑을 하고 널 사랑했으니 눈에 밟힌 아픈 구절 속 너의 얘기 들리우는 서글픈 하루 그대로 넘겨라 엄마도 아빠도 되돌아가서 다시 사랑을 하고 나를 만나요 모여 사진 찍고요 다 아는 얘기 모르는 척 무지개마을 막내 산책시키고 푸른 하늘 펼쳐보며 숨이 차게 뛰어노는 나의 그대 동네 따다 주시던 꽃향기 그대로 추억 속에 남은 하나뿐인 그대여 이제 놓아줍니다 부디 잘 가요,2,0,2,-5,-3
554,평온한 보이는 나의 표정엔 너는 모르는 비밀이 있어 한눈에 보일 리 없겠지 발밑에 숨긴 사실을 넌 전혀 모르게 했어 느낌을 발 길을 아직 낯선 그곳으로 떠나라 이끄는 대로 가지는 대로 하고 싶은 대로 두발은 가세요 나의 길을 찾아 수영 보이지 않게 수영 잦은 기복은 뒤로 한 채 닿을 곳은 천국 길에 나도 나의 미래는 전혀 몰라 너도 그렇듯이 나조차도 흥미롭지 않아 주위를 둘러보고 심호흡을 하십시오 조급해 말아 느낌을 온기를 나다운 그곳으로 떠나라 이끄는 가지는 하고 싶은 두발을 가세요 아주 멀리 수영 보이지 않게 잦은 기복은 뒤로 한 채 닿을 곳은 천국 길에,2,0,-2,-2,-4
555,지친 하루 끝에 수고했단 작은 한 마 딘 훗날에 기억될 오늘의 그림 같은 지금의 추억이 될 거예요 낮부터 밤까지 한시도 마음 놓고 쉴 수 없어 이놈의 폰도 나를 부르는 하나도 반갑지 않아 도망가고 싶다 날 찾지 마 따분함을 느껴보고 싶어 꼭 바쁘게 살아야 싶어 숨기엔 보는 눈이 많아서 눈치만 보다 하루가 다 갔어 언제나 늘 돌고 도는 하루 속에 무뎌짐을 느끼고만 있다면 식어버린 마음에 새로운 계절이 줬으면 해 생각은 접고 매일 날 웃을 수 있게 쉬어가도 돼요 아무 생각 하지 말아요 그래요 치유를 멈추지 마십시오 이제 다이빙에서 다이빙을 다이빙을 합니다 쉼이란 바다에 몸을 던져 푹 쉬어도 돼요 우리의 치유 치유 뭐라 못해요 치유를 멈추지 마십시오 이제 다이빙으로 다이빙을 합니다 다 거니까 걱정도 마요 이건 다 치유 멈추지 마세요 치유를 마십시오 음 꺼두고 매일 귀찮게 하는 폰 허전하다면 손을 잡고 서로 눈동자 속에 비친 모습 힘들 때면 꺼내 볼 수 있길 은 지금이 타이밍 억압 벗고 분위기로 다이빙 다이빙 지금 기분 입꼬리도 올라가 위로 가다 모든 걸 잠시나마 놓아둬도 괜찮아요 뭐 어떻게든 되겠죠 식었던 맘은 너로 가득 차 이제 편한 생각만 해 이상의 걱정은 없게 쉬어가도 돼요 아무 생각 하지 말아요 그래요 다이빙에서 합니다 쉼이란 바다에 몸을 던져 푹 쉬어도 우리의 오늘 하루도 수고 많았어 지친 하루 끝에 수고했단 작은 한 마 딘 훗날에 기억될 오늘의 그림 같은 지금의 추억이 될 거예요 마세요 아기 힘들면 쉬어도 돼 마세요 아기 지금 자기야 아기 힘들면 돼 지금 자기야,2,0,5,1,6
556,마음먹은 대로 무엇이든 될 수 있다면 세상의 많은 오늘이 아름다웠을까 어쩔 수 없는 슬픔이 노래가 되어 그런 인생이라고 가고 싶은 대로 어디로든 갈 수 있다면 나중에는 곳도 다 그럴까 떠나야 하는 마음 머무는 곳에서 그런 사람이라고 흐린 날에는 약간의 용기를 지치지 않을 만큼 무엇이 됐든 매일의 생활을 해 별다를 없는 듯이 그렇게 하고 싶은 대로 무엇이든 생각해 보면 처음 느꼈던 마음 다 그대로일까 좋아하던 순간이 꼭 영원하지 않아도 그런 사랑이라고 흐린 날에는 약간의 용기를 지치지 않을 만큼 무엇이 됐든 매일의 생활을 해 별다를 없는 듯이 그렇게 남다를 없다는 듯이 무엇이 되어도 별다를 없다는 그렇지는 않게,2,0,0,1,1
557,기억은 아름답게 변해서 지금의 나를 초라하게 만들고 맘속에 맴도는 쌀쌀한 말들 지금 기대고 싶어요 차가운 계절에도 모두들 따뜻한 표정을 하고 있는 걸요 끝없이 작아지는 무표정한 나만 지금 어디에 있나요 세상에 변하지 않는 건 없어 아픈 마음도 지나갈 거야 너는 너라서 잘 모르겠지만 한없이 소중하고 사랑스러워 매일매일 견디듯 살아가지만 내일도 너는 이겨낼 거야 너는 너라서 잘 모르겠지만 널 알아 내가 아는 넌 이겨낼 거라고 믿어 높은 계단 위에 오르면 나도 누군가처럼 넓은 사람이 될까요 끝없이 작아지는 빠듯한 마음 지금 안기고 싶어요 여린 너이기에 느릴 테지만 힘든 마음도 점점 무뎌질 거야 너라서 잘 모르겠지만 한없이 소중하고 사랑스러워 매일매일 견디듯 살아가지만 선택도 해낼 널 믿어 너의 방식대로 잘할 거라고 너도 널 믿어 일도 꼭 해낼 거라고,2,0,-4,2,-2
558,잠들기 전에 다짐했던 하루가 뜻대로 되지 않고 너를 힘들게 할 사람에 지치고 무거운 일에 짓눌려 아주 금방이라도 쓰러질 것만 같을 네가 넘어질 나도 걸음을 멈출게 네가 쓰러질 집으로 데려다줄게 너의 곁에 있을게 생각이 많아 내내 뒤척이다가 끝내 잠 못 이루는 밤의 끝에서 모든 걸 네가 망친 것만 같아서 작아지는 기분에 눈물이 날 같을 넘어질 나도 걸음을 멈출게 쓰러질 집으로 데려다줄게 무너질 나도 떨어질게 돌아오지 못하는 아주 먼 곳이라도 떠날게 너의 곁에 있을게 가장 소중하다 여겼던 너의 가치가 날 갑자기 물거품이 됐을 울어줄게 아파할게 곁에 있을게 넘어질 걸음을 멈출게 집으로 데려다줄게 무너질 떨어질게 돌아오지 못하는 아주 먼 곳이라도 떠날게,2,0,7,4,11
559,그대가 속한 세상이 그대를 지치게 하고 그대가 그대가 아닌 사람이기를 강요하네 속한 세상엔 많은 사람들이 있고 많은 사람들 가운데 나라는 한 사람이 있네 세상의 어둠이 짙어 길을 잃을 내가 빛이 되고 싶어 그대는 그대로 그냥 그대인 채로 남으면 돼 속한 세상에 나라는 사람이 있네 그대다움에 그댈 보며 미소 짓네 세상의 어둠이 짙어 길을 잃을 내가 빛이 되고 싶어 그대는 그대로 그냥 그대인 채로 남으면 돼 그대는 그대로 세상의 어둠이 짙어 길을 잃을 내가 빛이 되고 싶어 그냥 그대인 채로 남으면 돼,2,0,-3,2,-1
560,어린 시절 방 한편에는 만화책이 가득했어 많은 사람의 환호를 받으며 날아다니는 주인공이 되고 싶었나 그러다 어느덧 비슷한 나이가 됐지 꿈을 꾸게 됐고 눈을 떠보니 미로 속에 갇혀있어 답을 찾기 힘들겠지만 수많은 운명 속에서 내가 택한 길을 믿어 달려가 보는 거야 어렸던 날 놓아줄 거야 한 발자국 돌아설 일이 생겨도 어둠이 날 감싸 안아도 별처럼 빛나게 되는 날까지는 놓지 않을 거야 화려한 트로피이나 무언갈 원하지 않아 나와 같은 꿈을 가진 너를 위해 봄날 같은 희망이 되고파 시간을 돌리고 싶단 생각을 한 적도 있지만 여기까지 왔어 할 수 있어 수많은 운명 속에서 내가 택한 길을 믿어 달려가 보는 어렸던 날 놓아줄 한 발자국 돌아설 일이 생겨도 어둠이 감싸 안아도 별처럼 빛나게 되는 날까지는 놓지 않을 쉽지 않을 알아 내가 다 선택한 길이잖아 모든 걸 넘어서 만화 속 주인공이 돼볼 너도 나와 같다면 조금만 기다려줘 날아올라 너에게 손을 내밀어 줄게 우리의 꿈이 빛바래지 않도록 지쳐도 일어설 수 있도록 놓지 않을게 넌 이야기의 주인공이니까,2,0,0,-6,-6
561,멀고 멀어져 버린 내가 내가 깨지기 전에 거울 속 비친 짐승으로 변합니다 강해 지려고 노력합니다 매일 같은 곳을 바라봤지만 되돌리고 싶어 시작으로 우회전하십시오도와주세요 다시 표류하는 것은 결코 끝나지 않았습니다 당신을 위한 잊지 않아 내가 가는 당신을 위한 모릅니다 아직 그대론지 비나 빛나는 빛을 비추고 길을 이끌어냅니다 숨 쉴 수도 없이 울었던 날 강해 지려고 노력합니다 매일 같은 꿈을 그려봤지만 되돌리고 싶어 시작으로 우회전하십시오도와주세요 다시 표류하는 것은 결코 끝나지 않았습니다 당신을 위한 잊지 않아 가는 강해집니다 강해집니다 우리는 결코 끝나지 않았다 처음으로 나를 데려오세요 전화하십시오 전화하십시오 전화하십시오 부르는 돌아갈 수 있으면 좋겠다 떨어지고 있습니다 떨어지고 있습니다 떨어지고 있습니다 위해 떨어집니다 처음으로 나를 데려오세요 강해집니다 강한 강한 강한 처음으로 나를 데려오세요 우리는 않았다 우리가 무엇을 하고 있는지 잊지 않았습니다,2,0,3,2,5
562,그림 같았던 우리의 날들 머나먼 길을 걷던 세상 모든 쉬워 보이고 치기 어렸던 너와 어디쯤인지 아무것도 보이지가 않아도 손을 뻗으면 닿을 것만 같았어 눈을 뜨고도 꿈을 꾸었던 찬란한 속을 걸어온 우리의 날들이 남김없이 펼쳐지네 끝없는 우리의 하루 끝엔 아무것도 모르는 어린아이처럼 티 없는 웃음만 남기를 아직까지는 알 수가 없어 어디쯤 가고 있는지 모든 걸음이 처음이었던 그때를 기억해 이제 모든 너로 새겨질 테니 누가 뭐래도 아프지 않을 단단한 마음을 가질 거야 날들이 남김없이 펼쳐지네 끝없는 하루 끝엔 아무것도 모르는 어린아이처럼 티 없는 웃음만 남기를 남김없이 펼쳐지네 끝없는 하루 끝엔 아마 모르는 어린아이처럼 웃음만 남기를,2,0,2,6,8
563,해가 지는 바쁜 하루 네가 혼자란 생각이 상처받은 마음을 위로해 줄게 손을 잡아 다 잘 될 거야 아무런 걱정 하지 마 잘 오늘 밤에는 좋은 꿈 꾸길 행복해지길 너의 앞에 오르막길 때론 지치고 힘이 들어도 힘을 내자 너의 손을 잡아줄게 힘을 내보자 하루 끝에 부디 너의 행복이 있기를 외롭지 않게 있을게 걸을게 모든 다 잘 될 거야 아무런 걱정 하지 마 오늘 밤에는 좋은 꿈 꾸길 행복해 지길 부디 힘을 내주길,2,0,1,-4,-3
564,한숨이 나는지 고갤 못 드는 건지 흠나만 건지 무거운 발걸음 오늘은 어땠는지 아니요 나만 건지 홀로 켜진 불빛 아래 쓸쓸한 눈빛 달아난 빛 고개를 들어보니 까만 하늘 속에 별 까만 마음속 비추네 혼자라는 말 말 나와는 어울리지는 않아 혼자뿐이란 말 날 향한 미소에 접어둘게 이유를 모른 채로 한숨 섞인 채로 아니요 어딜 향하는지 날 비운 채로 따라간 길 길 마음 다시 꼭 잡아 주위를 둘러보니 푸른 세상 속 사람들 부풀은 마음속 혼자라는 나와는 어울리지는 않아 혼자뿐이란 날 향한 미소에 외로운 걸까 나만 자유로운 걸까 나만 흠매일 밤 생각에 잠겨 잠 못 들었던 그때는 힘들었습니다 다신 없을 지금의 나에게서 달아난 나를 찾아 매일 밤 생각에 잠겨 잠 못 들었던 그때는 힘들었습니다 다신 없을 지금의 나에게서 달아난 나를 찾아 오늘,2,0,1,-1,0
565,거리를 걷는 이미 발을 들인 길 위에 바람이 불지 않습니다 어둠 밖에 없어 보여 언젠가는 날 기다리고 있을 무언갈 찾아서 어디엔가 꼭 기다려온 끝에서 두 손을 내밀게 끝까지 멈추지 않을 것입니다 내가 바라던 이야기를 찾아가려 해 결코 멈추지 않고 여기서 기다릴 것입니다 내가 바랬던 이유들을 향해 걸어가 끝까지 멈추지 않을 것입니다 내가 바라던 이야기를 찾아가려 해 결코 않고 여기서 기다릴 바랬던 이유들을 향해 걸어가 끝까지 않을 바라던 이야기를 찾아가려 해 바랬던 이유들을 향해 걸어가,2,0,1,2,3
566,돌아서지 않을게 곁 옆에 머물러 함께할 테니 기쁜 날은 뜨거운 눈물과 그대 힘든 날엔 커져가는 널 축하할게 아무 걱정 말아 그대 베이비 돈 걱정 다 뒤돌아설 나와 있어 편이 되어줄 테니 외로워 말기 혼자가 아니야 널 지켜줄게 약속합니다 언제나 늘 그래왔듯이 완벽한 날은 없는데 초라한 거야 우린 이대로 괜찮아 오늘 밤은 편한 꿈을 꾸길 바래줄게 소리 없이 우는 날도 들킬까 참고 웃는 걸 연습하느라 힘이 든 많은 날도 안아주는 사람 없고 영혼 없이 받는 응원에 지쳤어 근데 적응됐어 너도 몰래 여름도 너는 추워 방에 홀로 남아 슬퍼해 네가 괴로워 남긴 여러 자국들이 보이기에 안의 널 볼 때마다 안쓰러운 때가 많아 잘 지내냔 문자가 그렇다고 거짓말 별것도 아닌 걸로 걱정하지 사실 아무 문제도 아닌 거지 붙잡고 놓칠 못해 설치는 잠에 그게 안되는 위해 불러 뭐 그런 일도 있는 거지 내일모레 글피엔 웃을 테니까 두목 안아줄게 너의,2,0,4,-4,0
567,혼자여서 외로울 너무 깊이 생각하지는 마 보이지 않는 상처에 많이 괴롭더라도 괜찮아 조금씩 나을 테니까 아프지 말고 아프지 말자 마음이 다치지 않게 아프지 말고 오래 말자 지금 그대로 넌 잘하고 있어 힘이 들어 돌아가기엔 이미 너무 먼 길을 와버린 걸 알 수가 없는 내일이 불안해도 괜찮아 분명 나아갈 테니까 가끔씩 서러울 땐 말이야 쏟아지는 눈물을 참지 마 널 탓하지 않으니까 말고 말자 몸도 맘도 약해지지 않게 오래 지금 그대로 잘하고 있어 좀처럼 맘 같지 않아 때론 실망스러워져 이게 아닌데 무너지고 싶을 때에 쓰린 가슴을 다시 펴고 패인 상처 나을 때까지 번이라도 내가 안아줄게 마음이 너무 다치지 않게 누구보다도 소중한 너이니까 지금처럼 넌 잘하고 있어,2,0,4,1,5
568,혼자라는 생각이 이유 없이 눈물이 날 꿈을 꾸다 길을 헤매 차가운 현실에 겁이 날 괜찮아 스치는 바람일 거야 괜찮아 지나는 소나기 거야 얼룩질 마음속에 다가가 말할게 따뜻한 그날이 올 거야 반복된 일상에 지칠 나쁜 마음이 작은 말들이 상처가 될 버릇처럼 한숨이 날 괜찮아 스치는 바람일 지나는 소나기 얼룩진 마음속에 다가가 말할게 따뜻한 그날이 올 어깨에 기대 크게 울어도 돼 스치는 바람일 지나는 소나기 얼룩진 마음속에 다가가 말할게 따뜻한 그날이 올 얼룩진,2,0,3,-3,0
569,지친 하루가 지나고 어둠이 내린 길 위에 달빛에 몸을 기대어 쓸쓸히 홀로 걷는 길 너무 지쳤다고 말해도 될까 자그마한 위로가 필요한 밤 귓가에 들리는 아름다운 말 혼자가 아니야 곁에 있을게 천천히 가도 돼 느린 아냐 지쳐 쓰러지면 일으켜줄게 어제와 같은 하루가 무겁게 나를 누를 너무 힘들다고 말해도 될까 자그마한 위로가 필요한 밤 귓가에 들리는 아름다운 말 혼자가 아니야 곁에 있을게 천천히 가도 돼 느린 아냐 지쳐 쓰러지면 일으켜줄게 얼어버린 바다 위에 철없는 항해 아닐까 그게 아니라고 얘기해줘요 잘하고 있다고 위로해줘요 귓가에 울리는 아름다운 말 혼자가 아니야 곁에 있을게 천천히 가도 돼 느린 아냐 지쳐 쓰러지면 일으켜줄게 달빛에 몸을 기대어 쓸쓸히 홀로 걷는 길,2,0,4,-1,3
570,푸른 하늘을 작은 새가 부러워 나도 한번 날아볼까 낡은 줄에 묶인 너무 답답해 자유롭게 살고 싶어 답답했던 줄을 끊어버리고 높은 하늘 위로 파리 하얀 구름을 타고 하늘 높이 올라가 멋진 여행 시작해 혼자여도 괜찮아 멀리 바라봐 무지개 끝까지 자유롭게 날아갈 거야 답답했던 줄을 끊어버리고 높은 하늘 위로 파리 하얀 구름을 타고 높이 올라가 멋진 여행 시작해 혼자여도 괜찮아 멀리 바라봐 무지개 끝까지 자유롭게 날아갈 거야 높이 날아봐 날아봐 달이 닿을 때까지 멋진 여행일 거야 혼자여도 괜찮아 멀리 바라봐 무지개 끝까지 날아가 순간을 하얀 구름을 타고 올라가 여행 시작해 날아갈래 날아갈래 날아갈,2,0,-2,2,0
571,닿을락 말락 세상은 이틀에 한번 미치겠어 울적이게 해 그럴 때마다 빨라지는 심장 잠도 못 빨개져 눈만 너네보다 부족한 점 알아 목표에 의심도 꽤 많은 같아 말이야 내려놓고 싶어 사실 근데 무겁기에 버티려 했지 넌 순간 진심으로 순간은 올 거야 무조건 한숨도 못 자던 꿈밖으로 별비 쏟아지는 그대여 이제 외로워 마요 못 알아줘도 레인 스타 레인 스타 파랑새보다 멋지고 찬란한 그대는 꼭 승리할 거야 가고 있잖아 레인 스타 비가 내리는 별 될까 말까 해 노력해도 그럼에도 해왔으니까 그걸로 됐어 계속되는 어려운 선택과 애써 넘겼던 못된 기분들도 당신의 작은 이름 누구도 쉬운 한정을 지을 수 없어 속엔 무한한 필름 모르는 과정을 찍은 끝은 영화가 될 거야 굽은 어깨 펴고 확신을 가져도 돼 불안한 마음에 속거나 하면 안 돼 날개는 충분히 넓어 날 수 있어 그대로를 믿어 간절한 미래에서 말해 주고 싶어 별비 쏟아지는 그대여 이제 외로워 마요 알아줘도 파랑새보다 멋지고 찬란한 그대는 꼭 승리할 가고 있잖아 비가 내리는 별,2,0,7,2,9
572,꽃길이었으면 해 새로운 시작이 널 엄습하는 불안감도 이해가 돼서 가만히 앉아 있을 수 없네 그냥 응원이라도 해볼까 해 우리는 그것을처럼 노래합니다 방금 청구서를 만들었습니다 네게 전활 걸었지 이인칭 대명사 오랜만에 놀러와 옛날처럼 내가 살게 그대로야 집은 똑같은 동네 똑같은 곳에서 살아 날을 다시 기억하십시오 너와 매일같이 돌아다녔던 그때완 달라졌지 그것이 중요하다고 생각하지 않습니다 그대로기에 만이야 나도 생각나 아무 생각 없이도 재밌던 그때가 말이야 긴 해였습니다다 모였던 날이 만인지 먼저 연락 줘서 고마워 새로운 직업과 아이들이 먹이를 얻었습니다 예전같이 놀 수는 없잖아 생각 없이 내일 아침부터 일이 있어 갈 순 없겠지만 당신은 멋진 밤을 보내고 있습니다 꽃길이었으면 해 새로운 시작이 널 엄습하는 불안감도 이해가 돼서 가만히 앉아 있을 수 없네 그냥 응원이라도 해볼까 우리는 그것을처럼 노래합니다 당신에게 인생이라고 말하지 않았습니다 식으로 될 거야 내가 누누이 말한 조심하란 가끔씩 모든 관계가 비즈니스 같아 핸드폰 뚜뚜뚜 뚜뚜뚜 안 들려 뚜뚜뚜 이미 서로 버티고 있다는 걸 알아 얘기를 할 수 있는 널 제외하면 아마 주소록에 옮길 사람은 안 남아 요금제 괜히 무리해 무제한함 우린 항상 둘이 앉아서 피자를 먹거나 영화를 보곤 했지 지금 네가 떠난 소파에 싱크홀 뒤에 걸린 그림 방 추억이 되었네 꽃길이었으면 시작이 엄습하는 불안감도 이해가 돼서 가만히 앉아 있을 없네 그냥 응원이라도 해볼까 우리는 그것을처럼 노래합니다 모든 친구들이 타고 타고 갈진 몰라 너도 알겠지만 갈진 몰라 너도 알겠지만 작별 인사를 싫어합니다,2,0,3,2,5
573,표지판이 그리워 뒤로 보기 시작한다 모두는 역사를 만들고 싶어 합니다 이번에는 베이비 답을 찾습니다 꿈에 내가 전혀 몰랐다 나를 기다리고 있었다 굽이 굽어진 맘 맘의 근심이 빌딩의 능선을 한없이 행군하는 밤 길을 잃은 발걸음은 살얼음 위를 걷고 있는 듯이 점점 굳어져 길게 늘어진 가로등 그림자가 키보다 커질 때쯤 길을 걷다가 생각했어 그늘 속에 그림자를 숨기며 사는 것이 나을 수도 있겠어 타고난 운명에 저항한다는 건 너무 모질어서 뒤주에 갇힌 사도처럼 노래할 수 있었어 물고 태어난 수저도 인맥도 돈도 없지만 나를 믿었어 꿈과 희망 자수성가 음반 수익은 이따위 것들이 하나로 뒤엉켜서 나를 물들였지만 그땐 몰랐어 즐기면서 하는 성공은 없어 되돌아보는 표지판이 그리워요 보기 시작한다 모두는 역사를 만들고 싶어 합니다 이번에는 베이비 답을 찾습니다 꿈에 내가 전혀 몰랐다 기다리고 있었다 시간이 모자라,2,0,-1,4,3
574,소년이 어른이 되어 사람을 알아갈 때에 뜻하지 않던 많은 요구와 거친 입술들 소년이 어른이 되어 세상을 알아갈 때에 하얀 마음은 점점 어두워지고 잠 못 이루는 날이 많아지겠지 나의 오늘이 흘러가면 서글픈 추억들 중에 작은 조각이 되겠지 잡을 수 없는 시간들은 떨어지는 빗방울이 사라지듯 나를 스쳐가네 소년이 어른이 되어 세상을 알아갈 때에 하얀 마음은 점점 어두워지고 눈물 흘리는 날이 많아지겠지 나의 오늘이 흘러가면 서글픈 추억들 중에 작은 조각이 되겠지 잡을 수 없는 시간들은 떨어지는 빗방울이 사라지듯 나를 스쳐가네 미련한 나의 모습을 버릴 수만 있다면 오늘이 흘러가면 잡을 수 없는 시간들은 떨어지는 빗방울이 사라지듯 나를 스쳐 내일이 다가오면 소년의 꿈을 이뤄줄 작은 노래가 돼줄게 오늘도 미련 없이 남겨두고 떠나가네,2,0,3,-2,1
575,거짓말쟁이 가족들에게 괜찮다 말해 죽을 같은데 나를 불태워라 내가 누군지 기억이 안 어린애였는데 텅 빈 방 안 소년은 외로워 멀리 도망가고 싶어 구렁텅이에서 날 꺼내 줘 누가 안아줬으면 싶어 누군가 나를 도와주세요 내가 나일 수 있게 도와줘 누군가 나를 도와주세요 웃고 있는 가면 벗겨줘 행복하지 않아 행복하지 않아 억지 미소 짓지만 행복하지 않아 살고 싶지 살고 싶지 죽고 싶진 않지만 살고 싶지 숨만 쉬는 기분 하루 끝에 잠이 때쯤에야 놓지 한시름 별일 없냐는 질문 별일 없다고 대답 아무 일도 없는데 울적할까 그건 의문 오늘도 감정노동해 맘대로 되는 일이 없네 속이 텅 빈 껍데기 작은 불씨에도 타들어 가는 쉽게 부서지는 재 같아 텅 빈 방 안 소년은 외로워 멀리 도망가고 싶어 구렁텅이에서 날 꺼내 줘 누가 안아줬으면 누군가 도와주세요 내가 나일 수 있게 도와줘 웃고 있는 가면 벗겨줘 억지 미소 짓지만 죽고 싶진 않지만,2,0,2,-1,1
576,내가 꿈 찾아 행복 찾아 하루하루 살아가다가 만나버린 괴로웠던 순간들 다 지나가리라 피할 수 없다면 즐겨라 퇴근길에 편의점 개에 만원인 캔맥주 원플원 과자 두 봉 기다릴 울 냥이 통조림 간식 세상 편한 차림으로 침대 위에 걸터앉아 최신 업데이트 영상 본다 눈 호강에 입속 가득 찬 단잔의 조화 내가 꿈 찾아 행복 하루하루 살아가다가 만나버린 괴로웠던 순간들 다 지나가리라 즐길 수 있을 거야 너는 좁은 방에 매트 깔고 생전 처음 해 본 요가 체중계에 올라서서 어제와 같은 몸무게에 안도하며 배달 앱에 단골 식당 요리조리 찾아보고 조리 요리 찾아보고 맛에 살지 내일도 일하러 간다 내가 꿈 행복 하루하루 살아가다가 만나버린 괴로웠던 순간들 다 지나가리라 즐길 수 있을 거야 너는 인생이 별건가요 똑같아요 열받고 힘들면 한잔하고 꿀잠 자고 그러다 웃고 즐길 있을 거야 너는 살아가다 고민들,2,0,-1,2,1
577,오쉿 저녁을 먹다 벌써 엄마 뱃속에서 나와 알아 젊습니다 꽃처럼 피어나겠지 좋은 엄마가 되십시오 괜찮아 아빠가 되세요 좋은 형제가 되십시오 괜찮을 거야 좋은 엄마가 되십시오 괜찮아 아빠가 되세요 형제가 괜찮을 거야 잠깐만 요 여기에 약간의 시간이 있다면 내게 만 나눠줘 국어 수학 영어 따윈 배워봤어도 어른이 되는 방법 따윈 돈을 하지 않는다 알고 있습니다 파티는 여기저기에 다들 걱정이 없네 척하는 중인 건지 자유의 무게는 가늠이 안 가서 빈속에 겁부터 먹고 있지 평생을 눈치를 보는 법 배웠던 나인데 왜인지 지금은 엉망이 되다 아마도 앞으로 삼킬 술잔이 던지는 경고나 메스꺼워 우린 어디로 흘러가는 중일까 다시 만날 수 있을까 다시 못 볼 얼굴들이라 해도 지금은 찍어놨던 민증이 빛을 발할 때야 우리는 트립 핀입니다 우리는 거를 사람처럼 훔칩니다 글쎄 그것은 시간입니다 어쨌든 계속됩니다 무거운 걸음으로 가벼운 파티에 어색한,2,0,6,7,13
578,좋은 하루 보내세요 좋은 하루 보내세요 좋은 하루 보내세요 내가 이렇게 된 거죠 제발 누가 말 해줘요 어린 시절 내가 찢었던 행운의 편지 때문일까요 그래요 우습죠 항상 지나간 뒤에 뒤돌아보며 늘 후회를 매일 걷곤 하는데 항상 같은 거릴 걷는데 왠지 낯선 기분일까요 숨이 가빠 오는 걸까요 그래요 사는 힘들어 그런가 봐요 늘 외롭고 지친 하루하루 하루에요 행복하게 사는 거죠 하루에요 걸어가는 거죠 하루에 요산 다는 그런 밤이 가면 또다시 아침이 오는 항상 달려가는데 앞만 보며 걷는데 늘 제자리인 걸까요 나만 힘들어 보일까요 괜찮죠 잠시만 멈출래요 먼 하늘 보며 숨을 고르고 하루에요 행복하게 사는 걸어가는 산다는 그런 밤이 가면 또다시 아침이 오는 하루에 요 아주 잘 하고 있어요 조금만 힘을 내요 하루에 요산 다는 그런 밤이 가면 또다시 아침이,2,0,-1,2,1
579,오랜 밤이 지나고 다시 내일이 찾아오면 나의 꿈은 가까워질까 시계처럼 멈춰있을까 하늘의 빛내 젊은 날의 하늘 늘 바래 왔던 나의 꿈들도 언젠간 플라이 플라이 플라이 피지 못한 꽃들도 언젠가는 피어오르고 구름 속에 갇힌 별들도 걷힌 하늘엔 환히 빛날 텐데 하늘의 빛내 젊은 날의 하늘 늘 바래 왔던 나의 꿈들도 언젠간 플라이나의 밤은 외로워 내일은 두려워 아직은 힘이 들지만 이겨낼게 하늘의 빛내 젊은 날의 하늘긴 시간에 멈춰 있어도 언젠간 뭐가 널 그렇게 만드니 아름다운 아름다운 아름다운 인생 아직 삶은 아름답잖아 될 거야 인생 꿈속에 닿을 때까지,2,0,-1,-2,-3
580,빛은 어디에 있습니까 어두워 보이지 않아 존재하긴 하는 건지 끝이 어디에 있습니까 가도 가도 끝이 없어 한참을 걸어도 결국엔 제자리걸음뿐 기나긴 터널 속을 헤매다 희미하게 보이는 빛을 따라가 느리면 맘이 뛰고 있는데 그거면 충분한 건데 너구나 조급해 하지 마 기다리는 것도 없는데 천천히 가면 돼 아무것도 아닌 걸 계속 밤을 보내십시오잘하고 있잖아 빛을 향해 계속 걸어가십시오 그대로 걸어가면 돼 이토록 오래 헤매게 될 이대로 끝이 되어버릴까 두려워 기나긴 터널의 끝에 희미하게 보이는 빛에 이끌려 느리면 맘이 뛰고 있는데 그거면 충분한 건데 조급해 하지 마 기다리는 것도 없는데 천천히 가면 돼 아무것도 아닌 걸 계속 밤을 보내십시오 어둠이 지나면 눈부신 밝은 태양이 너를 반겨 맞이할 거야 빛을 향해 걸어 가십시오 새로운 미래로 향해 너는 그대로만 걸어가면 지금 순간 내뱉는 숨들이 누군가에게는 따뜻한 위로가 될 수 있도록 높이고 있습니다 높이고 있습니다 하늘로 날아갑니다 터널의 끝에서 정해진 건 없어 가슴이 뛰는 대로 해 별처럼 빛나고 있습니다 넌 자체로도 빛나 빛에 물들어 맘이 가는 대로 하면,2,0,-4,2,-2
581,세상엔 상처가 가득한 마음을 들고선 아무렇지 않은 척 걸어 다니는 사람들로 가득해 우린 그런 서로와 웃고 떠들다 울고 화내고 서롤 밀쳐내다 두 팔로 껴안아 어른이 처음이야 마음 익숙하지 않은 걸 어른이 처음이야 마음 모르고 싶어 어른이 처음이야 내가 전혀 볼 수 없는 나의 마음 어딘가에 구멍이 뚫려 줄줄 새어나가는 느낌이 들어 잡히지 않는 무언가를 계속 쫓으면서 뭐가 정답인지 잘 모르니까 멈춰있고 세상은 늘 먼발치에 아직도 나를 잘 사랑할 모르고 보이지 않는 것들을 가득 움켜쥔 채로 이렇게 무뎌지는 되는 걸까 멈춰있고 세상은 늘 먼발치에 아직도 나를 잘 사랑할 모르고 보이지 않는 것들을 가득 움켜쥔 채로 이렇게 무뎌지는 되는 걸까 익숙하지 않은 걸 싶어,2,0,3,2,5
582,듣기 당신이하고 싶은 일을하십시오 그것당신의 인생 몽상가 돈 죽는 당신이하고 싶은 일을하십시오다 해 다 해 하고 싶은 대로 해 좋은 날에 하고 대로 괜찮아 우린 아직도 꿈을 꾸고 가슴이 뜨겁게 뛰는 걸 당신의 심장 박동을 느끼는 것을 의미합니다 당신이하고 일을하십시오오늘따라 하늘이 높네 기분도 날아갈 듯해 일을하고 싶어요상쾌한 내음 한 모금해 뭐라도 해야 할 듯해 일을하고 싶어요 음 하고 싶어어쩐지 하나도 두렵지 않음 허락하다 는 꿈이 이루어집니다앞이 보이지 않고 세상이 휘청거려도 힘차게 우리는 강해야합니다뜻대로 되지가 않고 어긋난대도 흘러가는 시간을 타고 일을하십시오다 다 대로 좋은 날에 괜찮아 우린 아직도 꿈을 꾸고 가슴이 뜨겁게 뛰는 걸 당신의 심장 박동을 느끼는 것을 의미합니다 일을하십시오지금 시작해도 절대 안 늦었어 그것너무 늦지 않았습니다그것너무 늦지 않았습니다 누가 뭐라 해도 일을하십시오 모든게 괜찮을거야 인생이니까 통제하십시오통제하십시오 오른쪽 왼쪽 앞으로 다시 가고 곳마다대체 어디에 일을 할 수있을 때까지해야 할 일을하십시오네 자신을 믿고 두목두려워하십시오여기요 앞이 보이지 않고 세상이 휘청거려도 힘차게 당신의 삶의 별입니다아무도 대신 못 영원히 다시 오지 않을 밤을 일을하십시오다 다 좋은 날에 괜찮아 우린 아직도 꿈을 꾸고 가슴이 뜨겁게 뛰는 걸 심장 박동을 느끼는 것을 의미합니다 일을하십시오 마음 가는 모든 허락하다 수행합니다미치고 싶고 숨쉬고 싶고 꿈꾸고 싶어 찬란히 빛나고 있어 마음 가는 모든 허락하다 수행합니다미치고 싶고 숨쉬고 꿈꾸고 싶어 찬란히 빛나고 있어,2,0,-3,0,-3
583,지친 하루 멈춘 나의 걸음 누구도 내게 알려준 적 없는데 벌써 까마득한 내일 머물고만 싶어 어제에 너무도 빠르게 다 변하는 같아 멈춰 있는데 부정적인 생각은 다 버리고 갖다 버려 긍정적인 사고방식을 가지고 습관 들여 한 번에 한 단계 씩 한 걸음 걸음 가자 허락하다 간 멈추지만 않으면 끝이 아니니까 천천히 속도로 가도 괜찮아 그것 남들과 비교하지 말고 시간을 내어 시간을 내십시오 그것 경주가 아닙니다 나의 길로 가면 돼 그것을 알고 이것은 끝이 아닙니다 꿈을 꾼다 생각해 우린 어디로든 언제든 가다 끝까지 좋은 기억만 간직해 시간을 걷는 여행자기 약 없는 우리만의 우리의 여행 끝을 모르는 여행 진심을 가린 애써 마음을 감추는 덜 자란 어른이 돼 버린 나에게 나와 같은 너에게 화려한 조명 뒤 감춰진 쓸쓸해 보여 어두운 그림자 늘 맑았기에 가면 뒤에 숨겨왔던 상처들을 꺼내 작은 바람에도 흔들려 생각은 나를 삼켜 그럼에도 인생이란 여행 설렘이 가득해서 꿈이 가득 찼던 어릴 적 세상은 더는 없어도 인내와 용기를 담아 튼튼해진 캐리어 이것은 끝이 아닙니다 꿈을 꾼다 생각해 우린 여행자 어디로든 언제든 좋은 기억만 간직해 걷는 여행자기 약 없는 우리만의 걸어도 걸어도 아득하기만 해 맨 처음 시작은 나쁘지 않았었는데 다시 가보는 거야 오우리의 삶이란 어디로든 언제든 좋은 기억만 간직해 걷는 여행자기 약 없는 우리만의,2,0,-1,0,-1
584,지난밤 내내 꿈속에 펼쳐둔 걱정거리도 이제는 털어내도 돼 돼 하루는 다시 시작돼 일기장에 적힌 빼곡한 말들 안에 살짝 적어봤던 꿈 기억할 거야 어두운 밤 잠이 들지 못한 별 이제는 알아 밤새 다독이던 너의 작은 바람 이제는 알아 숨고만 싶었던 어린 날의 작은 꿈을 아직은 못다 피운 작게도 웅크려왔던 모든 상상들을 이제 피워낼 거야 이제 시작할 거야 지나간 일들은 잊어 나아질 지금의 길 위에서 헤매더라도 다시 일어서면 돼 또다시 올지 모를 날선 시선들 지워지지 않은 깊은 흔적들 아픈 상처까지도 순간 감싸 쥐고 있잖아 알아 밤새 삼켜내던 너의 어둠까지 숨죽여 고요한 마음에 일렁이던 진심을 지금껏 헤매었던 맑고도 깊게 지나온 모든 시간들을 밤새 다독이던 너의 작은 바람 숨었던 숨기던 지난날의 모든 꿈들 많이도 헤매었던 작게도 웅크려왔던 틈 사이로 이제 피워 낼 피어날,2,0,5,3,8
585,뭔가 답답해 숨을 쉬고 있어도 숨이 막혀 호흡이 뻐 하루가 멀다 하고 넘어지기에 바빠 삶의 무게가 어깨를 짓눌러 분명 휴식이 필요해 숨 쉴 공간이 필요해 좋은 대화가 필요해 나쁘지 않은 낯섦과 느리게 가는 시간과 좋은 술 한 잔이 지금 이대로 떠나버릴까 다 내려놓고 훌쩍 떠날까 어디든 좋으니까 다 잊고 지금 이대로 떠나버릴까 버릴까 뭔가 막막해 얘길 하고 싶어도 마음이 닫혀 말문이 막혀 하루가 멀다 하고 멀어지기에 바빠 해도 슬픔에 잠겨 잠겨버린 마음에 맞는 열쇠가 있을 거라고 생각해 두려움 없는 설렘과 살아 숨 쉬는 감정들과 유치한 희망이 지금 이대로 떠나버릴까 다 내려놓고 훌쩍 떠날까 어디든 좋으니까 잊고 버릴까 뭐가 이렇게도 복잡한 건지 이미 답은 나와 있는데 아직도 이곳에 내려놓고 훌쩍 떠날까 어디든 좋으니까 잊고,2,0,3,0,3
586,너무 일찍 커버린 우리는 쉽게 금이 가는 마음을 가졌죠 희생 같은 치사한 단어를 당연하단 듯이 안고 살아가죠 무얼 위한 나인 건지 알지도 못하고 부디 행복하자며 쓴웃음처럼 말해요 깊은 밤을 오늘도 어김없이 맞이하는 그대 마음에 이불 덮어줄게요 깊은 밤에 울음을 삼켜내는 상처 많은 그대 삶을 모른 척해 줄게요 오오 음 모르는 아픔은 아무것도 아닌 되다들 그렇게 사나 가슴에 멍한 두 개쯤은 아무렇지 않단 표정 지은 채 어디서부터가 어른이고 그다음은 무엇인지 쓸만하고 따뜻한 위로를 모아놓아도 추워진 집 다 지나면 거지 같은 순간들도 추억 이면 추억이지 모를 일이겠지 오늘 내가 뱉은 말이 내일은 유언일지 무얼 위한 나인 건지 알지도 못하고 부디 행복하자며 쓴웃음처럼 말해요 깊은 밤을 오늘도 어김없이 맞이하는 그대 마음에 이불 덮어줄게요 밤에 울음을 삼켜내는 상처 많은 삶을 모른 척해 줄게요 한 번도 안아본 적 없는 나를 꼭 끌어안고서 오늘 밤만은 안심해도 된다며 스스로에게 위로를 건네요 밤을 오늘도 어김없이 맞이하는 마음에 이불 덮어줄게요 밤에 울음을 삼켜내는 상처 많은 삶을 모른 척해 줄게요 울어도 돼요,2,0,4,-5,-1
587,누군가에겐 너무도 쉬웠던 일이 늘 내겐 어려웠어 머물고 있어도 그곳에 없었고 세상은 신기루 같았어 외롭고 외로워라 날 둘러싼 모든 점점 날 혼자이게 해 괴롭고 괴로워라 앞에 놓인 현실은 영화보다 영화 같아 잠깐만 요이 순간을 잡고 놓지 않겠어 너와 우린 달랐을 뿐 잘못되진 않았어 소리쳐봐도 메아리가 없는 세상은 무향실 같았어 지치고 힘들어라 내가 꾸는 꿈들이 점점 날 작아지게 해 차갑고 차가워라 마음은 너무도 뜨겁고 현실은 얼음장 같아라 잠깐만 요이 순간을 잡고 놓지 않겠어 너와 우린 달랐을 뿐 잘못되진 않았어 그냥 붙잡아 순간을 잡고 놓지 말아 줘 너와 우린 달랐을 뿐 잘못되지 않았어,2,0,8,3,11
588,널 이렇게 보내줄 수밖에 없었어 후회할지도 모른 체 끝없이 다가오는 너와의 기억을 잊으려고 차마 눈을 감았어 널 위해 한 번도 눈물 보인 적이 없었어 눈물이 네게는 아픔인 걸 알고 있기에 네가 있는 어디에서도 너를 느낄 수 없어 슬퍼져 혼자라는 생각 힘들 때면 뒤를 돌아봐 언제나 여기서 있을게 가는 길이 힘들어 쉬고 싶을 땐 나를 한번 생각해봐줘 서로를 위해 우린 멀리 떨어져 있는 거라 말해도 잊을 수가 없을 테니까 지금 떨리는 마음을 너는 잘 알고 있을 거야 슬퍼져 혼자라는 생각 힘들 때면 뒤를 돌아봐 언제나 여기서 있을게 가는 길이 힘들어 쉬고 싶을 땐 나를 한번 생각해봐 언제까지 너와 있으니 그리운 추억에 힘들 때면 뒤를 돌아봐 언제나 여기서 있을게 가는 길이 힘들어 쉬고 싶을 땐 나를 한번 생각해봐줘,2,0,5,-1,4
589,도대체 나답다는 뭔데 다 포기하려는 날 말리는 사람들 할 수 있단 말은 그대들 입버릇 그만할래 포기하겠어 되돌아가는 것도 큰 용기야 내키지 않는 것은 다 억지야 펑펑 울다 지쳐 잠들면 세상이 나를 반겨 테지 바닥을 치고 오르면 다시 다가갈 꿈이 보여 편한 삶을 원친 않았어 가려 했던 그곳 고단했었던 길 긴 터널의 끝에는 빛이 내렸지만 가까워지진 않더라 희망이란 고문을 다 견뎠지 나를 다그치고 몰아세웠어 펑펑 울다 지쳐 잠들면 세상이 나를 반겨줄 테지 바닥을 치고 오르면 다시 다가갈 꿈이 보여 나와 했던 약속들을 어기겠어 희망 하나로 아프다면 비겁해 질래 주저앉을래 날 사랑할래 실패 향해 걷는다 길에 무너져도 세상은 비웃겠지만 내가 떳떳했으니까 됐어,2,0,3,-2,1
590,말도 안 되지 나간 기억만 남겨둔 채 말도 안돼 너의 향기는 아스팔트 아래,3,1,0,0,0
591,넌 나란 남자에게 모욕감을 줬어 자신을 탓해도 늦었어 어쨌든 말해줘서 다행 며칠 전에 술 취해서 전화해 말하려다가 만 이거였어 말로만 듣던 어장관리녀였어 그것도 아니지 하필 양다리 시작에 내가 자리한 맞지 실상은 양다리 이상일지도 예쁘면 예쁜 값을 한단 말이지 꼭 근데 어떡할래 메인 남자친구에게 걸렸어 걔도 너처럼 이성관계 더러워 뭐 어쩜 용서받을지도 모르겠네 다 왔어 꺼져 여기서 내려 진짜 화나지만 여잔 안 때려 어이가 없어 누군가를 잘 받을 자격이 하긴 보면 속은 바보지 넌 나란 남자에게 모욕감을 줬어 자신을 탓해도 늦었어 실연을 당했느니 어쩌니 술 취한 척 어깨에 기대면서 날 꼬시던 스킬 대체 번째니 그러면서 재미 느꼈니 내가 뭔 죄니 순진한 죄인가 내가 심심풀이 놀이 상대인가 이제 어떡해 인간들이 놀릴 텐데 애인 생길 거 같다고 자랑도 해놨는데 진짜 어떡해 이제 책임져 입은 모욕감 어른들이 항상 말씀하시고 속담에도 있지 믿는 도끼에 발등 찍힌단 말 하필 지금 하필 여기서 내려 진짜 화나지만 여잔 안 때려 어이가 없어 누군가를 잘 받을 자격이 하긴 보면 속은 바보지 넌 나란 남자에게 모욕감을 줬어 자신을 탓해도 늦었어 네가 뭔데 착한 날 울려 닫힌 맘 낭비한 물어내 하긴 어쩌면 편이 후련해 이제는 아니까 같은 여자들의 놀다니가 뭔데 착한 날 울려 닫힌 맘 낭비한 물어내하긴 어쩌면 편이 후련해 이제는 아니까 같은 여자들의 놀 나이 정도일 줄은 몰랐지 노는 일상이겠지만 나한텐 다를 알았지 꺼져버려 순결한 차에서 줬어내 줬어내 네가 적은 글을 어디서 읽었어 제목은 사랑 뒤 상처뿐,3,1,-3,0,-3
592,네가 나를 좋아해 줬다면 나의 작은 차를 좋아해 줬다면 너의 못생겼던 손을 좋아했을 지도 몰라 네가 나를 이뻐 해줬다면 나의 작은 키를 이뻐 해줬다면 너의 쉬지 않던 입을 이뻐 했을 지도 몰라 괜찮아요 어쨌든 끝난 얘기 괜찮아요 어쨌든 우린 안 맞는 단 얘기 기억해 내가 오늘 술에 취해 속 좁아 이러는 건 절대 아냐 오늘 밤은 네가 생각났을 뿐이야 나를 이해해줬다면 나의 익숙함을 이해해줬다면 너의 아는 오빠들을 이해했을 지도 몰라니가 용서해줬다면 지루함을 용서해줬다면 밤새 꺼진 전화를 용서했을 몰라 괜찮아요 어쨌든 끝난 얘기 우린 안 맞는 단 기억해 내가 오늘 술에 취해 속 좁아 이러는 건 절대 아냐 밤은 생각났을 뿐이야 눈으로 바라보는 모습 눈으로 기억하는 모습 그건 내가 아니야 진짜 아니야 눈으로 바라보는 모습 기억하는 진짜가 아니야 끝난 얘기괜찮아요어쨋든 우린 안 맞는 단 기억해 술에 취해 속 좁아 이러는 건 절대 아냐 밤은 아주아주 진짜 진짜 생각났을 뿐이야,3,1,-2,-6,-8
593,당신의 작은 마인드 나우 안에서 보세요 우리는 너무 단단 해져서 우리는 너무 영감을 얻지 못했습니다 너무 아프고 피곤한 모든 증오에 질려서 당신은 게이 웰이 되기에 좋지 않다고 말합니다 당신이 당신은 끈적인 관점을 묶을 수없는 인종 차별주의자 일뿐입니다 우리는 당신이 하는 일을 싫어하고 당신의 전체 승무원을 싫어합니다 당신의 말이 번역되지 않는 것은 꽤 많은 글 얻지 못한다 당신은 증오하는 삶을 사는 것을 정말로 좋아합니다 당신이 하는 일을 싫어하고 전체 승무원을 싫어합니다 말이 번역되지 않고 꽤 많은 글 얻는다 엿 먹어 엿 먹어 우리가 오웰에 가야 한다고 생각합니다 하는 일을 싫어하고 전체 승무원을 싫어합니다 말이 번역되지 않고 꽤 많은 글 얻는다 엿 먹어,3,1,-6,0,-6
594,일어났을 널 안고 싶어 안되는지 알고 싶어 삥땅 친 돈이 쌓여있어 너를 사고 싶어 너랑 하고 안되는 건 너뿐이야 안되는 건 너뿐이야 안되는 건 너뿐이야 나도 살아 이렇게 근데 일은 잘 풀리지 잘 안 기다려 각자의 길이 있기 때문이지 지구를 사기전에 목걸이나 보렴 돈 문제는 다 지웠어 대기업 회장님처럼 내가 봤을 땐 우린 어울려 산타 할 백 년과 겨울옷 서울년들 사이의 서울 보석 물어보는 너와 물고 빠는 놈 일어났을 널 안고 안되는지 알고 삥땅 친 돈이 쌓여있어 너를 사고 너랑 하고,3,1,2,-4,-2
595,버림받았어 한마디로 얘기하자면 보기 좋게 차인 같아 빌어먹을 가슴속엔 아직도 네가 살아 있어 바보였어 몰랐었어 나를 사랑한다 생각했어 마음도 널 사랑했기에 내가 가진 전부를 줘버렸어 넌 왔다 갔어 날벼락이 세상에 남은 듯한 하늘이 무너져 내리고 있어 깊은 곳으로 떨어져 모르게 속에서 살고 있는 널 죽일 거야 인생 길을 망쳐버린 모습을 없애 놓을 거야 그렇게 사랑스럽던 네가 나에겐 눈물을 보일 기회도 주지 않았었지 아무 일도 잡히지 않고 아무것도 들리지도 보이지도 않나 허우적대고 있었지 생활은 칙칙하게 됐어 앞뒤가 맞지가 않잖아 이를 악물고 잘 됐어 모르게 속에서 살고 있는 널 죽일 거야 인생 길을 망쳐버린 모습을 없애 놓을 모르게 설레었던 나의 마음을 아름답던 기억들을 없애 놓을 밤새우며 그미워한 많은 날들을 미치도록 사랑스러운 너의 모습을,3,1,3,5,8
596,찌질이가 예상외로 잘 나가니 배가 아파 뒤지겠지 마 너네 반 이상이 돈만 쳐다볼 한심하다 생각했지 너네 자랑할 부러운 적 단 한 번도 없어 사실 정이 떨어지고 질릴 때에 꼬우 면 나도 하란 식의 조언 엿 바꿔 먹고 침 퉤두목내 승무원도 싸우려고 시도해 진짜가 되십시오 너무 틀려 머리 쓰는 방식 너네가 볼 때는 사료 먹고 배 채워서 행복해도 그게 사람이냐 가축아 미련한 건 병도 아냐 엉덩이로 나이 먹어 사랑할 몰라 누굴 가르친대 멍청이야 제발 관심 꺼라 변태야 신고하기 전에 경찰의 너넨 입 다물고 화장실 머리 숙인 모습 자연스러워 그대로 박고 있어 홍학이시냐고 그리 안 살란가다 체 게바라처럼 사랑하는 아들이 미친 지에 예에 쟤네 운대요 미친 아들에 예에 화가 났대요 미친 아들에 예에 쟤네 운대요 화났어 아무것도 못 하죠 우냐 아들 덤벼들어 손 까딱 아무것도 못 해서 아들 덤벼들어 손 까딱 아무것도 못 해서에 그것을 내려놓으십시오 핫 드롭은 그것을 좋아합니다 핫 드롭은 그것을 좋아합니다 로이아래로 내려가서 핫 드롭은 좋아합니다 사격 멋진 친구들 멋진 들여놀러 다녀 너넨 눈을 돌려 꼴 보기가 싫어 네가 제일 좋아하는 가게에서 추방시켜내 머리 위 인간은 수 없지 고집불통 이상주의 죽어도 자존심이 주요 부위는 나를 시험해 본 적이 있다오 정신이 혼미해 홍대 길거리에 샷이 너무 많습니다 머리에 멍청한 패거리 언제나 재밌지 현명함 따윈 다 빼먹지 적들이 사방에 적을 사랑한다 얘네들 내가 되곤 해 아드레날린 느낌 느껴지는 에너지 저지르지 중죄 강북 대표 플레이보이 여성은 멋진 소년을 사랑합니다 훔쳐 여자친구들 마음 필요 없어도 강북 대표 플레이보이 여성은 소년을 사랑합니다 훔쳐 여자친구들 마음 필요 없어도 우냐 아들 덤벼들어 손 까딱 해서 해서 아들에 쟤네 운대요 화가 났대요 화났어 하죠 우냐,3,1,-6,-5,-11
597,이에서 원하는 것을 말해줘 나에게 나에게 당신의 모든 나는의 강력하지 않고 나를 찢어 버릴 수 있다고 생각하지 않는 당신의 모든 바쁜 거 알아 근데 내게 잠깐만 마음을 열어 달란 말이야 너의 미소 저장 마음에다 너의 눈 우주 아까워 수면 당신을 보고를 봐야 당신은 당신은 유일한입니다 당신은 유일한입니다 내가 당신과 사랑하는 유일한입니다 인생 안에서 당신을 원합니다 네가 나의 만들어 기준네가 원한다면 대령 내가 당신을 사랑하고 당신이 필요하다는 것을 알고 있습니다 세계로 초대해 주겠니 지금 단발에 큰 눈이 너무 잘 어울리는 배 날카로운 눈매는 찰랑이는 생머리가 베스트 단조로운 나의 삶의 너의 향기로 가득해 나에게 자랑스러워 그녀의 졸린 눈과 입술은 앤젤리나 졸리 그녀의 얼굴이 작거나 그녀의 엉덩이가 입으니까 고기에 중요한 것은 시점에 정말로 내가 그녀를 사랑합니다 마음 하나로 만족해 이제 우리는 댄스 플로어에서 춤을 추겠습니까 너무 익숙하게 섹시해도 부담되니까 서툴러도 어차피 눈에 콩깍지니까 아무 데도 가지 않아 천사 맨 아래에 맨 위에 이태원 홍대 강남은 너무 익숙해진 도시 생활 뉴욕 엘에이 젊을 너와 갔으면 해 여행 거를 사랑하는 네가 나의 만들어 기준네가 원한다면 대령 사랑하고 당신이 필요하다는 것을 알고 있습니다 세계로 초대해 주겠니 지금,3,1,6,-3,3
598,이제 다신 나를 찾지 마 너를 알고 만났던 거에 대한 나의 후회 이름부터 년까지 다니가 있다는 자체가 불편해 네가 망친 거란 걸 넌 제발 잊지 마니 거지 같은 인터넷 친구들 안 봐도 뻔해 이름부터 년까지 다 하나였다는 자체가 제일 큰 후회야 이제 다신 나를 찾지 마 너를 알고 만났던 거에 대한 나의 후회 이름부터 년까지 다니가 있다는 자체가 불편해 네가 망친 거란 걸 넌 제발 잊지 마니 거지 같은 인터넷 친구들 안 봐도 뻔해 다 하나였다는 제일 큰 후회 아니에요 사라지고 싶다 말 뜻은 지금 옆에 애니가 말을 하면 베토벤 컷오프를 원한다 내가 말을 해야지 넌 편해져 맞다 너는 불편하기 싫어 편해서 말했지 계좌로는 돈 못 보내줘 돈은 모으지도 않고 한 번에 써한 번 했어 안 변해서 원했어 사기꾼이 판에 치는 세상 속에선 돈 벌인 커지고 맘씀이만 검소해져야 이제 다신 나를 찾지 마 너를 알고 만났던 거에 대한 나의 다니가 있다는 불편해 네가 망친 거란 걸 제발 잊지 마니 거지 같은 인터넷 친구들 봐도 뻔해 다 하나였다는 제일 큰 후회야 아니에요 사라지고 싶다 말 뜻은 지금 옆에 애니가 말을 하면 베토벤 컷오프를 원한 핑계만 대고 있어없는 얘기는 지어난 편한 베고 있어난 없어 노력할 필요 조작 해 기억 너무 쉽게 누굴 지워난 핑계만 대고 있었어난 너무나 싫어,3,1,-3,5,2
599,스타 스웨터를 위한 생생한 희망에 대한 하이 하이 희망을 가져야 했다 백만 아리우스 중 하나는 높은 희망을 가졌다는 희망이 높았다는 것은 예언이 예언을 말하면서 위대한 일이 레거시 메니 리프의 운명을 만들어내는 모든 것을 원했던 모든 것을 원했던 모든 것을 원했던 원한다 사랑하지 않을 것입니다 당신에게 기다리고 있는 보고 싶어 하는 싫어하는 싫어합니다 내가 내가 항상 내가 항상 느낌이 있었는지 아는 백만 알로에 있는 사람은 높은 희망이 높았다 이상하게 낯선 사람 십자군을 위해 이상한 위해 이상하지 않고 참신은 이상하지 않아도 우리의 원했다는 것은 원했다 복잡한 묶음이 사랑받지 못하는 싫어하는 싫어하는 싫어하지만 것이 끝났다고 말하지만 그들은 가장 좋은 메소를 보지 못했습니다 살인 디드를 가질 수 없었지만 항상 높은가 높은 글 가졌다 거실에 대한 하이 희망을 가지고 있었는데 백만 알로가 글 가졌다는 느낌이 들었다 가에 대한 생생한 갖기 위해 살인을 만들 수 없었습니다는 알로에서 가졌다는 느낌이 들었습니다,3,1,2,-3,-1
600,마침내 그날이 와버렸네 오래오래 오래오래 오랫동안 기다려왔다네 참을 수 없었나 그래그래그래 그랬나 지쳐버렸나 지나치게 걱정을 했었나 나쁜 나쁜 나쁜 사람 될까 두려웠었나 아냐 혹시나 네가 나를 착한 착한 착한 사람 아니라고 거절할 거야 아무리 이런저런 얘기를 해도 내가 내키질 않으면 거절할 거야 아무리 얼굴이 어두워져도 내가 내키질 않으면 거절할 거야 아무래도 역시 안되겠어싫어 싫어 싫어 싫어 싫어라는 말을 입 밖으로 내는 상상해 보려고만 해도 막 입꼬리가 완전히 굳어버리려고 하는데 아냐 아냐 오늘만은 내가 부탁을 아무리 이런저런 얘기를 해도 내키질 않으면 얼굴이 어두워져도 이런저런 얘기를 얼굴이 어두워져도,3,1,-4,1,-3
601,은행 털어 우리는 강도들입니다 지갑 헐어 버리고 다시 벌어 아아은행 털어 우리는 강도들입니다 지갑 헐어 버리고 다시 벌어 은행 털어 우리는 강도들입니다 지갑 헐어 버리고 다시 벌어 아아은행 미디엄 누운 행 오키 너무 많아 악당 가장 큰 래퍼 시발점은 이곳에 비트를 보자 마디 절단 돈 세느라 바빠 메르세데스 벤츠 말은 돈 되는 놈이라는 거지 남자 살아 있었다 끔찍한 날 래퍼 캡 없음 이제는 웃을 일만 남았다고 듣다 당신의 지역에 새로운 아이들이 높은 전설을 가고 있습니다 젊은 특권을 죽으십시오 올라갑니다 될 거야 돈을 버는 떨어뜨립니다 돈을 버는 사람의 직업이 없었습니다 내가 할 거야 넌 말이 너무 많아 생각부터 바꿔 비에게는 돈을 얻습니다 담아 가방에 그것을 훔쳤습니다 절대 못해 너넨 나를 누가 방해해 너희는 나에게 집 중한 간이 됐어 샤넬 박이나는 코코아 사랑에 빠졌다 ,3,1,3,4,7
602,번째 나팔소리가 천지에 진동할 조심스레 갈고 갈아온 칼을 뽑아 드로라 저주받은 자의 애달픈 혁명이로다 광풍 속으로 달려들 비명 속에 나뒹구는 원수의 주검을 보리라 성난 얼굴로 돌아보라 피를 흘리게 하라 성난 이빨을 드러내어라 피를 흘리게 하라 펄펄 끓는 젊은 피가 거꾸로 솟을 적에 푸르게 날이 선 칼끝에는 검광이 빛난다고 기다려왔던가 세상을 뒤집어엎을 날을 그날 밤은 오늘 밤 영광 죽음뿐이다아 그날이 언제이더냐 이를 갈며 기다린 날이 드디어 때는 왔노 라이 검을 휘두를 날이랄 라라라라라라랄 라라라라라라랄 라라라라라라랄 라라라라라 우리의 앞길을 가로막을 누구라더냐 철옹성을 쳐부수고서 힘차게 맹진하노라 짓밟힌 자들의 처절한 복수리로 다 주먹 불끈 쥐고 일어설 화염 속에 불타오르는 철옹성의 끝을 보리라 우리는 자랑스러운 대한국의 청년폭도 힘차게 맹진하며 골로 가는 청춘이다 랄라라라라라라랄 라라라라라 성난 얼굴로 돌아보라 피를 흘리게 하라 이빨을 드러내어라,3,1,-1,-2,-3
603,문제이래 다 거래세 보인대 어쩔래난 멋 부리네 꾸미네 아가씨 다 못 말리네 불편한 말들이 선을 넘어난 보란 해내서 보여줘 버려나도 사랑을 원해나도 평화가 편해하지만 모두가 알잖아 건드리네를 만지지 마십시오 멋대로 해 뭐 상관없어요 맘대로 해 건드리네 나를 만지지 마십시오괜찮아 걱정 마 너무 좋아난 즐거워 살을 먹는대도 절대로 안 꿀리는 걸 하고 싶지 않아 독창적이 되고 싶어남의 눈치 보지 않아 건드리네를 만지지 마세요 와서 싸구려를 팔아 참지 않아 당신은 아무런 문제가 없습니다 맘대로 맘대로 누가 뭐래도 나대로 내가 문제라면 답 없지 당신은 보고 응시할 수 있습니다 나를 마십시오 불편한 말들이 선을 넘어난 보란 해내서 보여줘 버려나도 사랑을 원해나도 평화가 편해하지만 모두가 알잖아 건드리네를 마십시오 멋대로 해 뭐 상관없어요 건드리네 나를 마십시오괜찮아 걱정 마 너무 좋아난 즐거워 살을 먹는대도 절대로 안 꿀리는 걸 하고 싶지 독창적이 되고 싶어남의 눈치 보지 건드리네 때론 눈물이 쏟아지기도 날 만든 눈물이기도 익숙해 신경 쓰지 마 절대로 절대 절대 누가 뭐래도 멈추지 멋대로 뭐 상관없어요 마십시오괜찮아 걱정 너무 좋아난 즐거워 살을 먹는대도 안 꿀리는 걸 하고 싶지 독창적이 되고 싶어남의 눈치 보지,3,1,-2,-1,-3
604,아무것도 필요 없어 대체 뭐가 필요할 수 있겠어 그냥 뭐라도 해야겠단 생각에 집 밖을 나갔을 뿐인데 네가 언짢아하면 할 말이 없어 너는 열두 시가 되면 전화기를 안 받아그러다 세 시 아님 시에 문자가 어쩌고저쩌고 방금 자다 깼어 이거 듣는 사람 그녀가 클럽에 있었단 간 비밀로 해 줘 왜냐면 걔를 좋아해 걔가 앤지 알고서도 좋아해 걔가 남잘 만나는 걸 알고 있지 근데 걔는 내가 모를 아는 만큼 꽤 순수해 가슴의 찢어짐을 이기는 건 답장의 기다림을 이기는 건 너야 필요할 때만 넌 나를 사용해도 정도 여자 만나려면 어디까지 감당해야 하니 오늘은 가니 세상은 원래 건가 사랑은 원래 건가 너는 블로거 같아좋은 곳을 많이 알지나랑 간 알고 너는 말실수를 하지 세상은 원래 건가 사랑은 아무것도 필요 없어 대체 뭐가 필요할 수 있겠어 그냥 뭐라도 해야겠단 생각에 집 밖을 나갔을 뿐인데 네가 나를 안 만나 줬잖아 내가 화를,3,1,1,-4,-3
605,왠지 오늘따라 마음이 아픈지 했더니 오늘은 그대가 날 떠나가는 날이래요 항상 이렇게 외로운 사랑을 하는지 도무지 이해가 안 가는 이상한 날이에요 그랬는지 묻고 싶죠날 사랑하긴 했는지 그랬다면 날 안아줬는지 그렇게 예뻐했는지 나만 세상을 살고 있는 같아요 바라보기만 하다 포기할 수는 없겠죠 그런데도 이렇게 아픈 마음만 가지고 사는 건 도무지 불공평해서 견딜 수가 없어요 제발 나에게 돌아와 줘 왠지 오늘만은 그렇게 보내기 싫은지 오늘은 그대와 마지막인가 봐요 항상 이렇게 아무 말도 못 하는지 도무지 이해가 안 가는 이상한 날이에요 시작부터 사랑하지 않았다고 내게 말했었다면 그랬다면 나의 마음은 굳게 닫혔을까요 만 세상을 살고 있는 같아요 바라보기만 하다 포기할 수는 없겠죠 그런데도 아픈 마음만 가지고 사는 건 불공평해서 견딜 수가 없어요 그대는 아무렇지 않겠죠 제발 나에게 돌아와 줘 눈물로 붙잡을 수는 없겠죠 제발 나에게 돌아와 줘 근데도 아픈 마음만 가지고 사는 건 불공평해서 견딜수가 없어요 돌아와서 주세요 사실 이성적인 싫어요 우린 헤어져야만 했으니까 아무렇지 않게 살아가도 매일 밤이 고통스럽겠죠 그대가 정이 많은 사람이었다면 날 안아주진 않았을까요,3,1,-2,-2,-4
606,아시다시피 우리는 그것을 소유하고 있습니다 알아서 손 떼 절대 흉내 못내 끼 없는 연습 벌레 때깔 다르지 그것을 하나의 유지해야 한 다저 여잔 화색이 돌아 낙하 죄다 기생오라비 촌티 노려 지 감 찾는 사이 얼씨구 풍년이 왔지 낮은 한 아니야 마초처럼 완전 날것의 해이 무대는 구역이야 구경이나 더해쟤넨 진짜 멋이 뭔지 몰라 형편없는 몸짓 단계에선 예의 없게 노는 답 준비할 준비를 하십시오 오늘부로 품행제로 품행제로 모두가 그래요 멀쩡한 날이 없지 왔다 갔다 싸가지 바가지야얄 라리 얄라리야 오늘부로 품행제로 왔다 갔다 싸가지 바가지야얄 라리 얄라리야 손들어 만세 젊어서 노세요 알겠으면 하고 말해어렸을 나쁜 짓 많이 해봤니 대충 그런 간지 그것 액션 헤이 형제를 위한 잘 봐둬 진짜 깔롱다 엎어 사구 파투 회사는 우릴 타일러 해 봤자 깡그리 아류 멍청한 더미를 이해했습니다 진작에 종은 쳤고 게임은 끝이 났지 할 리 갈리쟤넨 진짜 멋이 뭔지 몰라 형편없는 몸짓 단계에선 예의 없게 노는 답 준비할 준비를 하십시오 오늘부로 모두가 그래요 멀쩡한 날이 없지 왔다 갔다 싸가지 바가지야얄 라리 얄라리야 들어와 환영해 사랑타령 안 할 사람만이 순간 항복해 손을 위로 두목처럼 행동하지 않습니다처럼 행동합니다 뚱보 이제 그만 굼떠 허락하다 에스 난폭운전 규칙 따위는 어겨 모두가 그래요 멀쩡한 날이 없지,3,1,-1,-1,-2
607,가끔 너무 멀리 왔다는 생각다 겁에 질린 표정이었을까 걱정 너무 하지 않아도 돼 걱정하지 마세요 너를 그냥 안아줄게 젊음 버리기 답답해 문을 열어 이건 너를 위한 아가페 우람 칸을 타고 너무 멀리 떠나버려 다라 오지 못해 크게 틀게 노래 우람 칸을 타고 빨리 떠나버려 다라 오지 못해 크게 틀게 노래 꿈 소년 소원 멀리 떠나버려 둘이 손 꽉 잡고 멀리로 따라올 수 없게 해 시간도 빛바랠뻔했던 소녀 무지개를 담아줄게가 벗어나 멀리로 하나로 충분해 지금 순간 꿈 소년 소원 우람 칸을 타고 빨리 모던 것에 지쳐버려 떠나버렸사랑한다 말해 근데 이것마저 멀어져 가니 미소에 영혼을 걸던 소년은 컸어 나의 슬픈 아픔 꺼내놓는 쉽지만은 않아 나를 꺼낼 요한 너의 오늘 하룬 어때난 순간 무너지는 건데 목에 걸친 파열 답지도 않고 병신 같아 뭔가 와버렸나 커져버린 공허함이 어른이 된 신호라는 건가 나를 놔두고 가둬놨던 나의 서울 나의 밖으로 내가 원한 삶 꿈 소년 소원 둘이 손 꽉 잡고 멀리로 따라올 수 없게 해 시간도 빛바랠뻔했던 소녀 무지개를 담아줄게가 벗어나 하나로 충분해 지금 순간 빨리 떠나버려떠나버려떠나버려떠나버려떠나버려떠나버려,3,1,-6,3,-3
608,죄악의 단어 위선의 가면 넘쳐흐르는 무도회장 터지는 샴페인 포도주와 빵 배부른 돼지들의 춤예쁘일 수 있을지도 모르지만 할아버지가 옳을 수도 있습니다 죽어라 불러라 거짓말의 노래를 죽어라 따라춰 악마들의 춤사위 성대한 잔치의 중심 커다란 단두대 아래 굴러다니는 목은 누구의 친구들을 환영합니다 다음은 누구일까네 예쁜 머리를 당신의 방에 매달아 사랑은 어디에 있어 우린 무엇을 잃었나 농장인가 죽어라 불러라 거짓말의 노래를 따라춰 악마들의 춤사위 성대한 잔치의 중심 커다란 단두대 아래 굴러다니는 목은 누구의,3,1,-2,4,2
609,날 사랑한다는 흔해빠진 거짓말 반복되는 싸움 가야 작별 인사 딴 사람 만나고 내겐 집에 가서 잤다고 둘러대는 제발 그냥 가라고 뭘 원해 어느새 손을 잡아 너답게 애 찾아 떠나가라고 널 떠나는 건 내겐 행운이란 걸 나가 밖으로 나가십시오 몸에 손대지 마 소름 끼치니까 이름 부르지 마 듣기 싫으니까 네가 뭘 안다고 사랑하긴 뭘 한다고 됐어 필요 없어 꺼져 멀리 몸에 손대지 만난 돌아가지 않아널 사랑하지 않아나 아웃 미안하다 하지 마 됐고 설명하려 하지 적당히 해 소리 지르기 전에 어리석은 잘 생각해 계산이 느리니 눈부신 날 놓친 걸 넌 후회하게 될 걸이 손 놓으라고 꼴 보기 싫다고나가 밖으로 나가 밖으로 아웃렛 가야 해내 몸에 손대지 소름 끼치니까 이름 부르지 듣기 싫으니까 네가 안다고 사랑하긴 한다고 됐어 필요 없어 꺼져 멀리 만난 돌아가지 않아널 사랑하지 않아나 아웃 가시 박힌 말을 실컷 퍼붓고 아주 완벽하게 돌아서는데 두 눈에 눈물이 차는 지나가 나가 나가자 가슴은 아프지만 사랑은 끝났어 넌 아니라고 해도 이미 끝났어 나를 잊고 과거 따윈 치워두고 넌 너대로 행복하길 바랄게 마나 아웃,3,1,-10,-2,-12
610,내가 사준 옷을 걸치고 내가 사준 행술 뿌리고 지금쯤 넌 그녈 만나 웃고 있겠지 그렇게 좋았던 거니 날 버리고 떠날 만큼 잘해야 한 거니 너를 아무리 지울래도 함께한 날이 얼마인데 지난 시간이 억울해서 눈물이 흐르지만 보여줄게 완전히 달라진 보여줄게 예뻐진 바보처럼 사랑 떠난 울지 않을 래더 멋진 남잘 만나 꼭 보여줄게 너보다 행복한 없이도 슬프지 않아 무너지지 않아 당신은 알고 있어야 합니다 산뜻하게 머릴 바꾸고 정성 들여 화장도 하고 하이힐에 짧은 치마 날 돌아봐 우연히라도 널 만나면 눈이 부시게 웃어주며 놀란 모습 뒤로 한 채 또각또각 걸어가려 해 완전히 달라진 보여줄 예뻐진 바보처럼 사랑 떠난 울지 않을 래더 멋진 남잘 만나 꼭 너보다 행복한 없이도 슬프지 않아 무너지지 당신은 알고 있어야 합니다 네가 줬던 반질 버리고 네가 썼던 편질 지우고 미련 없이 후회 없이 잊어줄 거야 너를 잊을래 너를 지울래 완전히 달라진 예뻐진 바보처럼 사랑 떠난 울지 않을 래더 멋진 남잘 꼭 너보다 행복한 없이도 슬프지 무너지지 당신은 알고 있어야 합니다,3,1,3,-3,0
611,이모티콘 같아 너의 얼굴에 답장을 해야 해화가 같아 일이 커지기 전에 사태를 파악해와 치롱 아기 아기와 이롱 빨리 알아채고 달려 거북이 밟어 악셀을 밟어 너의 묘지에 대지 선풍기 바람이 불어 여기까지 날아오셨나요 악귀가 붙어그렇게 무서워졌나요 사랑이 넌 너의 화에 데어버렸잖아 으엑너의 불에 타버린 플렉스 심장 두근두근 쿵치탁치 붐뱁나의 무릎 땅에 붙어 있어 져려 다리 손을 계속 비벼 빌고 있어 파리 나의 명품 사과받아줘라 메이드 인 파리 어서 화를 잘라 줘 눌렸잖아 가위 화는 바위 계란 같지 기어올라 봤자 너한테 닭대가리 분별 못 해 사리 머리 나빠 사실 말실수를 해서 화에 추가하지 냉면 사리 이모티콘 같아 얼굴에 답장을 해야 해화가 일이 커지기 전에 사태를 파악해와 치롱 아기 아기와 이롱 빨리 알아채고 달려 거북이 밟어 악셀을 묘지에 대지 선풍기 그걸론 안돼 너는 너무 뻔뻔해 언제나 이렇게 그냥 넘어가려 해말 같지 않은 소리만 늘어놓고 있네 뭘 잘 못 했는지 알고 있기나 해 미안하다는 말 반복해 너는 입버릇처럼 되어버린 말 너를 안 봐도 뻔한 비디 오잖아 아직도 너는 나를 모르잖아넌 내가 말해도 기억을 못 해외 하지 못해 연락을 해도 받지 못해 날인지도 몰라 어째 다시 널 믿지 않아 받지 않아 사과 속지 않아넌 답답해 고구마 감자 알 수 없어나를 좋아하긴 하는 거야 바보 같은 표정 지워진 심이란 말이야 귀엽다고 봐주는 건 진짜 마지막이야 마지막이야 마지막이야 이모티콘 얼굴에 답장을 해야 해화가 일이 커지기 전에 사태를 파악해와 치롱 아기 아기와 이롱 빨리 알아채고 달려 거북이 악셀을 묘지에 대지 선풍기,3,1,-2,6,4
612,나를 강하게 때려 나를 강하게 만들었습니다 정해진 대로 따르라고 그게 현명하게 사는 거라고 쥐 죽은 듯이 살라는 말 같잖은 말 누굴 위한 삶인가 뜨겁게 지져봐 절대 꼼짝 않고 버텨낼 테니까 거세게 때려봐네 손만 다칠 테니까 나를 봐끄떡없어쓰러지고 떨어져도 다시 일어나 오를 뿐야난 말이야 똑똑히 봐깎일수록 깨질수록 더욱 세지고 강해지는 돌덩이 감당할 수 없게 벅찬 세상 유독 내게만 모진 세상 모두가 돌아섰고 비웃었고 아픔이 나였지 시들고 저무는 그런 세상 이치에 날 가두려 하지 마 틀려도 괜찮아 삶은 내가 사니까 봐끄떡없어쓰러지고 떨어져도 다시 일어나 오를 뿐야난 말이야 똑똑히 봐깎일수록 깨질수록 더욱 세지고 강해지는 돌덩이 누가 뭐라 해도 나의 길 하나뿐인 나의 길 전부를 내걸고서 여기요 걸어가 계속해서 부딪히고 넘어져도 다시 일어나 걷는 거야 길 끝에 서서 나도 한 번 크게 한 번 목이 터져라 울 수 있을 때까지,3,1,-6,0,-6
613,당연히 기억나지 서울 작은 공연장 그때가 여름 방학 고 고 한국에 돌아왔을 만났던 내가 아마추어였을 때야 아마도 한동안은 첫사랑이라 믿었기 첫 이성과의 만남 헤어지고도 기다렸지 싸이월드 미니홈피에 올린 사랑 노래 손 오그라드는 가사들을 기억해 얘도 기억나 내가 한국에 돌아와 리미와 감자 웜맨형을 만나 홍대 바닥을 배워 나갈 거야 아마 처음 백 명 앞에 무대 위로 나가 열여섯 마디 여럿이 맞춰 입었던 옷이 보였을진 몰라도 내가 좋다고 따라다녔었잖아 괜찮다고 생각했지만 너무 장거리 연애였나 갑자기 부산 해운대 바다가 기억나 여자를 처음으로 안아서 술집에서 일하던 애도 기억나 미안해 그때는 작업하느라고 바빴어 전화를 걸어도 일부러 안 받아 마찬가지로 이미 잘 알잖아나를 버렸던 잊어버렸던 전부가 지금 와내게 연락을 하는 건네 기억 속의 너와 전혀 닮지 않은 걸 똑같은 장면이라면 입을 뒤로 감지 않을래 너는 달랐으면 해 자신을 똑바로 들여다봤으면 해나와 널 우리로 가두기,3,1,3,-4,-1
614,확인 현실에 낙서하고 다니는 문제 아내 멋 대로 그린 세상 알잖아나는 그것을 요리한다 스튜디오 안은 부귀영화의 냄새로 만 가득해 품을 떠난 일은 관심 끊어 끊어 티켓 완벽한 타이밍 너흰 못 메겨 아주 재미있는 순간을 잡아낸 다면 그냥 돌멩이가 되다 이아 패 한 벌 우린 다 빡 세게 가서 가져가라 걸음걸이 목에 그려 코끼리 우리끼린 미리 이미 사족은 불필요 사내놈들이 말이 많아 뭐 이리 산중호걸이라 하는 호랑님의 생일 잔칫날이 오늘 온갖 짐승들이 모여 신났지 왜냐 벌 거거든 큰돈을 이빨만 터는 걔넨 털렸어 이빨이 그니까 낮춰 톤을 오를 대로 오른 폼으로 쉽게 그냥 놀러 온 듯이 벌어재껴 빡 빡세게 당겨 빡 박다 챙겨 싹 싹 몸을 에워 싹 벌어재껴 빡세게 당겨 박다 챙겨 몸을 에워 싹은 꺼져 맨 위난 될 거야 수입으로 맨 위 음 사과는 뭔 사과니 랩 구려 차나 닦아넌 아직 랩해 배 벌어 넌 뱁새 뱀 빠른 슬랙 슬릿을 닦으십시오 어서 트니 개나리를 꼴렸다 말하면 믿겠다 배알,3,1,1,-1,0
615,한 번 맘을 알아줘널 위한 눈물을 받아줘 사랑은 바라지도 않았던 끝난 얘기다 지난 얘기 으니가 미워 죽겠다 네가 내가 싫어 죽겠다 내가 한 번만 나를 한 번 바라봐 이제 울고 있어요 네가 밉다 죽을 만큼 네가 밉다 싫다 미치도록 내가 싫다를 알고 있습니다 싫다 밉다 죽을 만큼 싫다 미치도록 싫다를 알고 있습니다 돌아선 맘을 멈춰줘 널 보는 눈빛을 받아줘 사랑은 바라지도 않았던 끝난 얘기다 지난 얘기 으니가 미워 죽겠다 싫어 번만 나를 번 바라봐 이제 울고 있어요 죽을 만큼 미치도록 싫다를 알고 있습니다 아기가 세계 복귀로 돌아와 여자가 되라 않으면 널 죽도록미워하꺼란걸 알아낼 사랑했던 마음이 미움으로 다 바뀌기 전에 돌아와 어서 내게 잘못했다고 어서 얘기해 나를 바라봐 눈 맞추고 안아봐 입 맞추고 날 널,3,1,-3,-1,-4
616,분위기와 바이브와 가십시오많아진 주위 안에 여자 여자 아직도 널 기다리는 걸 너만 보여 어디도 못 가게 하지 사랑에 빠졌어 러브 푸어 샷이 필요해 아직 못 잊어 전부를 잃어 없으면 도 못가 저를 사랑해요 가지 샷이 필요해 아직 못 잊어 전부를 잃어 없으면 도 못가 사랑에 빠졌어 릴처럼 이모를 돌리고 밤에는 이제 마셔 독한 위스 키넌 보석같이 빛나는 아내 대처할 수 없기에 빼고 다 있지 절대 스위치 할 수 없어 또다시 꼬인 하늘 아래서 지나간 모든 것이 잘못 자연스럽게 따라가네 너에게서 받은 아픈 나의 심장 휴식 안 보여나고가 간다 길어지내 밤을 새워 밤새도록 멍한 상태야 진통제는 이제 필요 없어 필요하지 않습니다 나아졌지만 작년보다 괜찮아 필요한 건 사랑 닫혀있던 심장을 어디로 데려간 건지 내게 알려줘많아진 주위 안에 여자 아직도 널 기다리는 걸 너만 보여 어디도,3,1,-1,8,7
617,너네 자랑하고 싶은 거 있으면 해난 괜찮아 왜냐면 부럽지가 않아 한 개도 부럽지가 않아 너네 자랑하고 싶은 거 있으면 해난 괜찮아 왜냐면 부럽지가 않아 전혀 않아네가 가진 많겠니 내가 가진 많겠니 잘 모르겠지만 한번 우리가 이렇게 한 번 머리를 맞대고 생각을 해보자고 너한테 십만 원이 있고 나한테 백만 원이 있어 상당히 너는 내가 부럽겠지 짜증 나겠지 근데 입장을 한번 바꿔서 우리가 생각을 해보자고 덕분에 행복할까 내가 많이 가져서 만족할까 아니지 세상에는 천만 원을 가진 놈도 있지 그놈을 부러워하는 거야 짜증 거야 누가 짜증 날까 널까 날까 몰라 근데 세상에는 말이야 부러움이란 거를 모르는 놈도 있거든 그게 누구냐면 나야 너네 자랑하고 싶은 거 있으면 해난 괜찮아 왜냐면 한 개도 전혀 그게 다 부러워서 그러는 거지 뭐 아니괜히 그러는 아니라 그게 다 부러워서 그러는 거야 부러우니까 자랑을 하고 자랑을 하니까 부러워지고 부러우니까 자랑을 하고 하니까 부러워지고 아주 뭐 너무 부러울 테니까 개도 전혀,3,1,-1,-2,-3
618,흔하디흔한 행복하라는 착한 작별 인사를 해 주기엔 맘이 안 무섭고 네가 미웠어 청춘을 허비했다는 생각이 말로 되는 건 너무도 서롤 알아왔던 탓차 라리 모든 거짓말이라면 모자란 사랑이 몫이 헌신이 진심이 너에겐 불편했구나 헌신이 진심이 너에겐 미안하단 말 듣는 거 싫은 거 알아 함부로 억지로 그러지 않아 근데 맘이 안 어쨌든 고맙고 고마웠으니 추억으로 가장한 벅찬 속의 떨치지 못하는 어쩔 수 없는 나란 사람 못 다한 사랑에 보낸다나는 당신을 사랑했습니다 치밀어 오르는 슬픔에 바친단 눈물이 노래가 너에겐 나였다나는 당신을 사랑했습니다 사랑해 사랑해 사랑해요 사랑해 못 다한 사랑에 당신은 나의 굶주림이었다 치밀어 오르는 슬픔에 바친단 눈물이 노래가 나였다나는 당신을 사랑했습니다 맘이 안,3,1,-10,-7,-17
619,그냥 이렇게 할 거야 이걸로 끝왜 평소 하던 대로 해 바라보다 지금 가면 영원히 절대 안 속으로는 너를 못 가게 걸고 싶지만 바 내가 메두사도 아니고 뒤도 안 보대 바닥에 떨어뜨리더라 원래는 목에 걸려있던 선물 끝났나 권투 사우나에 앉아서 수건을 걸고 한숨만 셔 탕에서 김은 그날의 눈앞에서 서서히 사라져 네가 언급되면 나의 눈치를 봐넌 나를 알잖아 감정 잘 못 숨기는 유형 표정이 차갑게 굳지 동상 사장 학교와 비유하면 총장 네가 나를 거두고 돌아와달라는 말은 마 가재 채기 해서 가루약 다 날려버렸어 우리의 연을 놔 날려버렸어 늦잠 잔 수험생 날려버렸어 잉꼬 부인 재채기해서 가루약 다 우리의 연을 놔 늦잠 잔 수험생 잉꼬 부인 새 친구 생겼더라 나도 있어얜 주일이 된 여자 친구지 이뻐 나를 사랑해내게 잔소리 안 해나도 상관 없어오니 지금 만나는 걔 있지 걔한테 잘 해귀,3,1,0,1,1
620,돈을 얻으십시오 열 밤 하늘의 펄 날아가지 별난 돌직구 너는 커브 컵 안에 컵 안에 컵 안에 야바위 같은 세상에 도사 같은 포즈흠술 안 마셔도 한 도수 높아타오르는 열 위에서 춤을 춰 터프 이내 레벨 프로 게이머에 영혼들은 많아 남자 버전의 영감을 받고 다시 창의력 가뭄 다시 열기를 발견 이걸 년째 반복 다시 쉬어갈 수 있는 타이밍이 나와 사이에도 새로운 이야기들이 나와난 그냥 물처럼 흘러가는 존재 백도가 돼도 절대 안 돼 고체 타오르고 있는 열 같은 나무여도 건 뭔가 결이 서른이 돼도 계속 추구하는 변화 가서 만들어지는 한 편의 영화 너의 반지를 던져 여긴 새빨간 용암 회색 도시 속에 활짝 피어 성과 공중에서 손 미지근해진 여기에는 필요하지 예열 섭씨 섭씨 섭씨 내가 넌 내가 아는 걸 좋아해 당신이 당신의 일을 하는 것을 보고 싶어하고 나에게 열심히 줘내 머리 어깨 무릎 발은 너무 힘들어 소스가 무엇인지 손가락 핥아 오른 쪽빛이 몸은 당신이 그것에 대해 생각하는 것을 봅니다 우린 있어 차이가 은 누구도 아닙니다레 눈이 부셔 가리지 앞을 다르니까 빛이 날 감싸니까 쳐다볼 수가 없잖아 당신은 내가 잘 할 수 있습니다 나은 칸은 당신을 좋아하지 않는다 나은 보일 리 뜨거운 당신은 당신입니다 간신히 일부 많은 늘 모든 것을 바운스 바운스 바운스 바운스에 거짓말쟁이 엉덩이를 불태우기 시작합니다 진실의 온스가 당신이 말하는 곳에서 당신의 입에서 당신은 시간을 낭비하는 불난 재가 돼 좋아요 먼지 넌 그런 존재란 불난 재가 돼 좋아요 먼지 넌 그런 존재와 난난 뭐가 되던 하면 그냥 잘 날 하기만 하면 트렌드 세터도 손을 높이 하늘 위로 올려봐 오늘 밤땀은 식힐 수 없어 온도가,3,1,1,4,5
621,오늘 특별하게 드레스 업하길 원해 왠지 내가 내가 아닌 같아 음 멋지게 마인드는 대담해 난나 오늘 되는 같아 트렌디한 느낌의 액세서리 그에 걸맞은 두 눈 반짝 반짝 빛나는 클링네 옆에 친구도 혹하지 시선 입술에 눈 오늘 내가 퀸 여왕 여왕 옆에만 서면 너도 왕 왕 날 원하는 남자는 많지만 너를 픽을 선택하십시오 마지막일지 몰라 더는 감추지 않아 시간은 빨라 우릴 기다리지 않아이끌리는 대로 네가 원하는 대로 멈추지 막 입술과 입술 입술이 달콤하게 녹여 거야 엉덩이와 엉덩이 정신없이 빙글빙글 입술 입술 엉덩이와 히프 시끄러운 히프 스즈우 멋진 입술과 힙합 입술과 힙합과 립 슬립과 힙합을 얻었습니다 매일 솔직하게 표현해 주길 원해 네가 네가 아닌 같아 가끔 섹시하게 워킹은 당당해 난나 되는 마지막일지 몰라 더는 감추지 않아 시간은 빨라 우릴 기다리지 않아이끌리는 대로 원하는 멈추지 막 입술이 달콤하게 녹여 거야 엉덩이와 엉덩이 정신없이 빙글빙글 말로는 설명 못 해나 제정신 아닌듯해 엉덩이 입술이 달콤하게 녹여 거야 정신없이 빙글빙글 멋진 힙합을 얻었다 멋진 엉덩이를 얻었다,3,1,6,0,6
622,걸러 눈깔 돌아가는 놈들 걸러 벌렁 눈깔 안 돌아가는 거 보면 심장 벌렁 정신 잡아 안 잡아간다 비밀 떠들어대는 놈들 주둥이 나불거려 뒤에서 벌렁벌렁 벌렁벌렁 벌렁벌렁 주둥이 벌렁 아니면은 꺼져 심장 절대 안 무시 선생님들 가르침 양아치들 가래침 입속에 도로 넣어 까불지 마 꺼내 주머니 안에 뭐 숨겨 놨길래갈 길 가라 근데 얘네다들 이렇게 다부지냐 뻥 차 태워 똥차 대갈빡 잇 돈다 돈다 태워버리거나 볶아 고립됐어 눈치 보지 말고 중간에 와서 껴 진짜 ㅈ도 아냐 새끼네가 마음먹고 맞서면서 면 거리 걸었던 옛날 행사에 대가는 스태킹 재산 매장 가서 이거 사고 저거 사고 포부 대빵 넘치는 배짱여 전해 배짱은 집에서만큼은 대빵 어쩌면 이건 한 생각 현실은 집 붓다가 나보다 서열이 한 단계 높은 거 아니야 높은 거를 보다가 걸리는 담 거기로 갈 수 있어 일순간에 기죽냐 한 번쯤 해 인물 값 청춘,3,1,0,-7,-7
623,팩으로 남자를 본 적이 있습니까 시장과 예술의 견해 내가 퍼진 모든 마음의 상태 너무나 헌신적이라는 것이 어휘를 선택할 꼰대지 아무래도 못 벌 땐 질 좋은 보케 히트 문제입니다 골칫덩이인가 봐나는 문제가 부스러기 털어도 연예인들 줍는 꼴은 아까워 미친개가 아니에요 밥벌이는 연예인 골라 까기 연예인들 예술가 취급하면 곤란하지그래 가사 온스에 맹렬한 마음 그램을 얻었습니다 뱉은 말에 책임지려 연예인들과는 안 친하지 모든 건 동일한 방식으로 돈 버는 방식으론 빠는 상식으로다 시끄러워 유키의 부기는 검은 티를 퇴색시켜네 몸에 붙는 아내 그들은 너무 어리 석습니다 돈 쓸어 담는 길을 멀리 돌아 바닥을 다져 좋은 시계 부기 많은 친구는 필요 없지 어울려봐야 내가 득 본 것처럼 꾸며질 좋은 이상의 것을 가졌고 막상 맛을 보니 쓰더군 근데 높게보다는 멀리 왔지 식사는 구리 손잡이와 은색 숟가락 이곳에 이쁨 받을 필요가 전혀 없어내가 나의 주인 너희들은 궁전에 개 짖어라 짖어 궁전 밖에서 노숙하면 되지 에프 부기에 엠마마 너무 부기 사자 돌림 직업은 안 가졌어도 지켰어 품위 계급사회 찌들어 유명한 새 비서 역할 따내기 게임 위론 없는데 비위를 맞춰야 되지 너무 부지에 처음 이곳에 도달했을 와는 전혀 반대의 마음가짐 부기 대중교통에 간간이 협찬받아 날 꾸미지만 부기한 질하는 애들을 보며 노력에 비해 얻는 없어도 어머니는 결코 검은 티를 퇴색시켜네 몸에 붙는 아내 그들은 어리 석습니다 돈 쓸어 담는 길을 멀리 돌아 바닥을 다져 시계 많은 친구는 필요 없지 어울려봐야 내가 득 본 것처럼 꾸며질 이상의 것을 가졌고 막상 맛을 보니 쓰더군 근데 높게보다는,3,1,0,-1,-1
624,이제 그만 헤어지자 이렇게 헤어질 거라곤 생각도 못 했지 솔직히 말해 질리는 거 있잖니 알 거야 자신이 사귄 것도 대단하다 생각지 않니 어제 오랜만에 친구를 만났는데 애인이 있느냐고 나한테 물어보데 그냥 애인 없다고 했어 사실 어제 핸드폰도 일부러 꺼놓은 거야 괜찮아 나도 나가면 애인 없다고 해 그런 건 이해하니까 걱정 안 해도 돼 근데 만나려고 두 전부터 샤워하고 샴푸하고 왁스 바르고 선물까지 준비했는데 맞다 선물도 샀어 받아 헤어지자고 하니까 벌써 숨 막혀 잘 봐야 손 떨리는 거 보이지 어우 이거 봐야 잠깐만 어디가 선물은 두고 가야 잠깐만 거기서 끝인 거라면 내가 줬던 선물 커플링까지도 돌려주고 가기가 막혀 네가 안 되는 거야 지금이라도 널 버려 잘 됐어 지금 말들 진심인 거니 믿지 못하겠지 나도 마찬가지야 급하게 나가느라고 들고 간 것뿐이야 짜증이 쌓여가 널 상대하다간 왁스를 바르건 무스를 바르건 이제 여자한테나 보여주라고 그런 건 숨 막힌다고 했어죽을 같아 있으면 죽겠단 얘기 나오겠다 그냥 ,3,1,-6,1,-5
625,여자 괴물 주변 사람들이 나보고 미친 같대 너도 날 보고 지금 미칠 같대 이해해 나도 내가 미친 같아난 미친 것처럼 리듬에 맞춰 춤도 춰 한 번 떴다 하면 여기저기 난리 나이 밤이 다 가도록 난리 크나 답은 정해져 있어 넌 확인 아무렇게 그렇게 너도 나도 난리 나더는 널 외롭게 하지 마는 앞에 세상에 이제 숨겨온 널 찾아봐 오늘 밤 미쳐 소리 질러 즐겨 밤이 가잖았다 뛰어 흔들어날 보고 미쳐 해 모도 다 미쳐미친 것처럼 것처럼 미쳐 미미 이미 지금 내게 다 미쳐나가 십 걸처럼 주변의 소녀 못 믿겠으면 전화 걸어 남자 친구에게 전화해 다라올 수 없는 수업 어딜 가든 뉴욕 파리 밀라노 도쿄 런던 한번 작정하면 여기저기 나이 몸이 지나가면 크나 답은 정해져 있어 넌 확인 아무렇게 그렇게 너도 나도 나더는 널 외롭게 하지 마는 앞에 세상에 이제 숨겨온 찾아봐 오늘 밤 소리 질러 즐겨 밤이 가잖았다 뛰어 흔들어날 보고 해 모도 미쳐미친 미미 이미 지금 내게 넌 내게 나만 믿고 늘 맡겨 나만 믿고 맡겨 아무것도 묻지 말고 나와 놀아 오늘만은 따라와 오늘만 날 척해날 해 모도 미쳐미친 미미 이미,3,1,-2,1,-1
626,당신을 보면 넌 못 감당해 날 나중에 훅을 벗었다 기분은 발가락을 같은 코크 스나의 전 이름은 지금 술을 마셨다네가 싫다 해도 당신은 불안합니까 소년 뭘 그리 찡그려 금발 바비 인형을 원하십니까 그것 여기에는 없습니다 인형이 아닙니다 미친 연이라 말해 뭐 나에게 손실입니다 사정 없이 까보라고 너나에게 잃어버린다 사랑 그깟 거 몸에 상처 하나도 어림없지 너의 썩은 향수나 뿌릴 바엔 톰보이음아요 말단은 말단입니다 음 것이 나의 태도입니다 될 것입니다 탁구를 연주하고 싶어요 오른쪽 춤을 좋아한다 친구를 사랑한다 가끔 우리는 담배 없이 맹세합니다를 바꾸십시오 도대체 미친 척이라 말해 뭐 나에게 손실입니다 사정 없이 씹으라고 너나에게 잃어버린 사랑 그깟 거 눈에 눈물 한 방울 어림없지 너의 하찮은 말에 미소나 지을 바엔 톰보이음아요 말단은 말단입니다 음 것이 나의 태도입니다 당신이 그것을 얻는가 될 것입니다 당신은 노래를 얻습니다 내가 의미하는 바를 얻으십시오 말괄량이 그것 남자도 남자도 남자 여자도 아닙니다 남자도 여자도 마찬가지입니다 마 그냥 그것 남자 여자도 아닙니다 마찬가지입니다 그냥 내가 사랑하는 말괄량이,3,1,-1,5,4
627,무엇을 원하는지 사는 대로 사네 무엇을 원하는지 가는 대로 사네 무엇을 원하는지 그냥 되는 대로 사네 사는 가는 그냥 되는 사는 가는 그냥 되는 사네니가 원하는 뭐 야니가 원하는 뭐 야니가 원하는 뭐 야니가 정말로 뭐야 원칙 가네 원칙 가네 인생의 전부를 걸어보고 싶은 그런 네가 원하던 전부를 걸어보고 싶은 그런 뭐야 나이를 처먹도록 그걸 몰라 나이를 처먹도록 그걸 몰라 나이를 처먹도록 그걸 몰라 이거 죽음 이거 끝장 진짜,3,1,0,3,3
628,신사 숙녀 그들은 우리를 부릅니 다부 석 순 갑시다 뭘 아는 놈들이 뭘 알려주려 해이가 뭔가 싶을 걸 근심 걱정 가득 찬 세상살이 걷어차 걷어차걷어차 차 차 차내 스타일로 날 따르다 거기 두 줄로 갈러 마음 다 알아 손을 뻗어서 여보세요 하기 힘든 건 내일 해 그냥 해 달라 해 하면 돼 호 한 번 사는 인생 멋지게 살자 응어리를 거니는 사람들 속에 너를 숨기지만 이제 해야 하는지 눈 똑바로 뜨고 우릴 지켜보면 돼한다면 하는 놈 그게 싫은 건 싫다고 말할 줄도 알아야지 맘대로 하고 싶은 건 거침없이 다 거침없이 걸어가지 거침없이 달려가지 날아가지 응하자 절은 빡세게 간다 백도 없이 직진 프라이드 양념치킨 고민고민하지 않지 우유부단하지 않지 호전국 각지에서 모인 놈들이 세상 흔드는 중임 호 우리의 재능을 기부 기부 기부 막힘없이 가다 굳이 설명 안 해도 뭐든지 맘대로 그래난 걸어가지 달려가지 거침없이날아가지 그것을 얻으십시오 거리를 거니는 사람들 속에 너를 숨기지만 이제 해야 하는지 눈 똑바로 뜨고 우릴 지켜보면 돼한다면 하는 놈 그게 싫은 싫다고 말할 줄도 알아야지 맘대로 하고 싶은 다 걸어가지 달려가지 날아가지 응고개를 들어봐 하늘은 파란데 맘을 내려놔 비워봐 세상을 크게 뭐 안 하고 하는 놈 그게 싫은 싫다고 말할 줄도 알아야지 싶은 날아가지 응거침없이거침없이거침없이거침없이,3,1,-1,0,-1
629,비는 오고 너는 가려 하고 마음 눅눅하게 잠기고 낡은 흑백영화 한 장면처럼 말은 끊기고 사랑한 만큼 힘들었다고 사랑하기에 날 보낸다고 말도 안 되는 이별 핑계에 나의 대답을 원하니 너만큼 사랑하지 않았었나 덜 사랑해서 널 못 보내 가슴이 너무 좁아 떠나간 너의 행복 빌어줄 그런 드라마 같은 그런 속 깊은 사랑 내겐 없으니 사랑하면 내게 머물러줘 사랑하면 이별은 없는 거야 너만큼 사랑하지 않았었나 덜 사랑해서 널 못 보내 가슴이 너무 좁아 떠나간 너의 행복 빌어줄 그런 드라마 같은 속 깊은 사랑 내겐 없으니 우리의 사랑 바닥 보일 때까지 우리의 메말라 갈라질 때까지 다 쓰고 남은 사랑처럼 쓸모없는 건 만들지 마요 손톱만큼의 작은 사랑도 내게 다 주고 가요 이별은 없는 거야,3,1,-2,-1,-3
630,빨리빨리 피해 오른쪽 체리 폭탄은 그것을 느낍니다 빨리빨리 피해 오른쪽 체리 폭탄은 그것을 느낍니다 빨리빨리 피해 오른쪽 체리 폭탄은 그것을 느낍니다 가장 큰 히트 단계에서 가장 큰 인기 가장 큰 히트 단계에서 인기 히트 단계에서 인기 타격시간이 됐지 마 타이다 대기실 앞은 바글거려 다들 눈 못 떼 따라와 공중에 손을 대고 이제 막 터질 거야 어디에나 나를 삼켜봐 그리곤 느낀 위꽤 오래 절여진 폭탄 터질지 몰라 머리처럼 머리를 터뜨립니다 킹스맨 소방관이 없습니다 이건 불꽃놀이 하늘의 높이 타격은 행복하고 당신이 행복하다면 비트에서 손을 박수 롭다는 것을 알고 있습니다 느낍니,3,1,1,4,5
631,길이 길인 아는 아니라 그냥 길이 그냥 거기 있으니까 가는 거야 원래부터 길이 있는 아니라 가다 보면 어찌어찌 되는 거 길인 아는 아니라 그냥 거기 있으니까 가는 거야 원래부터 있는 가다 보면 어찌어찌 되는 거야 내가 너로 살아 봤냐 아니잖아니가 나로 살아 봤냐 아니잖아 걔네가 너로 살아 봤냐 아니잖아아니면 네가 걔네로 아니잖아아니잖아 아니잖아 아니잖아 갈 길 가이 사람 사람 이러쿵저러쿵 뭐라 뭐라 뭐라 해도 상관 말고 갈 길 가미주알 고주알 친절히 설명을 조곤조곤조곤조곤조곤조곤해도 못 알아들으면 이렇게 말해버려 그건 생각이고 그건 생각이고 그건 생각이고 뭔 말인지 알겠지마는 생각이 보니 생각이 보니 길인지 길인지 길이기는 길인지 지름길인지 돌아 돌아 돌아 돌아가는 길인지는 나도 몰라 몰라 몰라 너도 결국에는 그대의 머리 위로 뛰어다니는 것처럼 보이는 사람도 너처럼 아무것도 갈 길 가이 사람 이러쿵저러쿵 해도 상관 말고 가미주알 고주알 친절히 설명을 조곤조곤조곤조곤조곤조곤해도 못 알아들으면 이렇게 말해버려 뭔 말인지 알겠지마는 생각이 보니 그거는 어디까지나 뭔 말인지 알겠지마는,3,1,0,-2,-2
632,물러서야 합니다의 델 어델 감히 누구라고 날 젖혀 이쯤에서 물러나고 입 닫는 좋을 걸 아님 한번 기어 올라와 보던가 널 짝사랑을 했었니 소꿉장난처럼 어릴 엔간히 끼를 끼를 끼를 좀네가 부렸겠니 소싯적 추억 팔이 그리 재밌니 남잔 지금 수준 따윈 꿈도 못 꿀 수준 날 가진 그런 레벨보다 시피 레벨 곤 나에게 가져오세요 꺼져줘 거에서 손 떼 뒤로 물러서서 뒤로 물러납니다 다시 태어나도 안될 걸 뒤로 물러서서 물러납니다 착한 남자들에게 너는 독배 같은 아실수록 외로워 매일 아프고 피곤합니다 넘지 말아 경계선 선형 네가 비빌 곳이 아니야 물러서서 물러납니다 저울질로 가린 건 참지 못할 가벼운 마음일 걸 매일 아프고 피곤합니다 그런다고 네게 되나 들어봐 상상보다 같은 애들이 많긴 많아그러거나 말거나 세상은 너를 빼고 돌아가 돌아가 당신은 당신이 재미를 찾고 있는 좋은 마음을 얻어야 합니다 재미를 찾니 호의로 다가와 이미 계산 끝나 공해상의 보물선을 보기라도 한 ,3,1,3,-2,1
633,거짓말 거짓말 거짓말 밤에 대체 연락해 아는 여자 동생들 많네 저리 가요 친구가 널 길에서 봤대 네가 내게 잔다고 한 가서 방 안에서 한참 울고 있는데 밤새 풀리지 않는 기분 거지 같아 어떡해 도저히 더는 참을 수 없는데 베이비 내가 아는 것을 안다네 이제 네가 숨 쉬는 것도 싫어 스치는 것조차 싫어 내가 알아요 널 생각할수록 나를 미치게 만드는 너의 더는 못 숨어 꼭꼭 숨어 다 찾아낼 걸 널 빨리 배우네 시원해 네가 다 지어낸 가짜 소설 무서워 과다 복용하는 사람 박수 보낼게 박수 박수 넌 남우주연상 타고 도 남을 연기했네 넌 흡연자 모두가 피해 지나치게 벌받아야지 넌 싸짐 싹 다 챙겨 나가 별 볼 없으니까 베이비 내가 아는 것을 안다네 이제 숨 쉬는 것도 싫어스치는 것조차 싫어 알아요 생각할수록 나를 미치게 만드는 너의 죽을 때까지 이렇게 살다가 지옥 가길 기도해 지옥으로 가십시오 그대여 너는 태어나질 말았어야 어떡해 미치도록 꼴도 보기 싫은데 베이비 것을 안다네 이제 숨 쉬는 것도 싫어스치는 것조차 알아요 생각할수록 나를 미치게 만드는 너의,3,1,-12,-6,-18
634,불타오르네 방에서 일어나난 뭣도 없지 해가 지고 비틀대며 걷지다 만신창이로 취했어 취했어 막 욕해 길에서 길에서나 맛이 갔지 미친놈 같지다 엉망진창 마음에 들었어삐이니 멋대로 살아 어차피 꺼야 애쓰지 말아져도 괜찮아 손을 들어 소리 질러 이거 불태워 버려 불타오르네 싹 다 불태워라 보우 와우 와우 싹 다 불태워라 다 태울 새벽이 갈 때까지 그냥 살아도 돼 우린 젊기에 말하는 넌 뭔 수저길래 수저 수저 거려 사람인데 뭐니 멋대로 살아 어차피 꺼야 애쓰지 말아져도 괜찮아 손을 들어 소리 질러 이거 불태워 버려 불타오르네 싹 불태워라 보우 와우 겁 많은 자여 여기로 불 괴로운 자여 여기로 불 맨주먹을 들고 밤새도록 진군하는 발걸음으로 불 뛰어봐 미쳐버려 뜨거운 뜨거운 뜨거운 활 활 파이어 화력 활 파이어 화력 보우 용서해줄게,3,1,-5,3,-2
635,다 알아봐 티브이쇼 챔피언 랩 스타 셀럽이자 패시야 핸드폰은 종일 울려 필요해 무음 부재 전화에 일일이 답하기 피곤한 몸 그런 내게 전화해 어딜 가라마라고 뭘 계속 달라고 외면하면 행운 운운하겠지만 당신이 필요하다고 생각하는 것이 필요하지 않습니다 넌 애매해 내게 뭘 바라기엔 눈엔 차지도 않잖아 없을 거야 기횐 앞에 말 많은 애 옆에 잘 생긴 애 차 키 올려놓는 애 갑자기 들러붙는 넌 말해 편집하겠습니다 그건 너나 먼저 해 태도부터 고치고 생각해보고 얘기 못 하겠네 번호 번호를 변경하겠습니다만 빼고 모든 숫자가 다 올랐어 수행원 잔고 부재중 전환 몰랐어 근데 이게 말이냐면 다시 전화하십시오는 없을 거라고 보채지 말라고 후회에 취해 전활 걸어오는 전 남자 친구 아무리 쥐어짜도 기억 안 사람 팬 서비스를 인맥인 척 에다 올려 과시하는 괜히 엮이려는 무심결에 받아놓고 아차 싶어 사람인 척 기억 안 척해봐도 내게 굳이 지난 일을 사과하지 당신이 가되고 싶다고 생각합니다 또다시 넌 말해 편집하겠습니다 그건 너나 먼저 해니 태도부터 고치고 생각해보고 얘기 못 하겠네 당신의 멍청한 태도 번호를 바꿀 게나도 받고 싶은데 그게 진심이라면 근데 번호는 쟤한테 거야 진심을 오해할까 마음 졸이는 애자기 할 하며 내겐 관심 없는 애인보다 생각이 살아있는 못 노는 말을 제대로 이해하고 고개 끄덕이는 애내 번호를 줄게 말해 당신을 편집하지 않을 것입니다 맘에 들어 그런 태도 내가 봤을 그건 완벽해 바꾸려 하지 마 당신의 바보 같은 태도 당신에게 줄게,3,1,-1,-1,-2
636,반쯤 미쳐가는 다 망가져 나의 삶넌 내게서 나를 지워가고 나를 부숴버려라 추락한 나를 눈앞에서 멀어지는 너의 속도는 로너의 속도는 로너의 속도는 눈앞에서 점이 되어버려부질없는 것이 되어버렸어 대체 누가 쉽다고 말을 해내 기억 영혼까지 가져가죠 숨이 턱 끝까지 몰고 가네 사라지는 보는 기분이란 건 어때사라지는 너의 속도 어림잡아 킬로 정도 돼 보여뒤돌지 말고 가지 지금 사이코야 이럴수록 네가 필요하면 넌 다 알잖아 숨을 참는 죽어가는 난난 너를 지켜줄게 지나갈 조금씩 멀어지는 상태도 눈을 감고 뜨면 사라질 같아 수많은 기억들을 돌고 돌아 너는 다시 우릴 마주칠 수 있나 반쯤 미쳐가는 다 망가져 나의 삶넌 내게서 지워가고 부숴버려라 추락한 눈앞에서 멀어지는 너의 로너의 잘못된 길에 빠진 듯이 괜히 왔어 제자리로다 알면서 다시 어제의 너는 네가 아닌 듯이 분홍빛의 환상인 듯이 원래 이게 나였었지 변하는 건 없어 별다를 없고 못 꺼낸 말은 많아도 지나쳐 버린 후고 우리는 뭐 옆자리에서 반대 자리 종점으로 가장 너와 가까울 마지막일 걸 지금이 네가 지나간 길을 그냥 멍히 보고 있을 수밖에 죽여 찬 공간 날쟤넨 아픔도 남의 거라 하니까 입을 꾹 닫네 앞에 원하는 건 없어 사랑은 없고 다친 나의 마음에 비해 너무 빠른 발걸음 원하는 없어 사랑은 없고 다친 마음에 비해 너무 빠른 발걸음 반쯤 미쳐가는 망가져 삶넌 내게서 지워가고 부숴버려라 추락한 노,3,1,-2,-2,-4
637,무궁화 꽃이 피었습니다 빼고 다 멈춰지담 꽃이 피었습니다 현아 빼고 다 비켜 도망가 너나 기어서 도망가 싫은데 도망가 너나 기어서 싫어 싫어 얼음 얼음 얼음 땡 땡 땡 처음 몰래 들어간 클럽 넌 자유를 가지고 싶어 두리번거리다 느낀 구석 뜨거운 느낌 언니 나처럼 따분한 눈빛 지금 우린 머리부터 발끝까지 빨개요 심심해 재미있는 만드는 어때요 쫄 보가 아냐 없어 핑계 핑계 걸리면 언니가 미인계 미인계 어린 나이에 내가 가진 많아어째 요즘 들어내가 가진 이제 많았으면 해서 실 많았으면 해내가 원래 욕심이 많아 여기서 이제 훔쳐보려 해저기 날 계속 훔쳐보는 애도 망가 너나 기어서 싫은데 싫어 여기요 거기 랩 스타 내가 보여 줄게 진짜 별 절대 비슷한 건 못 참아 그냥 앞서는 스타일 수군대는 쟤들 매일 쓰린 속 달래는 루저들의 남 헐뜯기 매가 약이다마는 사이즈가 가슴 어쩌겠어 넓은 아량으로 용서하는 삶의 작은 기쁨 아무것도 몰라요 거짓말 치면 혼나요 이리 나를 안 잡아서 안달이 났나 높은 곳에 있는 날 잡나 뭐 내게 귀여운 넌 바보 같은 오늘 밤 거리의 시인 가치는 빌론 올라 매일 인정해나도 내가 너무 잘난 걸 싫은데 너네 손가락질 이기적인 두 명 남자들은 불러오 주여 운명은 분명 편이야 아무리 기고 오를래도 쩌리야 무궁화 꽃이 피었습니다 빼고 다 멈춰지담 현아 비켜,3,1,-4,2,-2
638,아예 아예 아예 이렇게 감을 못 잡는 거야 말을 하는지 모르겠어 뭐야 싱긋싱긋 웃으며 치근 치근대날 그렇고 그런 애 취급해 남자는 그렇게 하지 않습니다 답할 맘 없어 그런 질문에 절대 안 돼 오늘만 번을 물어본 거야 아기 정지 대체 뭐라 뭐라 하는데 당최 못 알아듣겠어 도번번히 좌절되는 시도 정신 차리고 보는 너만 빼고 모두가 보이는 신호 오늘 내일 하지 말고 서둘러서 다가와 어서 다가와 어서 뻔해 이대론 불편해 그런 것만 물어보지 마 원하는 대로 해 그게 편해요 시간이 가버리기 전에 말 더듬는 거야 말을 하는지 모르겠어 뭐야 순진한 척 말을 더듬더듬 새어 나오는 나쁜 버릇 버릇 머리 어깨 무릎 발 무릎 발에 상이 가능하지 백 프로 다 뭐 이렇게 질문이 많은 네가 어린애야 뭐야 대체 네가 아는 뭐 야당 최 아는 없어 필요함이 절실한 개인 지도 정도 해도 못 알아듣어 혼 나야 돼 나와 뒤로 오늘 내일 하지 말고 서둘러서 다가와서 다가와서 식은 뻔해 이대론 불편해 것만 물어보지 마 원하는 대로 해나는 그게 편해요 시간이 가버리기 전에 직까지도 나에겐 얘기하지 못한 말들 아쉬워지기 전에 얘기 해 지치기 넌 옆으로 와이런 뻔해 이대론 불편해 거만 물어보지 마연하는 대로 해 그게 편해요 시간이 가버리기,3,1,-3,5,2
639,나쁜 계집애 나난 나쁜 계집애 나쁜 계집애 모든 여자가 있는 고난 나난 모든 여자가 있는 곳 쎄 아주 사납게 오너 정도론 날 절대 감당 못해 어질 투 따윈 눈곱만큼도 모르죠 점쟁이도 맘속은 못 맞추죠 여왕벌 주인공 어디로 튈지 몰라 럭비공 목에 걸린 골드 체인 스윙 린 왼쪽 오른쪽 외롭지 않아 매일 밤마다 권리 취득 당당한 지조 고귀한 품위 허는 웃음은 기본 눈물은 무기 맞아 미소는 불너 애태우니까 화상이 와서 지금 얻으십시오싫으면 시집가 나난 모든 여자가 있는 고난 곳은 니야 언니 언니 언니 여기요 언니야 여기요 남자들은 허니라 불러요 여자들은 언니라 불러요 팍팍 잘 나가는 싸늘한 라운드 라운드 돌고 도는 이상한 멜로디 응대가 제일 잘,3,1,-2,-1,-3
640,궁금해서 잠이 안 그랬어 구차해도 묻고 싶어 뭐였어나 나나나만 애탄 거니나 진심인데 넌 그랬구나 그랬어좋았는데 넌 아니었나 봐그랬구나 넌 그런 모르고 이럴 거면 바래다주었던 그날 밤 논 나를 안아주지 말았어야지 설렘에 밤잠 설치게 했던 말 말도 말았어야지 그러지는 말지 비겁하게 숨어버린 너를 돌아올 거라고 믿은 내가 바보야 사랑스럽게 날 보던 눈빛에 빠졌던 내가 바보지 이럴 줄도 모르고 이렇게 돼 버린 그냥 얘기할게 이미 떠나버린 맘 돌릴 순 없으니 그랬구나 그랬어좋았는데 아니었나 봐그랬구나 생각뿐인데 이럴 거면 바래다주었던 그날 밤 논 나를 안아주지 말았어야지 설렘에 밤잠 설치게 했던 말 말도 줄은 몰랐어어때 하고 싶니 지금 순간의 감정일지 중간에 금방 에러가 날 것인지 아니에요 알고 있습니다 생각엔 오래가진 못할 거 같아 아닌 관계는 이어지지 못해 잠 못 들어 아픈 새벽 잘 지내니 문자 한 번쯤은 해주지 혹시나 하며 올린 얘기에 좋아요 누르지 말지 괜히 기대하게 바래다주던 그날 밤처럼 돌아와서 포근하게 나를 안아줘 설렘에 밤잠 설치게 했던 말로 두근거리게 해줘 다시 날 녹여줘이럴 거면 귀엽다고 하지 말지 그러지 혼잣말만 늘어가네 전하지도 못할 말만,3,1,3,-1,2
641,당신은 나에게 인생의 가장 좋은 부분을 주었다 당신은 나를 너무 살아 있다고 느끼게 합니다 우린 서로 곳을 또다시 만나 별의 길을 우리는 괜찮아 걱정 마 넌 어딜 가든 빛날 태양 너와 우리는 괜찮아 걱정 마 넌 어딜 가든 빛날 태양 너와 당신은 나에게 인생의 가장 좋은 부분을 주었다 나를 너무 살아 있다고 느끼게 합니다 서로 곳 서로 사람 옆에 있더라도 나를 잊진 말아 밤에 빠진 채로 날 못 구해 토해 같은 느낌 은 나처럼 바다 느낌 익사 사실 네가 필요한데 그런 말 못 토해 아침이 오고 있어 다시 숨어 나에게 인생의 가장 좋은 부분을 주었다 너무 살아 있다고 느끼게 합니다 우린 곳을 또다시 만나 별의 길을 우리가 그것을 잃을 수 생각하지 않았다 당신이 문을 닫았다 빛이 나던 너의 두 눈엔 어둠만 흘렀어 당신이 나의 인생에 들어왔을 어느새 변해갔고 전에 검게 물들여놓은 때를 씻어놨어 추억들을 팔아 벌어댄 돈도 지나버린 시간은 못 돌려 시간은 사라졌습니다 홀로 수만 가지 말을 떠올려 입을 열 때마다 너한테 줬네 상처 마음을 수면제랑 다시 깊이 삼켜 남은 중 하나만이 사람을 찾는 것입니다 변해가고 떠나 변한 상황일수록 그리워 기억 안의 변해가고 떠나 변한 상황일수록 그리워 기억 변해가고 떠났지만 우린 곳을 또다시 만나 별의 길을,3,1,-3,0,-3
642,반쪽 같은 소리 하지 막내 반쪽 이제 거야 나쁜 연이라고 하지 말 나쁜 건 너의 그녀야 은 영원히 지속됩니다 버릇처럼 뱉던 말처럼 보기 좋게 끝났잖니 친구치곤 예쁜 여사 치은 개뿔 걔한테 지금 너를 뺏긴 거니 눈물 뚝 떨어져 롤링이 두 글자를 지워야겠지 너무 미워도 그것을 놓아야 한다도 번 다신 널 보고 싶지 않아 반쪽 같은 소리 하지 막내 이제 거야 나쁜 연이라고 말 건 너의 그녀야 사탕 발린 말투 달콤했던 만큼 아프니까 제발 두목 그래아프니까 청춘 파란만큼 젊음 거울 속에 아직도 예쁜 그래요 찢었어 너의 사진 지웠어 번호 빛이 바다에서 많은 물고기를 솔로 하지만에 대한 알고 있는처럼 수영합니다를 놓치고 와를 키스하면 당신을 위한 너무 미워도 그것을 놓아야 한다도 번 다신 널 보고 싶지 않아 같은 소리 막내 이제 거야 연이라고 말 건 그녀야 반쪽을 줬던 내가 안타까워 충분했다 다시 줘도 원하지도 않았으니까 반의반의 반반 쪽,3,1,1,-4,-3
643,반말 마 반말 마 반말 마 마야 네가 지금 뭣 땜에 나한테 반말이야 마야 아무래도 이건 미쳐 마야 네가 지금 뭣 땜에 나한테 반말이야 아무래도 이건 미쳐 반말하지 반말하지 마만 말하지 위를 몰라 반말하지 마만 말하지 위를 몰라 네가 지금 뭣 땜에 나한테 반말이야 아무래도 이건 미쳐 반,3,1,0,-1,-1
644,허튼 말들 세포를 가리지 않는 거친 말들 상대를 가리지 않는 쉴 틈 없이 밤낮으로 짖어대는 근면한 습성 냄새나는 곳에는 언제라도 나타나서 본능적인 감으로 정신없이 달려들어 쉭 물어 쉭 물어 쉭 물어 왕왕 왕 마구 왕왕 왕 헤픈 말들 실현될 가망은 없는 멋진 귓가에 맴돌지 않는 구역은 언제라도 지키려는 늠름한 습성 냄새는 곳에는 언제라도 나타나서 익숙해서 감으로 정신없이 들려 들어 쉭물어 왕왕 왕 쉭물어 마구 어디부터 진실이고 어디까지 거짓인지 구분조차 못하지만 뭐라 해도 괜찮아 눈을 떠도 감은 채 뚫린 귀를 막은 채 입만 남은 채 정신없이 크 달려들어 마구 뜬 눈을 감아뚫린 귀를 막아 모든 생각을 멈춰,3,1,0,-8,-8
645,일하는 사람 일을 하면 돈을 주니까 맨날 일하기 싫다 말하면서 일하러 간다 왜냐 월세 세금 땜에 밥값 의무적인 관계가 내게 책임을 물어 그분은 말 한마디를 꺼내는 곱지가 않아 그게 말이든 나에게는 마음이 아파 별거 아닌 일에도 민감하게 욕을 하니까 상처투성인 맘속엔 주문을 외워 죽어버려라 죽어버려라 죽어버려라 내게 돈을 주는 그대에게 주문을 외워라 내게 화를 내는 그대에게 저주를 걸어라 표정이 굳어 이유가 없어 어이가 없어 욕을 먹는 내겐 업무의 옵션인가 그럴 때마다 속이 쓰려와 가슴이 아파 그분 이름을 부르면 겁부터 나지 조금만 더해 놀아 뭐 해 웃는 모습으로 거짓 표정 미소 짓고 한 귀로 흘려 사업하면 원래 민감하게 구는 거야 두 눈 맑게 표정 밝게 주문을 외워 표정을 밝게 외워 두 눈을 맑게 돈을 주는 그대에게 외워라 화를 내는 저주를 걸어라 주는 외워라 화를 내는 저주를 걸어라 일하는 사람 일을 하면 주니까 맨날 일하기 싫다 말하면서 일하러 간다,3,1,-7,5,-2
646,타닥 타오르는 불씨 기름에 닿기 전에 먼저 집어삼키네 필시 휩쓸려가겠지 은 오늘의 선수 입장하시네 건수를 응물기 시작하면 둥둥둥 동네북이 돼 둥둥둥 툭툭 건드네 괜스레 툭툭 반응이 없음 그냥 담가버리지 푹푹 응진 실도 거짓이 돼 거짓도 진실이 돼 이곳에선 모두가 도덕적 사고와 판단이 완벽한 사람이 웃기 시네 분노 필요하지 타오를 땐 이유가 있어 어쩌면 우리의 역사니 그게 세상을 바꾸기도 하지 이건 분노 아닌 분뇨 뭐가 분노인지 알잖아 분노인 척하며 죽여 진짜 분노 질려버린 수도 없이 많은 사람들 넌 나만 죽이는 아니야 똥 밟는 익숙해 다 무감각해진 사람들 분뇨 무관심 너넨 팀이야 뭐라고 욱해 욱해나는 욱해 욱해나는 악의에 가득 찬 분노에 분노해나는 악의에 가득 찬 분노에 분노해나는 욱해 욱해나는 꺼져야만 했던 분노에 분노해나는 꺼져야만 했던 분노해그래 욱 욱 욱해라 욱대가 될 때까지 욱해라 욱 욱해라 욱부러질 때까지,3,1,-1,-5,-6
647,영원한 건 절대 없어 결국에 넌 변했지 이유도 없어 진심이 없어 사랑 같은 소리 따윈 집어 쳐 오늘 밤은 삐딱하게 내버려 둬 어차피 혼자였지 다 의미 사탕 발린 위로 따윈 집어 쳐 오늘 밤은 삐딱하게 버럭버럭 소리쳐 현기증 심심풀이 화풀이 상대는 연인들 괜히 시비 걸어 동네 양아치처럼 가끔 삐딱하게 다리를 일부러 절언이 세상이란 영화 속 주인공은 너와 나갈 곳을 잃고 헤매는 외로운 섬 텅텅 빈 길거리를 가득 채운 기러기들 맘과 달리 날씨는 더럽게도 믿고 마냥 행복했었던 내가 우습게 남겨졌어 새끼손가락 걸고 맹세했었던 네가 결국엔 영원한 건 절대 결국에 넌 변했지 이유도 진심이 사랑 같은 소리 따윈 집어 쳐 오늘 밤은 내버려 둬 어차피 혼자였지 다 의미 사탕 발린 위로 짙은 아이라인 긋고 스프레이 한 통 다 쓰고 가죽바지 가죽 재킷 걸치고 인상 쓰고 아픔을 숨긴 채 앞으로 비뚤어질래 네가 미안해지게 하늘에다 침을 칵 투박해진 말투와 거칠어진 눈빛이 무서워 실은 있지 두려워져 돌아가고픈데 갈 데 없고 사랑하고픈데 상대 없고 뭘 어쩌라고 돌이 킬 수 없더라고 믿고 마냥 행복했었던 내가 우습게 남겨졌어 새끼손가락 걸고 맹세했었던 네가 결국엔 영원한 건 절대 결국에 넌 변했지 이유도 진심이 사랑 같은 소리 내버려 둬 어차피 혼자였지 의미 사탕 발린 위로 나를 위해 아무 말 말아 줄래요 혼자인 이렇게 힘들 몰랐는데 그대가 보고 싶어 밤만 나를 위해 친구가 되어줄래요 좋은 날 아름다운 날 그리운 날,3,1,-5,-3,-8
648,살기 싫어 문제도 있고 술에 취해도 내일만 되면 힘들어 나도 느낌 알지 나도 느낌 알지 엄마가 보고 싶고 아빠는 미워 전 남자친구 남잘 못 믿어 나도 느낌 알지그래 스윙 알지 경상도가 들리네 대구서 올라왔니 거기서 온 친구들을 나름 만났지 너는 살아 역삼역같이 일하는 언니들이 방을 잡았어 그래봤지 얹혀산 집이 제일 편해 그치 편하고 밥은 네가 줘 술은 내가 낼게 숙취음료 한 병씩 하자 꼭 필요한 에어백 여기서 일해 그냥 음악 너도 하고 싶은 거 해 표정이 죽냐 쉬운 건 없지 실패도 두렵고 가끔 숨고 싶을 때가 깊은 구멍 속 차가 되게 좋네 일종 땄나 골목이야 춥다 들어가자 근데 술 먹는 대신에 대리로 만족하자 뭘로 먹을래 내일 쉬니 맘껏 마샤 살기 싫어 문제도 있고 술에 취해도 내일만 되면 힘들어 베이비 부축해줄게 괜찮니 베이비 온 엄마,3,1,-2,2,0
649,이리 시끄러운 것이냐 이리 시끄러운 것일까 이리 시끄러운 것이냐 것인가 것이냐 것일까 것인가 앞뒤 안 보이냐 존 시나 까라고 거기나 이게 마지막 자비야 그냥 걸쭉한 죽어야 누나야 지금이 시야 한 번 하는 것이야 래퍼들 거지야 오빠만 거지야 군대를 빼려니 머리 크지만 아니야 갔다 왔으니깐 까라면 까라면 까임 마 한국 힙합의 싸이 넌 파밍 하다 뜬 사이가 약을 빨아야 합니까 정신을 차려 자식아 힙합 겉멋이야 찐따 보다는 일진이야 끝나면 가지 마사지 방 오해 마 건전 마사지 싸지마 싸지마 싸지마 아가리로 똥 넌 호선 같은이야 그러고 보니 인천역이야 여긴 많다면 양아치가 걔네 만날 건 동현이야 말고 김 동 현이야 아주 현실적 사고야 랩 오져도 면상 사고야 뭔 만함 가사에 반지하 용쓴다 힘내라 자식아 세상 어려운 건 정치야 네가 제일 잘하고 있는데도 담배 한 대 피우고 보니깐 충청도 가끔은 그리워요 근데 우물 안 개구리가 된 친구를 보고 있으니깐 어쩌면 욕심인가 쟤 공무원 떨어지잖아 것일까 것인가,3,1,-2,-3,-5
650,내가 마음을 채우는 아이디어로 마음을 채워 주었다 그녀가 마음에 들지 않으려면 룸메라에 그녀를 데려갔다를 원한다는 것은 사이드에 권총을 죽이고 싶다는 마음을 채우고 아이디어로 채우고 룸메이트의 석판에서 가장 높았다 전원에서 돌아오지 않아의 삶이 너무 많은 갱단의 삶이 너무 많아서 볼 수 없다는 돌아오지 않았습니다의 저를 강하게 튼튼하다 룸메 이프에서 가장 높음이 가장 높습니다 내가 여기에서 나가게 하는 높은 것입니다 높은 곳에서 분위기가 무엇인지,3,1,0,0,0
651,넌 나를 넌 나를 넌 나를 왜왜 날 떠나갔니 왜왜 날 떠나갔니 한참을 걷다가 삼청동 끝자락쯤 왔을 언제나 만나던 길에서 내게 헤어지자 했어 울먹 거리며 돌아선 너무해 가증스러워 뒤통수를 후려맞은 허무해 갑작스러워 긴 길을 가라고 역 앞에 서라도 걸으면 서라도 커피 마실 때라도 말했어도 됐잖아 미안하단 말 밖에 하지 않는 네게 화가 사람 있다고 내가 싫다고 변명이라도 해 떠나니 떠나니 날 두고서 너는 떠나니 네가 다시 돌아올까 거짓말일까 한 걸음도 못 가잖아넌 따윈 해놓고 혼자서 울면서 걸어가 눈물 콧물 범벅된 쳐다보는 시선들 부끄러워 부끄러운 것보다 너와의 이별이 슬픈 현실이 싫어 없는 내일은 어떡하지 뭘 하지 혼자서 물어 뭘 할까 친구를 만날까 영화를 볼까아무렇지 않은 척출 금은 할 수 있을까 지금이라도 너한테 전화할까 매달릴까 됐어 그냥 술이나 마실까 두고서 너는 네가 다시 돌아올까 모두거짓말일까 한 걸음도 못 가잖아 눈물이 멈추질 않아서 그렇게 떠나가는 널 붙잡을 수가 없잖아 떠나지 마 떠나지 마 두고서 너는 떠나지 마누 구보다 네가 잘 알잖아 너만을 사랑했던 너도 가슴 아플 거야 힘들 거야 말하는 나더러 사람들이 내게 말해 돈 거야 정신 차려취한 체 사는 편해 도망치고 싶었던 마음 체한 것처럼 답답해추하게 널 잡던 모습이 모든 다 꿈이야 현실이 아니야 내가 생각했던 미래는 아니야 무정히 떠나며 남긴 일방적 이별 통보 인정 못해그렇게 아무리 부정해도 흐르는 눈물이 긍정해넌 왜왜 떠나갔니,3,1,-11,1,-10
652,천장을 가득 매운 담배연기가 사라질 때까지 아무 말도 할 수 없었지 창백한 얼굴 너의 눈과 눈 사이를 천천히 오고 가다 값싸 보이는 화분을 골라서 창밖으로 집어던졌지 너와 이렇게 불편한 시간을 보내야 아마도 너의 세 마디 혀끝엔 작은 악마가 춤추고 사실을 알아버렸을 때쯤 여기에 없어 나의 직관은 한 번 나의 기대를 배신하고 말았어 너와 이렇게 불편한 시간을 보내야,3,1,-2,1,-1
653,결코 팔지 않습니다 내려 입은 기술이 맞습니다 드리 피 골라놨었지 현금 벌면 너부터 매입하기로 나는에서 새로운 옷장에 기술만 들어 분신 결코 팔지 않습니다 내려 입은 기술이 맞습니다 드리 피 골라놨었지 현금 벌면 너부터 매입하기로 나는에서 새로운 옷장에 기술만 들어 분신 같은 느낌 한국인이냐고 물어 말도 이해가 가지 없었잖아 같은 놈도 기술에 대한 기술에 대한 기술 손 대지 마 건 데네 범퍼 작동 안 하니 불안해 보여 지릴 거 같지네가 너랑 발맞추지 손 떼라 거짓말하고 평화 외치는 넌 나처럼 예전을 얻으십시오 문을 개방이 로고 없으면 빼라 블루 그것을 좋아한다 비교만 싸구려 재킷의 링 위에선 없어 자비 결코 팔지 않습니다 내려 입은 기술이 맞습니다 드리 피 골라놨었지 현금 벌면 너부터 매입하기로 나는에서 새로운 옷장에 기술만 들어 분신,3,1,-3,-4,-7
654,너무 트랙에 카트 너무 예쁘고 그는 그것을 좋아한다 그는 그가 키티 고양이 안에서 그것을 위로 이길 키티 키티 고양이 고양이를 잃어버린 이처럼 초점 이제 그가 원인에서 영화배우를 만들려고 합니다 통계 그가 다시 말할 그것을 좋아하지 않는다는 것을 알고 좋아해요 나를 닫을 보지를 흉내 냅니다 위로 계속 가라 티티 퍼러는 키티를 만듭니다 고양이를 자극하게 만드십시오 메도 같은 메타 여자는 메타와 같은 메타 여자가 아니었어 아내 콜드 브리 킹의 라운드 라운드 최고의 고양이를 얻어 너와의 스트랩 당신은 텍스트에서 좋은 그립 캣 이모티콘을 얻을 수 있습니다 계속해서 소녀 소녀 퍼러는 키티를 만듭니다 그는 키티를 너무 예쁘게 만들고 화성을 좋아하고 예쁘고 예쁘고 현기증을 좋아하고 퍼러를 좋아하는 것을 좋아합니다 자극하게 만드십시오,3,1,6,-2,4
655,내가 당신이 내가 결정하는지 결정하는 것을 두려워하는 사람은 당신이를 알고 있다면 슬프다면 슬프다는 것을 안다 보내려고 슬프다는 걸 알아요 당신이 주변에 있을 사랑에 빠질 고문이 되어야 한다 당신이 떠날 내가 싫어할 떠나는 것을 두려워할 영원한 결정하는지 결정하는지 결정한다면 이를 알려주십시오 미 슬플 결정하는 것이 두려워어떤 사람은 결정하는 두려워합니다 것이 두려워,3,1,-3,-1,-4
656,당신의 흰색 결혼식에 모든 분홍색을 입을 것이다 어리석은 똥을 인정하기 위해 내가 위선자라는 것을 인정해야 합니다 그것의 측면에 있는 것보다 좋아하는 것을 좋아합니다를 사랑하는 은 그들이라고 부르는 것을 듣고 기다리지 않고 모든 이야기를 구성하는 모든 이야기를 만들어 내지 않을 것입니다 내가 바보 같은 똥 고타를 하고 싶은 것은 내가 위선자라는 인정한다 은 싸움에 합류하는 것입니다 생명의 은 멍청한 똥개를 하고 싶은 싸움의 싸움에 합류하는 스켈레 톤 주식입니다는 위선자라는 인정합니다,3,1,2,-6,-4
657,뭔가 심오한 결국엔 명함으로 재활용될 표정으로 눈만 가리면 누구나 정의인 듯칼과 저울을 말하는 당신들을 향해 이제 차례입니다 너의 안전하다 못해 불쾌한 의자를 위해 이제 차례입니다 모두가 너의 헛소리를 믿고 있진 않아 당신의 얼굴을 부수는 너의 두 눈에 당신의 얼굴을 부수는 삐뚤어진 입술에 아직도 자신만이 진짜라고 믿는 자존심을 향해 뭔가 특별한 고상해야 스스로를 달래주고 소위 말하는 소위들은 깨달음에 도달한 잘난 혀를 받들기를 원해 이제 차례입니다 심오하고 절대적인 쓰레기를 위해 모두가 상냥하게 끄덕이진 않아 당신의 얼굴을 부수는 두 눈에 삐뚤어진 입술에 아직도 자신만이 진짜라고 믿는 자존심을 향해 두 눈에 썩어버린 귓속에 아직도 뱉는 대로 다 진리가 된다 믿는 너를 향해알지도 못하고 알려 하지도 않은 채 너는 철창 안에 자신을 숨기고 거짓인지 진짜인지 가려내는 것조차도 예리한 관심 없는 미소로 애써 지은 모래성을 부수면서 깔깔대는 모습을 순수하다 말하겠지만 구역질 모습에 눈과 코와 귀와 내장들과 머릿속이 녹아 버릴 것만 같아 삐뚤어진 입술에 자신만이 진짜라고 자존심을 썩어 버린 귓속에 뱉는 대로 다 진리가 된다 너를 매달려 얼굴,3,1,5,-5,0
658,자기야 어디가 떠나가지 마 번짼 지도 모르지만 마지막이야 한 번만 믿어 줘 죄를 씻어 줘 지난번의 걔처럼 제발 잊어 줘 무릎 꿇고 있어도 무릎 안고 빌어도 소용없어 일어서 제발 옆에 있어 미안해 진짜 성질낸 아니잖아 돌아가자 이건 낭비잖아 자기잖아 날 욕할까 시발 지훈 할복할까 아오 봤냐 이거 진짜 장기 자랑이건 장난 아냐 알아 근데 손을 당기잖아너그럽게 웃어 머리 쓰다듬어 줘이렇게 날 뿌리치고 가지 뒤돌고 너무 봐서 이제 예뻐 보이네 뒤통수 거 남자가 웃게 해 거래 말 씹고 들어가난 오늘 밤죽을 게나 버스 앞에 뛰어든다 지금 순간 너무 질투 지금 순간 너무 질투 지금 순간 질투 나장님이 된 같아 눈을 감다가 떠도 어둡거든 아무리 크게 방의 불 밝혀도 널 익사시킬 만큼 눈물을 흘리게 했어도 그럴 때마다 너를 구하려 애썼고 그와 구명조끼 입고 다니잖아 수영은 내가 가르쳤는데 이건 아니잖아 이제 롯데월드 가줄게 제발 다시 줄래 고소공포증도 극복했어 줄래 고갤 숙이고 있어 날 울리고 있어 넌 진짜 밉지만 쟨 그냥 죽이고 싶어 사진 비공개로 해라 뭘 쪼개 야넬 어머니 컴 잘 못 하시지만 보겠다 지난번에 나하고 전화 한 거나 알아네가 아직도 좋아한다고 한 거 알아 넌 돌아오게 돼 있어날 부정하지 막 결과는 잘 보여서 투명하니까,3,1,-7,2,-5
659,우리가 자주 걸었던 길거리에 마주치면 그냥 모른척해 줘요 우리가 자주 걸었던 길거리에 둘이 만나지 않게 교통을 정리해줘요 심하게 싸웠지 눈에 불을 켜고서 자동차 빵빵거리면서 빨리 가라고 늦고 싶은데 넌 멀리 있어 멀리 있어 먼 산에 있어 바다로 가려고 했었지 광어나 먹을라고 했었지 너무 엇갈려도 너무 엇갈렸어 우리의 교통 우리의 소통 우리의 고통 내비는 먹통 우리가 자주 걸었던 길거리에 마주치면 그냥 모른척해 줘요 둘이 만나지 않게 교통을 정리해줘요 이대로 가다간 다 죽어 너와 사이엔 보험 같은 것도 없잖아 사고 나도 안 보상해줘난 내리고 싶어 그냥 갓길에 대줘 퇴근 시간이 아닌데도 꽉 막혀서 앞뒤 상황을 보니 도저히 답 없어서 나올 같아 구토 옆자린데도 불통 거를 정지시키는 것이 좋지 않다고 느끼지 않는다 마주치면 모른척해 줘요 우리둘이 만나지 않게 교통을 정리해줘요,3,1,-7,-2,-9
660,지금 얼굴 어떠니 항상 숨이 막히고 답답해 다들 어쩌면 그렇게 평온한 얼굴을 할 수 있는지 세상의 무게가 나만 누르진 않을 텐데 머리가 무거워 웃을 수가 없는데 다가와 가자 손을 내미는데 잡아줄 수 없어 거꾸로 서서 세상을 말을 해 모든 건 잘못됐어 세상도 날 둘러싼 사람들도 삐뚤어졌어 나만 내가 밟고 있는 땅인지 하늘인지 모르겠어 눈에 보이는 모든 진짜인지 어지러워 날 지키려 해가 다 지고 있는 엄마의 어깨 애써 눈 맞추며 다가온 그의 입술 분명 같은 곳에 있는데 우린 방향이 달라 안아줄 수 없어 거꾸로 서서 세상을 말을 해 모든 건 잘못됐어 세상도 날 둘러싼 사람들도 삐뚤어졌어 나만 미안해 아름다움에게 어둠을 밝히는 환한 빛에게 소중히 담은 깊은 두 눈에게 땜에 삐뚤어진 너의 상처에 넌 거꾸로 있는 나를 말을 해 힘들어 보인다고 세상과 널 둘러싼 사람들과 흘러가자고 방법을 알려줘 서서 세상을 다 잘못됐어 세상도 사람들도 삐뚤어졌어,3,1,2,-5,-3
661,계속해서 계속해서 그들을 폰에서 벨리 나이를 불러일으키지 않고 폰 샤넬 쾰른 안드에 부르지 않고 암캐들을 위해 옷을 입히기 위해 옷을 입는다는 내가 마음의 그의 하실 당신을 떨어뜨릴 당신을 내려놓을 그녀는 그녀가 크림에서 음료를 흘리기를 희망합니다 섹스를 첫날에 당신이 메시를 시작하기 위해 당신이 무엇을 시작하는지 알고 있습니다 주차 드롭 탑 그것을 모두를 알고 있습니다 숙녀들을 듣는다면 여자들에서는 팁을 갈아 주려고 필요합니다에 필요한 것을 주는 그들에 게에서 진주 세트 플루를 만들어 글처럼 만들어냅니다 인쇄 시판을 마실 수 있습니다 내가 사랑하는 세상을 사랑한다는 사람을 사랑한다면 숙녀들을 듣고 나가서에 대한 멍청이들을 듣고 외에서 우리를 위층에서 우리를 감동시키기 우리를 감동시키기 위해를 아는 것이 너무나도 이를 아는 것입니다 내가 끝나기 막힌 축복 받은 멍청이 거는 관과 과를 느끼면 이를 알고 있다면 이를 느끼면 있다면 느끼면 진동 여자에서 끔찍하다를 알면,3,1,2,-2,0
662,바닥에서 우리는 여기로 올라갑니다 전 잘해 근데 알약이 없습니다 지갑 부풀어 펌핑처럼 차이들을 어필 걔네 데려다 놔봐라 여기에 근데 한마디만 해도 역해 차이를 맞춰봐 짊어진 달라 나처럼 당신을 때렸다 때려잡는 배트맨 재미로 다 매일 해 차면 쪼끔 색맹 맘에 들고 안 들고 만 흑백색을 대입해오 남자 내가 대체 있냬뭐래 도리도리 죔죔 그런 소리 하면 내게 맴매 돈 안 되는 얘긴 내일 해 투덜대기나 해 애인같이에 대해 이야기하다 미래 선생님 가르치면 네가 배워야지 내가 당신에게 갈 수 있습니까 애인의 집 찌면 그녀 매일 밤 전에 듣는 재생 목록 안에 노래가 껴있잖아 이제 들이받아 나처럼 사이코 받은 만큼 배로 갚아 총은 없는데도 탄창은 많아다 갖다고 이제 전쟁 준비 칸 당신에게 간다 애인의 집 찌면 그녀 매일 밤 전에 듣는 재생 목록 안에 노래가 껴있네 하야하는 좋을 걸 각오 갖고 어서 판돈 미래를 그렸어 반 고흐 내건 팝에 건 퇴보도 손 두 발,3,1,3,-2,1
663,죽느냐 사느냐는 것도 중요한 문제지만 자신을 모른다는 것이 지금 현재 큰 문제다 뿌린 데로 거둔다는 걸 부메랑처럼 되돌아와 이제는 자신을 알라고 남을 평가하기 전에 자신을 알라 너보다 못한 사람 세상에 없어 알라 조금은 예의들을 지켜 알라 누군가 네가 던진 말 한마디에 울고 죽는다 죽느냐 사느냐는 것도 중요한 문제지만 모른다는 것이 지금 현재 큰 문제 널 아껴주는 사람 가슴이 거라 착각은 마이제는 머니가 세 살다가 아냐 사랑은 행복은 사는 아냐 사람의 눈물 밟지 마라 누군가 네가 던진 말 한마디에 울고 죽는다 알라고 남을 평가하기 전에 너보다 못한 사람 세상에 없어 조금은 예의들을 지켜 누군가 네가 던진 말 한마디에 울고 죽는다,3,1,0,1,1
664,세상의 모든 화려함을 얼굴에 달고 꼬리엔 모든 더러움을 몰래 감추고 언제나 웃음이 넘치는 텔레비 뒤엔 제도에 억눌린 당신들의 얼굴이 있고 방송국은 당신에게 웃음을 주고 대신 당신은 방송국에 자유를 팔고 티브이는 사랑을 싣고 당신은 쓰레기가 되고 당신은 저녁 뉴스를 보고 정치를 말하고 앵커맨은 대본을 보고 뉴스를 말하고 뉴스의 편집장은 대본을 미리 검사하고 정치가와 자본가는 그에게 지시를 내리고 당신이 알고 있는 건 뭔가 당신이 할 수 있는 건 뭔가 모든 방송국을 폭파시켜야 한 다모든 텔레비를 폭파시켜야 한 다모든 방송국을 폭파시켜야 한다 시끄러운 주둥이를 닥치게 하라 우리에게 아부하며 꼬리치며 온갖 쇼를 하며 우리의 돈과 힘과 피와 땀과 영혼을 빼앗고 늙어 걸 잃어갈 때쯤 방송국은 당신에게 칼날을 들이대겠지 당신이 알고 있는 건 뭔가 할 수 방송국을 한 다모든 텔레비를 한다 시끄러운 주둥이를닥치게 하라 텔레비를 한다 시끄러운 주둥이를 닥치게 하라,3,1,2,2,4
665,최악의 사람 오늘 아침에도 문장을 머금은 채 눈 떴지 지난밤엔 악몽을 꿨지 내가 날 무덤에 파묻었지 묻히면서도 시를 읊었지 볼펜은 처녀를 더럽히듯 노트에 씨 뿌리고 끄적거리다 눈에 띈 건 몇십 분이고 물어뜯어놔굼뜨거나 아예 눈도 못 뜨거나 예쁘거나 낯선 이에게 친절이 헤프거나 그따위 문장들은 볼펜이 잠 들은 낮 시간에 지워버려난 벌써 한참 부른 노래를 부정했지 세상으로부터 날 분리해 언어가 날 지배하는 곳이 나의 아틀리에 슬픔과 친한 기쁘진 않지 만 터널을 지난 뒤엔 욕 섞어 침 한 번 뱉어버려 곁에서 눈치만 보던 아내는 외로움에 울고 있었지 최악의 남자 최악의 남자 남자 사람 붐 맵은 이름을 얻고 스탠더드를 내줬지 노래를 얻고 악마와 계약을 맺었지 좋은 남자는 포기했어 그녀마저 행복 위에서 머무는 걸 포기했어 사람들이 보기에 썩 괜찮은 놈인 척 놈과는 놈인 척깨진 거울 속 망가진 내가 탈레스의 구덩이에 빠진 비웃네 아내는 언제까지인 줄도 모르고 기다려날 두면 안 돼 내가 되려 소리 질러 망친 건 난데 세상 모든 아버지들에게 물려받은 것만 조과 만족의 등가교환 가둔 덫괜시리 고난 속에 그녀를 엮어놨나 봐한 낱 달콤한 노래 땜에 내게 도난당한 그녀 행복도 다 노래로 갚고 만다며 지금 순간에도 사람,3,1,-8,0,-8
666,개소리지 다 개소리개소리지 다 개소리개소리지 다 개소리개소리지 개소리전부 개소리흔해빠진 멜로디 속사랑 노래 가사처럼 덫 없는 말허울뿐이지 뭐어차피 가지 특이 케이스를 뺀나머지는 가식일 뿐자신보다 타인을 위하는 이타심 뭐너가 뭐 날 알아 말 마라그저 귀를 닫고 눈을 감고입을 막고 파 말야다 개소리 차피 외톨이이해받지 못한단 걸 되새김질해질리도록 겪었잖아사탕발림 싹 개소리 개소리 쉿개소리지 쉿개소리지 쉿개소리지 쉿날 사랑한다며 곁을 지키겠다던 여잔지쳐서 떠나갔고친구라 생각한 자식은사실은 장기 짝이 필요했던 놈키워준다던 회사 못쓰게 만들다같이 가자던 팀들도 이름도기억이 안 날 정도로먼 사이가 된걸 알다 똑같지 말뿐뱉은 대로 되면 좋고 아님 말뿐그런데도 멍청한 놈가끔 의심한다 하면서도믿고 나선 한숨 쉬는 일을 반복하니딱히 할 말이 없지사람이 싫지만 아직 외롭지외톨이가 싫어 개소리란 걸 알면서도기대하는 병신개소리지 다관계에 지쳐닫아버려 수많은 가능성함께 빛날 거란 소린어느 얼간이가 뱉은 개소린지저것 아니요늘어만 가는 낭비사람이 늘수록 분산된 에너지뭐가 그리 서운한지날 멋대로 주무르려 하니선택지 따윈 없이 당신의 우정은 당신의 사랑을 당신의 의사 소통을 좋아합니다필요 없어내 시간은 항상 부족한데 우그들은 소중한 시간을 소비하고 싶어하기에 고맙지 만 사양 할게혼자가 편해 함께는 뻔해너 뻔뻔해 그래서난 거절해개소리지 개소리개소리 개소리개소리 개소리개소리 개소리지개소리 개소리전부다 싹,3,1,-1,-2,-3
667,산을 넘어 산 넘어강을 넘어 강 넘어산을 넘어 산맥 강을 바다다 넘어가 다음힘들지 않아 거친 정글 속에뛰어든 건 나니까 괜찮아 높은다음 도시 속에빌딩들 내려보며 하루 종일 비행하십시오워어오 워어오 워오 높은저 위로 갈래워어오 워어오 워오 높은더 높이 날래워어오 워어오 워오 높은저 위로 갈래워어오 높은더 높이 날래처음이라서 방법이 없어처음이라서 당돌해 봤어처음이란 무기가 됐어처음이라서 다 처음이라서 다독 덫 독버섯 한번 깔아 봐라결국에 살아남아 어떻게든 살아남아나는 알아 함정 깔아 봤자 세게 밟아 답은 뭐든 까고 보면 돼힘들지 않아 거친 정글 속에뛰어든 건 나니까 괜찮아 높은다음 도시 속에빌딩들 내려보며 하루 종일 비행하십시오워어오 높은저 위로 갈래워어오 높은더 높이 날래워어오 날래힘들지 않아 거친 정글 속에뛰어든 건 나니까 괜찮아 높은다음 도시 속에빌딩들 내려보며 하루 종일 비행하십시오많은 가시덩굴 다친 곳을 잡고잠시 쉴 없네난 참고 계속해서내 앞을 바라보며 뛰면 돼실행미로 짐승처럼다 비슷한 길은 다 피해가미숙하지만 새로운 도전 꿈을 막는 것들은 먹어 치워난 달려 꿈을 향하는 모험힘들지 비행하십시오힘들지 비행하십시오워어오 날래워어오 날래,3,1,-4,1,-3
668,강남대로 앞 신호대기 중인 차 창문 너머 보이는 무심코 인사 건넸지만 아차 우리는 헤어진 사이 초간 멍하니 쳐다보다 시선을 돌린다 추스른다 놀란 맘 지나가는 사람들 이상하게 쳐다본다 막 근데 있잖아 너도 날 보고 자리에 바위가 된 굳은 채 가만있네 정리하기로 결심했던 맘이 휩쓸리고 흔들리고 날 못 살게 하는데 신호 바뀌네 이제 출발해야 돼 지나갈게 잘 잘 지내야 돼 보여 잘 지내나 헤어스타일도 바꿨네 역시 태가 예쁜 얼굴이니 뭘 해도 어울리지 정말로 걱정 많이 했어 솔직히 아플까 힘이 들까 나보다 많이 슬플까 근데 보여 내가 바보였나 보여 내가 바보였나 네가 혹여 이별 못 견딜까 걱정했는데 이렇게 우연히 막상 너를 보니까 맘 놓여 시선이 다시 돌아가 인파 속에서 널 찾아냈지 근데 곁의 새 남자 내게 얘기했던 사람인가 그땐 불행하길 바랐지만 지금은 달라 행복해야 돼 알지 진심인 거 그도 알게지 네가 특별한 감성을 지닌 거 페달을 밟고 가야 하는데 발이 움직이지 않을까 페달을 밟고 가야 하는데 발이 움직이지 않을까 페달을 밟고 가야 움직일 수 없을까 지내나 헤어스타일도 바꿨네 역시 태가 예쁜 얼굴이니 뭘 해도 어울리지 정말로 걱정 많이 했어 솔직히 아플까 힘이 들까 나보다 슬플까 내가 바보였나 녹색 불이 켜져 있어 갈 시간입니다 갈 수 없어 널 그냥 두고 경적소리가 들려 움직여야 한다고 말했다 이게 마지막인 같다고 녹색 빛은 갈 시간입니다 수 없어 널 그냥 두고 경적소리가 들려 움직여야 한다고 말했다 이게 마지막인 같다고 지내나 헤어스타일도 바꿨네 역시 태가 예쁜 얼굴이니 뭘 해도 어울리지 정말로 걱정 했어나 솔직히 아플까 힘이 들까 나보다 슬플까,3,1,-1,1,0
669,내가 되고 싶은 것은 멋짐 골라 킥 머리 어깨 무릎 다 잘 알고 있기 해 내가 하는 것처럼 그것을 하십시오 나를 해 박수 박수를 걷어차십시오 히피는 당신을 사랑합니다 네가 뭐라든 간에 너를 존중한다네가 뭘 하든 간에 늘 따끈따끈해 관심이 따끔따끔해 힐끔 힐끔힐끔 모든 일이 가뿐해 재향 군인 성공을 썰어 먹어 미슐랭 누구보다 빠른 걸음을 걸었네 비시즌 잊은 지도 오래야 뒷걸음 내가 되고 싶은 것은 멋짐 멋대로 골라 킥 머리 어깨 무릎 다 잘 알고 있기삐삐삐 논란이 돼 패션별로 신경 안 써 행동 나를 클릭하십시오 홀린 듯이 줌 클로즈업 클로즈업해 엉덩이 엉덩이 머리 어깨 무릎 입권 힙합 엉덩이 해 입권 힙합 어딜 가든 넌 반사 빛날 수 있어 세상에 넌 하나뿐인 걸근데 얼굴에 침 뱉니 칵투날 자극한 감사 거기서 멈춘 찌질이 반사 덕분에 나의 멘틀은 단단해난 앨범 만들러 갈게 당신이 되고 싶은 것은 트렌디입니다 어드로 끌기 눈속임 때지 그런 애들 끼리끼리 잘 알고 있기삐삐삐 논란이 돼 패션별로 신경 안 써 행동 나를 클릭하십시오 홀린 듯이 줌 클로즈업 클로즈업해 입권 힙합 있어 코 묻은 티 삐져나온 입떡진 상관없지 코 묻은 티 삐져나온 입떡진 하면 있어 코 묻은 티 삐져나온 팬티 떡진 상관없지 팬티 떡진 하면 있기삐삐삐 논란이 돼 패션별로 신경 안 써 행동 클릭하십시오 홀린 듯이 줌 클로즈업 클로즈업해 있기,3,1,2,-2,0
670,입술을 보고 힙합을 임건 사랑과 전쟁 입술을 보고 힙합을 봐우린 전사 함성을 들어 마을 열어라 고개를 들어라 몸을 데워라 가서 조져라는 그것을 내려놓을 수 있습니다 주위에 있고 싶어 그들은 차가운 어깨를 얻습니다 내가 이미에 말한라고 말해주었습니다 가장 나쁜 우는 이미 보여주었습니다 스폿 사격 네가 뭘 알아네가 뭐를 알아내가 움직이기 시작하면 입 닫아 다시 벌어지게 될 거니 까니 눈 코입 어깨 발 무릎 발매 입술을 보고 힙합을 임건 사랑과 전쟁 임건 사랑과 전쟁 맘을 열어라 고개를 들어라 몸을 데워라 가서 조져라나 운율의 스라소니 마누라 관자놀이를 밝히는 아우라 허리 밑에 손들은 재 가루가 될 테니 위로 들어 흔들어 다 나와 놀아다 나눠 가져 지금의 짜릿함 모두가 되는 아릿다움 담자 이제부터 미래가 시작된 펼쳐져 갇혀 있던 너의 속마음 뭘 알아네가 뭐를 알아내가 움직이기 시작하면 입 닫아 다시 벌어지게 될 거니 까니 눈 코입 어깨 발 무릎 발매 봐우린 전사 내가 로터리를 떨어뜨린다 그것을 죽인다 모르면 외워미친 고타를 얻을 수 있어야 합니다를 채워 생각 집어 여니 몸이 가는 대로 이동 단계별 세상을 움직이는 매직 당신의 마크처럼 그것을 분해하십시오 당신의 마크를 준비이건 봐우린 전사 함성을 들어 마을 열어라 고개를 들어라 몸을 데워라 가서 조져라,3,1,-2,1,-1
671,넌 아직도 일을 하고 있니 아직도 일을 하고 있지 나름대로 잘 돼서 너무 행복한데 생각이 너무 많아 밤에는 못 자고 있지 아무런 상관없는 네가 너무 바빠 다 잊고 생각 안 나던 네가 너에게 말한 바람들을 다 이루고 나서야 내팽개친 순수함을 다시 주워 담고 있지 전 너의 번 홀 찾았어 다행이야 나도 번호를 안 바꿔서 이건 미련일까 한참 생각해봤지만 이건 그냥 생각나서에 가까워 날이 올까 상상도 못 했어 예전에 치고받고 난리도 아니었잖아 그땐 그게 최선의 방법이었어 지금은 절대 겪을 수 없는 큰 감동이었어 많은 시간이 흐르고 후에 달력을 보네 그냥 생각이 나서 그냥 생각이 났어 우린 곳에서 똑같은 아침과 밤을 보네 나서 났어 전 괜찮아요 네가 없는 도시에서 꿀리면 안 돼 흐르는 눈물 모른 척했어 다 소용없는 짓 괜찮은 척 메마른 몸의 예쁜 여잘 쟁취하는 근데 그것도 별로 오래 못,3,1,4,-3,1
672,지금 불이 꺼진 음악실에 몰래 들어가 피아노를 치는 건 애가 확실해 나날이 몰라보게 늘어만 가는 실력 가느다란 손가락에 실려흘러나오는 음악에 흠뻑 취해 넋을 잃은 채 가슴을 적시네 애와 애인 안 되면 친구라도 먹고 싶은데 보통 애들의 기준에 예뻐 보이는 애는 아니지만 지금의 무료함과 우울함으로 가득 찬 공기를 가르고 건반 위로 손가락을 녹이는 작은 손 어설픈 클래식 연주도 아니고 찌든 가요 쇼에 계속 나오는 그런 음악도 절대로 아닌 달콤하고 씁쓸한 젊음이 제대로 담긴 독특한 분위기 그녀의 뒤로 다가가놀라게 했다면 미안 질문 하나만 질문 하면 너와 어울려서 좋은 것들을 할 수 있지 그녀는 대답했다 간단해 악기 다룰 알아 있다가 나한테 와서 신청서를 받아 거기에 쓰라고 돼 있는 부분 다 쓰고 네가 쓴 곡 있으면 가져와도 아까 질문이 나하고 사귀고 싶다는 뜻이면 그건 두고 보자 어디에서 모여 무엇을 하는지 멀리에서 보면 너무 희미해 나와는 상관없어 보였던 모든 이제는 달라졌어나는 거를 원하,3,1,-5,-4,-9
673,온몸엔 카키 이제 알다시피 통장 사기 이제 알다시피널 제거하지 나쁜 놈 나쁜 놈 나쁜 개새끼들 나중에 돌아왔다거지깽값을 물었어 거지 마음이 가난해 거지 땡전 한 푼 없어 거지 마음이 가난해 돈 벌 때지 돈 벌 떼돈 볼 때는 돈 벌 때천만 원을 술에 담가마셔버려 몸보신 벌떼에 쏘여 혹이 몹시 아픔 전해줘 소식형이 소싯적에 박사 드레 들었어 이르면 이르면 일름 보 잃으면 잃으면 이러면 일억도 못 가져알기는 싫은데 봐야겠지 남자로 태어나 하얗게 칠해진 대리석 바닥을 밟어 오늘도 사투 끝나면 하품 나의 안식 음악 하지 아직 흘러내려 바지 힙합 바지 투엑스 라지 뻔뻔하지 나의 상식 밖의 행동 예상해도 벗어나지 궤도 온몸엔 카키 이제 알다시피 통장 사기 알다시피널 제거하지 놈 개새끼들 나중에 돌아왔다거지깽값을 물었어 마음이 가난해 땡전 한 푼 없어 같은 새끼들은 많은데 믿을 사람은 없어 어디에도 거지같이 행동해도 되는 많 있으면 해도 돼 돈이 다가 맞는데 거지라고 뭐가 문제인 건데,3,1,-7,-2,-9
674,당신이 오늘 가고 있는 곳에서 가서 알려주세요 마지막으로 갈게 너를 데리러 삼십분이면 돼그래 그녀가 간다는 그녀가 알고 있는 모드를 쫓아는 그녀가 알고 있는 모드를 될 것입니다 혼자가 낫다 했잖아 어차피 넌 자리를 고정하십시오갈게 너를 데리러넌 여태 보이는 것만을 믿지 아직 나를 믿니 암캐들과 약간의 저녁 식사를 했지만 너를 위해 내가 도시 밖으로 나가는 길을 떠나는 순간에 내가를 비밀로 나가는 순간에 결코 있지 않았다 따위는 낭비 지사는 길에 해댔던 혼잣말이 지나는 다시 그것을 나쁘게 만들어 아플 시간만 다니 눈만 물들어 시뻘겋게 뜻대로 노력해도 안 되는데 행복해널 부럽게 봤던 친한 친구들이 그들은 하지 않습니다 간호 둘이 새겼었던 여권 위 문신 지웠다가 써서 더럽던 편지 글씨 맘에 지워야지 원래 없었던 듯이는 자신의 돈으로 시간을 내십시오 멕시코 오아보다 뜨거워 보인다 보이는 걸 믿기에 네게 손 대지 당신이 오늘 가고 곳에,3,1,0,3,3
675,한 번은 말했어 전화 끊지 마 경고는 없어 이제는 축구 스타일 내가 생각했을 잘 한 같아 너에게 이제 그럴 이유가 없어 내가 넌 요리도 안 하지 빨래도 안 하고 쉰지 두 계절 뭔 말인지 알아 씨이 맨날 가져가는 돈 근데 차 없다고 나에게 불평하고 차를 내가 커피 샀잖아 그렇게 타고 싶었던 사람도 아니었잖아 친구들 말을 들었을 걸 넌 속이 비어있어 장기 기증한 소녀 이효리 보면서 집 갖고 싶다며 산데 근데 일은 안 해 있어 억 널 따뜻하게 안았다 오늘 불은 꺼졌으니 이제부터 넌 뜨거운 아기가 아니에 뜨거운 베이비 뜨거운 아기이지만 너는 아니야 아기 아기 아기 적이 꽤 많아 나도 문제 있어 근데 형제들의 어린 와인보다 짙어 이름이나 아냐 이거 대체 마셔 만나기 전엔 원샷 했지 신선한 한 병 공주로 변신해서 밖에서 소리,3,1,-3,1,-2
676,댐벼 댐벼 다 다 준비 준비될 것입니다 죽는다 가져와 다 차가울 맛있다니까 자기야 혀로 낼름하지 말고 한 번에 그것을 삼킨 말씀하십시오에 미 대중의 수요에 돌아옵니다 나대로 잘난 맛에 살아 뭐 이미 아시아는 재능을 얻었습니다 래퍼들 반 정도는 목을 과일 닌자처럼 슬라이스 이제는 게임 안에서 자를 필요 없는 멜론 나를 증오하는 새끼들의 복수 이식 수술을 해야 될지도 뒤통수에 눈 세상은 악연이 많아서 그림이 나와다 내가 좆같이 대했기 때문이지 말이야 피부 같아 각오가 잘 안 벗겨져 몸에서 혼란 속에 남아 외치는 거는 영원히 구했습니다 억울 손목에 감은 기분 너는 평생 모를 건 시간이 없었다 설명하다 업보가 계속 억을 벌게 하네 아마도 신이 사랑하는 새끼 중에 돈을 부를 거야 앞으로도 가사에서 어쩌면 이게 내가 원하던 모습이 지나한텐 맨날 비난과 칭찬이 자자해서 두 암캐들과 삼인조를 가질 것입니다댐벼 댐벼 준비 준비될 것입니다 죽는다 가져와 준비 준비될 것입니다 죽는다 가져와,3,1,1,-2,-1
677,그럴 절대 없지 네가 미워지는 일어 못된 척 그런 척이 전 가버려 소리쳐도 그렇게 할까나 말대로 갈까 하지 어느새 손 꼭 잡은 그댈 미워하자 멀어지자 그때는 보내주자 조금만 나빴던 기억들도 조금은 남겨야지 준비됐다면 갈게 말 안 해도 그땐 다 알아니 어색한 거짓말 그거 안 해도 돼 괜찮아 그댈 미워하자 멀어지자 그때는 보내주자 조금만 나빴던 기억들도 조금은 남겨야지 준비됐다면 갈게 말 안 해도 그땐 다 알아니 어색한 거짓말 그거 돼 괜찮아 변한 건 없어 울고 있지만 떠올라 수줍었던 미소가 가슴 아파 예쁜 미소 이렇게 지켜주지 못해 안녕 사랑 멀어지면 그때도 사랑하면 그건 돼도 아픈 추억들에 견디지 못할 거야 원래 그런 남자 넌 원래 그런 여자 서로 미워하자 아주 조금씩 천천히 미워해 보자 아주 조금씩 천천히 음,3,1,-6,-2,-8
678,거를 찾아 올려놓는 것처럼 너무 길었습니다 가짜 사람들을 보여주었습니다 사람들은 우리가 당신이 당신의 문제를 숨기고 있는 것처럼 말할 우리가 말할 우리가 말할 옳지 않다고 내에 맞지 않을 내에 대한에 대화를 사랑하는 사랑을 보여줍니다 도달 범위에서 도달할 때까지의 똥 도달 거리에 도달할 절대 끊임없이 달리지 않을 것입니다 사랑은 가짜입니다 당신이 당신의 실수를 위로 올려놓고 싶어 하는 말을 믿지 않습니다 내까지까지 얼굴은 너무 길어졌다 가를 쳐다보는 것처럼 보였다 가짜 사람들이 가짜 사람들이 내까지 까지를 사랑하는 사랑을 보여주고 내에 똑바로 연주하기 위해 밤과 볼 수 오른쪽 버리기처럼 당신이 바뀌었습니다는 그들이 페이스 홀 시간에 미소를 지을 결코 내장 구멍 시간을 지키기 위해 내장 구멍 시간을 지키고 있을 결코 사메 메트가 아니었습니다 사랑은 가짜라고 수 있습니다 말 하는 단어를 믿지 마십시오를 찾아 사람들이 사람들을 보여주었습니다 얼굴을 얼굴까지 내면까지 내면까지 얼굴을 내면서 너무 길었습니다,3,1,-3,-1,-4
679,내보다 부자내 올해 손목 이름 리처드 손목영앤리친 타 외제차 회사 지분보다 비싼 유일 대의 첫 레이블은 허구 홉을 얻지 못했습니다 파더니 가만 다 보니 한 건 없고 다 뒤쳐앓아만 누워있어나 떨어뜨립니다 다음을 위해 빛내는 무버 유사성 다이아몬드 손목 얼음 돌침대 야마로 누가 열심히 킥발냄시 뭐 훈기는 이미 웹 부자 너무 방법 부자 웹도 밝혀 불이 붙은 시합 넌 꼬리를 잡으려 해 근데 잡았어도 뭐 해 도마뱀처럼 거기에 잘라다 뒀지 마음에 폴로 랄프 녹색은 커져 헐크 포식자처럼 작년은 술로 날려먹었지 배엔 억 치 술 올핸 뒤졌어 창 나의 브라더 선임으로 있어 엉망 따고 후임으로 가리 평화 래퍼 새끼들 다 라메노틴 절름발이 너흴 볼 땐 마차 백미러에서 빈번히 지금 은 우연히 불러일으키지 않습니다 너흰 실랑이는 아이러니입니다 지붕 위도 쳐다볼 모르는 놈들이라 이벌이라니 푸시 핀 푸시 핀 밀 푸신 푸신 푸시 핀 진 버즈 부랑자 푸신 부랑자 호랑이와 벌의 무늬는 같지 검은색 노란색 문신 억지 들은 맥 프로 놈은 냈다 하면 새로운 새로운 티니가 나를 따라잡았다고 생각할 때쯤엔 이동하다 자식들 흐름도 쓰는 핸드폰도 구식 형사보다 혀가 긴 래퍼 온 스타 갱스터 적을 해도 속은 햄스터 뇌 있음 브레인스토밍 말뿐인 준비된 죽이다 누가 변화해 여길 은 솔 영혼 명반 따기 수험 아닌 생각 삶 정력적 활동 돌바닥 출신들의 영광의 한 글로리 영광 만들어 쇼미 비트를 떨어뜨립니다 누가 신병들을 책임져 없어 난의 너흰 그냥 운율 음악 가난 래퍼로 안 쳐내 빼고 시즌이 다가오고 있습니다 진을 밀어 가진 푸틴 부랑자,3,1,0,0,0
680,바보들아 이미 돈 벌지 바보 같은 옷 집어치우지 바보 같은 짓 하며 벌지 바보라고 했던 쟤네 흠칫 옷 얘기하지 말아 쓰레기 가방에 있는 거는 제작에 대한 제동처럼 랩난 사람 넌 하고 있는 음원에 지 불으니 경험에 엿 먹여 그것이 내가 하는 일입니다 직업 질병 서울 보다 남쪽으로 사고 아키바로 스키드 스키드 바보 같은 의견 무시 오른쪽 친구 아님 결제 따로 얹어 타고 스키드 스키드는 내가 얻은 전부입니다 사랑은 전부입니다 내가 얻은 전부입니다 모든 것이 필요로 하는 모든 것입니다 사랑을 얻는 모든 것입니다 보이 예니 트렌디함은 너무 예전 꺼 야생 산만만 해 보여 강하게 강해집니다 빠른수혼세코프난 미쳐 클럽 뱅커에게 이거 가수니 의견 디지털 가에서 어울리는 일치합니다 폐기물 가방에 보여 장소 얼굴 꿈에 살고 넌 꿈꾸는 사람 금값 넘어 검사해 수하물 만드는 건 범죄야걘 돼 기업 간첩 위성 전활 사야겠어 서울 보다 남쪽으로 사고 아키바로 의견 무시 오른쪽 친구 아님 결제 따로 얹어 타고 여기는 전부라는 것입니다 사랑을 얻었습니다 사랑은,3,1,-3,-3,-6
681,누가 예상이나 했겠어 콩알만 한 애송이에서 손꼽히는 탑 랭커 목소리만 큰 넌 목만 메이저 예정인이 사나워 비트 키워 지금 명상 준비 예리해 예리해개쩌는 멜로디 메이킹 해꽂아 뇌리에 최신 유행 극혐하는 학생 친구 방금 내적 댄스 춘 거 걸렸어좋아 끝물 같아 보인다면 공연 와서 파도 타고 다시 떠들어 돈 돈 내홍 병 예방엔 노래가 직방 어린이 어르신까지 깡그리 다 힙합가수들 박자 대신 발매일 밀당 이유는 지에코 신보 출시 임박 빛을 봤지 고글 쓴 후부터 넌 어두워 앞이 고글 쓴 후부터 충격적 사실은 쪽도 해당 안 되는 놈이 꼭 뭐 구는 거 라임도 맞출 겸 모가지 끊으러 여긴 덜덜덜 저긴 훌쩍훌쩍 무서운 추이를 보여내 바이럴 마케팅에 가요계 전염 안 떨어져 운발 운율을 씁니다 직업 특성상 운을 떼니까 망할 확률은 빵 프로다 인마 내가 마흔을 넘기면 바뀔걸 올드의 정의가 심술 나서 어깃장 놓다간 걷어차요 볼기짝 그새 늘었어 랩 테크닉 인생 그래프같이 변칙적,3,1,-4,-1,-5
682,당신이 어딘가에 있다는 것을 알고 있습니다 제인 도이는 당신이 클럽 하워 가고있는 것을 좋아한다는 것을 알고 있습니다 너와 나의 첫 만남이클럽 년저번에 미쳐서 정신을 놨어너에 대한 이야기를 썼지아주 오묘합니다 감성무슨 생각에 썼지나도 잘 모르겠어애써 의식의 흐름으로 너에게편지를 쓰자니천국에는 못 닿을 거 같아 이게 절대핑계가 아니라 생각 많이 해봤는데방법이 별로 없네그래서 그것을 적어 놓고이 똥을 게시하는 녹음하지 못하지만 관리했습니다 직원이 다 해주지등 직원이그리고 나의 모든 호미는 불을 붙였다다 존나 잘해네가 연락하던 래퍼보다보면 나도 마찬가지나도 그런 래퍼 오빠인가 보다근데 어떡하지 줬지 몸만사랑보다는내가 들렸을 때내 머릿속에는생각들이 휘몰아치네아무리 기억하려해도 떠오르지 않는 이름떠오르지 않는 너의 이름불러봐도 대답 없는 이름떠오르지 않는 너의 이름불러봐도 대답 없는 이름형들과 살기 춥다있지이런 규칙 공유가 돌보고 있습니다그래서 해줬지 소개 당신과 우리는 우리가 친절합니다근데 알고 있었니내가 널 아직 잊지 못했는데왜 받냐 소개그래 미안해이런 식 갑질 싫다고 했지이러면 내가 손해또 날 투쟁형들 나를 불러주세요사거리 코쿤근처 술집 꾼 층 자리는 창문옆이고 오래 얼른넌 태우고 있었지 담배울 엉아들 착해 재밌는 분위기시발 해야 돼내가 널 여기서 좋다고 말할분위기는절대 아니야 너와 죽술 취한 너를 등에 업고집에 데려와 방을 내주고아침에 일어나 젠장 젠장 내려 오는 보지 않아야 할 것내 머릿속에는생각들이 휘몰아치네아무리 기억하려해도 떠오르지 이름떠오르지 너의 이름불러봐도 대답 없는 이름내가 들렸을 때내 머릿속에는생각들이 휘몰아치네아무리 기억하려해도 떠오르지 이름나는 당신이 어딘가에 있다는 압니다,3,1,2,0,2
683,다짜고짜 던지는 너의 헛소리 황당한 황당해서 헛웃음만 나오네 숨만 쉬어도 쪼아대는 어제오늘 그런 식으로 해라나도 수를 쓸 테다 영등포역 화장실 번째 칸 번호 남겨버린다 위장 대장 십이지장 장기를 팝니다 삐뚤어져 버릴 테다 능글능글 웃긴다 엿 먹이니 즐겁냐 황당한 황당해서 헛웃음만 나오네 말만 하면 빈정대는 어제오늘 그런 식으로 해라나도 수를 쓸 테다 지하 삼층 ᅡ자리에 번쩍번쩍 빨간색 차서 서희 양쪽 타이어의 바람을 빼낸다 삐뚤어져 버릴 데다 펑 누가 나를 판단해 누가 정의 해니 입맛대로 나를 깎아내려 하지 마 못마땅한 이유를 설명해줄까 마음 속에 맺혀있는 컴플렉스지허나 나를 못살게 괴롭히면 나도 수를 쓸 빨간색 이름을 꾹꾹 눌러 적는다 삐뚤어져 버릴 멋대로 해라 멋대로 살 멋대로 해라 살,3,1,-6,4,-2
684,폭염에 복면 쓰고불구덩이에 처박힌내 기분을 니들이 알아스윙스 기리 팔로 코쿤악당들아 기다려라이 만화에서 주인공은절대 죽지 않아계획대로 되고 있어확인계획대로 되고 있어소년점프 소년점프와다다다다다다와 시발 이거 완전히 좆됐네제대로 빡세게 대가리 깸하지만아 필 라잌 소년 점프 실 그림이거 완전 클래식 클리셰주인공 초반에 고통 받고각 잘 재고 무릎 바닥 쳐 박고야 병신새꺄 사실 다추진력을 얻기 위함이라고계획대로 돼가고 있어청춘 만화 빡세게 찍듯마미손 풋내기 슛부터시작 산왕전 머리 위 슬램덩크딸깍 하는 소리 수다부릅 부릅 부릅 응음 당신이게 요즘 유행이라며한국힙합 망해라내가 여기서 쓰러 질 거 같냐새끼들아넘어져도 쓰리고 인생은 길고내 음악도 길어모험은 시작됐어마미손 가자 렛츠고도넛맨 미안해마이크 못 줘서 미안해딥 넉살 더콰 창모악당들아 기다려라이 만화에서 주인공은절대 죽지 않아계획대로 되고 있어 확인계획대로 있어소년점프 소년점프와다다다다다다마미손 인생 존나 뻥 응손 쉬운 성공 꼴렸어 응몰랐어 실패는 졸라 써쉬운 성공은 화장빨 졸라 뽀얘그니까 폴라폰 포도 폴라포냉장고 꺼내서 급하게 삼킴뒷골 아퍼 응어 마미손 인생 존나 뻥그래 그래우주는 겁나게 크고난 우주의 조빱 조빱날 떨어뜨린 심사위원님들나빠 나빠돌 맞은 개구리처럼 지금 아파하나님 빌어요내 맘의 사랑과 평화 평화 평화내가 여기서 쓰러 질 거 같냐새끼들아넘어져도 쓰리고 인생은 길고내 음악도 길어모험은 시작됐어마미손 가자 렛츠고도넛맨 미안해마이크 못 줘서 미안해스윙스 기리 팔로 코쿤악당들아 기다려라이 만화에서주인공은 절대 죽지 않아계획대로 있어 확인계획대로 있어하 하딥 넉살 더콰 창모악당들아 만화에서 주인공은절대 있어 확인계획대로 있어소년 점프 소년 점프 가자폭염에 복면 쓰고 처박힌불구덩이 기분을 니들이 알아,3,1,-4,3,-1
685,게임에서 그것을 튀어나온다 괜찮아 안 나누지 난나는 절대 자르지 않을 것이다 돈에서는 안 대인배통채로 다 가져와 내가 팝은 듣지 마세요 오다 나누기엔 너무 많은 팝 팝팝 팝 팝 예가 눈 감고 다시 터뜨린다다 시 손에 쥐어보니 머린 비어난 높이 올라 두려움이 없었다 안전 불감증에 너무 위험 대체 뭣하러 남의 거 따러 맨날 힘들어 그냥 무시해 맨날 몸살을 달고 살아 절대 몸 안 사려 간다 무식 손에 뭣 없어도 절대 안기었어 떨어졌다 안되고 내가 이겼어빨 떨어져도 어떻게든 버텨서 통장 한숨 내쉬어 푹 팔천 따리 나는입니다 엄마 차에 한 번에 톡 옛날에 쿠기였음 했노쓸데없는 연락들은 다 읽씹늦기 전에 기회 놓치고 짜내다 라세가 런던을 털었어 송곳 예비군 때마다 지팡이를 잡아당기십시오후려쳐도 못 내지 흠난 가졌어 기술 다 피하고 슬라이딩 계약서 사인해 우승반지에다 키스 됐어 이제 닿았어 왔어 돈 벌 밖에 없어 영덕아 됐어 게임에서 튀어나옵니다 괜찮아,3,1,-5,3,-2
686,허락하다 화상 아니요 그것 완료되었습니다 방화 허락하다 화상 열정에 불타다 염원에 불타다 삶 속을 내가 달린 매일 화상을 입는다 멈출 수 없던 시절 모든 것을 태웠고 모든 것을 원했다 명예는 첫 번째 돈 인기까지도 스스로가 과열이 될 수밖에 없던 뭣도 모른 무식한 야망의 원동력 내가 땀을 흘릴 기름 샤워해 불을 지필 수 있게 발에 다리에 뜨겁게 방식대로 달리세요 달아오르는 성적 인기는 정점 비례하는 태어난 증오 울리는 경적이 레이블로 팬과 원인같이 타오르기에 하루 종일 합리적인 공범 방화범 재미있었다 무서울 건 없어 한 치 앞 에프 누군가 나에게 물어보면 오른쪽 내가 불을 지폈지 나에게 물어 무엇을 선택하십시오 불을 끌지 타오를 지방화 그것 완료되었습니다 나의 꿈도 완료 큰 성과도 완료 할 몫도 완료 이상은 없음 과유불급이야 손뼉 떠나는 멋 켰던 건 나를 위함이었어 세상이 타오를 누가 알았겠어 식힐 때쯤 보니 흔적들이 보여 끄기엔 너무 큰불 심한 방화였단 걸 젠장 뜨거워 안돼 괴로워 잠 깨 이면과 연락하다 무서운 상태 할 수 있는 사람이 없다 팀 멈추지 않습니다 똥그 끄기엔 나만이 가능해 혼돈의 소방관 오진 압해도 재처럼 어둠의 길일 거라고 자신에게 말씀하십시오한 치 앞 큰 관문 필요한 나의 돌을 던질 판도 비껴가는 한 누군가 나에게 물어보면 오른쪽 지폈지 물어 무엇을 선택하십시오 끌지 타오를지 누군가 물어보면 오른쪽 지폈지 물어 무엇을 선택하십시오 끌지 타오를 지방화 방화,3,1,0,-2,-2
687,내가 제일 잘 나가 내가 제일 잘 나가 내가 제일 잘 나가 잘나가 잘나가 누가 봐도 죽여주잖아 괜찮은 둘째가라면 몸이 서럽잖아 괜찮은 넌 뒤를 따라오지만 앞만 보고 질주해 네가 앉은 테이블 위를 뛰어다녀나는 아니에요 간호 건드리면 감당 못해 뜨거운 뜨거운 뜨거운 불 뒤집어지기 전에 발 누가 날 말려 옷장을 열어 가장 상큼한 옷을 걸치고 거울에 비친 얼굴을 꼼꼼히 살피고 지금은 시약 속 시간은 시 반도도 한 걸음으로 나선 밤 잘나가 봐도 끝내주잖아 괜찮은 네가 나라도 몸이 부럽잖아 남자들은 날 돌아보고 여자들은 해 앉은 자리를 매일 넘봐 피곤해 선수인 척 폼만 잡는 어리바리한 넌 바람 빠진 타이어처럼 보기 좋게 차여어떤 비교도 거부 해이건 겸손한 얘기 가치를 논하자면 억 달러의 아기 뭘 아는 사람들은 다 알아서 알아봐 아무나 잡고 물어봐 누가 네가 나보다 아니요 아니요 아니요 나보다 나보다,3,1,5,-1,4
688,누가 이제야 벗겨지는 베일 기다려 주셔서 감사합니다 안녕하세요 나를 보면 모두가 다 공황 예상 외니 시작합니다 처음엔 따끔할 겁니다응그런 눈동자 나쁜 건 들키지 맙시다 어디든지 사정거리 한 탱크처럼 엄마 빨라지는 심장소리 탱크 탱크 엄마 망설이지 않는 탱크처럼 플레이 엄마 우회하지 않을래 탱크처럼 신선한 신선한 너무 이상한 신선한 너무 이상한 너무 이상하다 이상한 이상하다 마노 감사합니다 삐뚤다고 자를 대니 그것에 대해 생각하십시오넌 속마음을 들켜 이미 얼다 지나갑니다 막지는 맙시다 음 뻔한 거짓말 멋대로 정하지 맙시다 겁이 뭐야 돌격하는 유형과 같은 탱크 끝이 없는 황야를 갈라 밀려나지 않는 플레이 후퇴하지 않을래 이상하다 메이 양은 볼 수 있습니다 그것 피어올라 꿈꿔왔던 신기루비를 내려 사막에 원하는 대로 상상한 대로 소원 소원 위시 소원의,3,1,-3,4,1
689,너에게 사랑을 구걸하지 않았어 진심을 원했어 마지막으로 널 봤던 날도 널 원하지 않았어 진심을 원했어 상처받은 마음과 더럽혀진 추억 날 바라보던 표정 다 너무 싫어난 네가 싫어 불안했던 모습 지켜 내려던 모습니다 너무 후회가 돼 잘 몰랐던 네가 싫어 너에게 사랑을 구걸하지 않았어 진심을 원했어 마지막으로 만난 날도 넌 진심이 없었어 상처받은 마음과 더럽혀진 추억 날 바라보던 표정 다 너무 싫어난 네가 싫어 불안했던 모습 지켜 내려던 모습니다 후회가 돼 굳게 닫힌 나의 맘과 돌이킬 수 없는 서로를 아프게 했던 그때가 싫어난 내가 시간이 흐른다면 서로를 이해할 수 있을까 그때도 만나지 말자 내가 너에게 늘 진심이었고 너도 그때만큼은 그랬을 거라 믿어,3,1,-2,4,2
690,넘어져도 다시 일어나나는 전설이지 내가 죽기 전에 미리같이 사진부터 찍어놔나는 개의 발가락에 있습니다도 다리가 여러 명 기둥이 되었지 머릿속 게을리 움직인다고 생각하면 체계에 오류나 사자의 영혼 내가 가슴과 원칙을 얻었던 앞서 앞서있다 가둬두려 해도 탈출했지 노예 되기 전에 선택해 죽음 매년 판을 벌려 다시 기록 세워나는 착한 사람 통장 채워 한국인 피가 흘러 절대 안 굽혀 남자는 안에 너와 나의 차이점 요리를 해도 맛있어내 너무 높이 있어내에서이지만 당신의 핸즈는 레이스 속도 속도를 원하지 않습니다 포기했어 지침다 맘대로 해이 새끼 카피한 걸로 돈 벌어 넌 네가 목소리 팔아서 벌어도 번이나 본 댓글 처음인 것처럼 해임제는 나도 포기했거든 괜찮아요 이리 줄게에야 디야 너흰 진정하지 비밀 지키면 감사 얘가 하면 오마주 내가 하면 다 카피 너랑 나중에 누가 재범이 형이랑 작업해 새 페이스 러브 당신의 증오처럼 빛납니다 핏물 다 시시해 가짜,3,1,-6,-5,-11
691,살을 베는 날 선 바람 살을 뱉는 낯선 사람 살지르고 사치한 밤 살찌우고 무시한 밤 흩날리는 눈 흩어지는 골 삿된 무리들 사라지네 흩날리는 눈 흩어지는 골 삿된 무리들 사라지네,3,1,-1,0,-1
692,우리는 우리가 나은 느낌을 느낄 수 있다는 것을 알고 있습니다 우리가 느낄 수 있다는 것을 알게 해주세요 도망치고 있습니다 알고 있습니다 걱정 마 아기 생각은 내일 해 웃음을 지어줘 얼굴은 붉어져 스쳐 지나가버려도 꿀처럼 기분이 다 말해 혀가 움직이질 않게 해줘 꿀처럼 밤새 기분이 다 말해 혀가 움직이질 않게 해줘 밤새 전화기는 됐어 말하기 위해 시간을 모르게 눈을 뜰 옆에 없어도 원망 안 할게 멀어질까 사인 당신이 이겼다는 것을 안다 마음 웃음을 지어줘 얼굴은 붉어져 스쳐 지나가버려도 꿀처럼 기분이 다 말해 혀가 움직이질 않게 해줘 밤새 일까 머리는 아는데 데일까 몸이 반응해 손을 놓고 손을 잡아 아기를 데리고 가십시오죄일까 내가 나인 헤맬까 이렇게 그놈은 널 감당 못해할 수 당신을 데려가면 내가 당신을 맛볼 있게 해주세요,3,1,-4,-3,-7
693,지긋지긋 배고프고 갈증 나고 생맥주가 지긋지긋 잠도 밤도 맘도 지긋지긋 눈을 뜨고 눈을 감고 뛰어가고 걸어가고지긋지긋ㅈㄱㅈㄱㅈㄱㅈㄱㅈㄱㅈㄱㅈㄱㅈㄱㅈㄱㅈㄱㅈㄱㅈㄱ댄스 댄스 댄서 만들기 댄스 춤추는 댄스 댄서 만들기 매일 아침 매일 저녁 매주 주말 매주 월요일 겨울 찬바람 뜨거운 바람 에어컨 바람 선풍기 바람 비 긋 지긋 알지 그치니가 바라는 근 바람ㅈㄱㅈㄱ ㅈㄱㅈㄱㅈㄱㅈㄱ찬양질 사냥질 이제 전화하지마영업질 서비스 질 스팸문자 보내지 마 만들기 댄스ㅈㄱㅈㄱ쉴새없이 지껄이는 시끌시끌 징그러운 아래위아래위 거침없이 뱉어내는 침상 위 춤사위 너와 사이 사이 도 지긋지긋ㅈㄱㅈㄱㅈㄱㅈㄱㅈㄱㅈㄱㅈㄱㅈㄱ댄스 댄서 춤추는,3,1,0,0,0
694,내겐 이건 언제나 약점 날 약하게 나약하게 만들어움츠러들어 널 만나면 나약하게 날 약하게 만들어 믿음이 가득 찬 날 좋아하던 모습은 다 가고 좋아하던 이유 떠나고 아직도 뭘 잘못한 건지 몰라아니면 내가 잘못된 건지 몰라 세상 물정 몰라 모르는 척 한걸 지도 몰라 의식에 더는 안 속아날 의심해 더는 반복하기 싫어 진심이야 한 번만 믿어줘 답이 없잖아 어차피 음악이었잖아 그냥 음악이었잖아 포기하기 싫어널 포기하기 싫어널 포기하기 싫어널 잃고 반복하기 잃고 반복하기 잃고 싫어나를 죽일지도 이다음번엔 죽일지도 너를 다음번에 뒷주머니 식칼을 꺼내내 손목에 너의 목에 고통을 빨리 끝내주소서 고통을 빨리 끝내 주소 서신이시여 용서해주소서 당신이 보낸 전령 이제 거절 우리가 세상에 아무것도 가지고 온 것이 없으매 아무것도 가지고 가지 못하리니 우리가 먹을 것과 입을 것이 있은즉족한 줄로 알 것이니라 부하려 하는 자들은 시험과 올무와 여러 가지 어리석고 해로운 욕심에 떨어지나니 사람으로 파멸과 멸망에 빠지게 하는 것이라야 방송 나가면 되고 그냥 랩 가르치면 되고 아이돌 가사 대신 써주면 돼즐겨주면 돼 돈이 되면 대체 뭐가 문제야 규칙은 누가 정해놨어 뭐가 널 가두고 있는데 대체 뭐가 널 가둘 수 있는데 이제야 자유로운 느낌이야 자유로운 느낌이야 자유로운 느낌이야 이제야,3,1,-8,0,-8
695,까놓고 말해봐 뒤에서 하는 말 막상 앞에 서면 넌 입바른 말 말 필요 없이 같음 안 쿨한 척할 거면 면전에다 욕을 해 진짜 솔직해져 쿨한 뭔데 쿨해야만 하는 내가 볼 때는 못된 같아 막말 듣고 기분 나쁘건 당연한 일인데 쿨하지 못해 나쁜 사람 됐네 솔직해져 틀린 거 없는 말이잖아 당신이 항상 당신이 항상 시도해보세요 날 위해 원하는 있다면 다 가질 거야 그렇게 하고 싶어 골 아프게 넌 뭘 고민을 해 네가 내게 준만큼 나도 날 거야 톡톡 사이다 흐름 해보나 만나지 너와 가위바위보 할 거면 제대로 하지 딴 소린 안 해 걱정 따윈 집어치워 할 거나 해사이다 사이다 사이다 이제 확실하게 알겠니 이게 너와 차이야 남들이 뭔데 내가 눈치 봐야 결과와 대가다 내가 받는데 맘대로 남 탓할 시간에 목을 죄일래그러니 걱정하는 척은 그만 됐어 너네 생각과는 다르게 준비돼 있어내가 안될 거라고 말하던 둘에겐 거 미안하게 됐어찔리겠지 날 손가락질하던 손으로 이제는 내게 전활 거니 더는 낭비하지 마 아니어도 폰은 이미 과부하 명성에 게시하는 것처럼 좋습니다 위해 원하는 있다면 다 가질 거야 그렇게 하고 싶어 골 아프게 넌 뭘 고민을 네가 내게 준만큼 나도 톡톡 흐름 해보나 만나지 너와 가위바위보 할 거면 제대로 하지 딴 소린 안 걱정 따윈 집어치워 거나 해사이다 이제 확실하게 알겠니 이게 차이야 눈치 따윈 보지 않아 말은 제대로 하지 딴소리해 뭘 알아야지 거 아냐 손톱 물어뜯는 말이야 눈치 보지 않아 말은 딴소리 애걔 집에 갔어 그녀는 사라 졌어요 분명 오늘 밤 꾸게 될 예지몽 해보자 그냥 그냥 그냥,3,1,-6,0,-6
696,유형의 유형의 짐승 짐승 짐승 유형의 화장은 진하게 타고난 계집애 뭔가에 끌리지 해 시 태그 일상 데일리 너무 나쁘다 그런 날 자랑해 당신을 미치게 합니다 당신의 눈에서 그것을 볼 수 있습니다 너와 다르다고 틀린 건 아냐 판단하지 마 인생 모르잖아오 난우는 당신을 위한 사람이 되어야 한다 놀라지 마라 선수끼리 당신은 정말로 나를 테스트하고 싶습니까 내가 엑스인 같아 당신은 정말로 원하십니까 내가 엑스인 같아 당신은 정말로 원하십니까 내가 엑스인 같아 패션은 살짝 야하게 태도는 과하게 너에 비해 매워남에 대해 배워나는 잘하는 것이 너무 나쁘다 가끔 엇나가 삐 끝나 당신의 친절한 레이디는 당신을 알고 있습니다 당신의 눈에서 그것을 볼 수 있습니다 너와 다르다고 틀린 건 아냐 판단하지 마 인생 모르잖아오 난우는 위한 사람이 되어야 한다 놀라지 마라 선수끼리 나를 테스트하고 싶습니까 원하십니까 만족하지 않아 욕심쟁이 거 챙겨 챙겨 하루 종일 전 덕분에 구역의 미친 엑스 만족하지 않아 욕심쟁이 거 챙겨 하루 종일 전 덕분에 구역의 미친 너무 기분이 좋다 살아있어서 가장 나쁜입니다 가장 나쁜 중 가장 나쁜 중 나쁜 사람을 가져오는 것입니다 록 스타,3,1,-3,6,3
697,음이 거기 누군가요 음모 나를 안다고요 음이 잊어버렸죠 버렸죠 노도 웃기지 않나요 당황스럽네요 음모 친한 척 말아줘 말하고 다녀 음음 오만 지지 말고 떨어져요 내게 뭐를 원하나요다 똑같죠 너처럼 같은 거는 이제 전혀 모르겠네요 음음 오나 변했나요다 똑같죠 너처럼 베풀거나 내주거나 천사 같은 여보세요 달콤하게 사탕 발린 말도 예의 없어 착한 척 말고 꺼져 이제 가식 떨지 말아맴돌거나 말 걸거나 박쥐 같은 수행원 성공을 점쳤다는 거짓말 쟁이 어이없어 친한 척 말고 꺼져널 위한 가식 따윈 기대 말아 엉망진창 지금만 보십시오 몰랐지 오리 속 백조 황홀한 케이크 위 폭발 머리 위에 크라운 말했지 이곳의 보석은 나야 투자해 어서 넌 번쩍거린 것만 찾느라 여길 번쩍 들어 올릴 못 찾았어 별로 별로야 됐으니 꺼져 음음 오만 지지 떨어져요 내게 뭐를 원하나요다 똑같죠 너처럼 거는 이제 전혀 모르겠네요 오나 변했나요다 베풀거나 내주거나 천사 여보세요 달콤하게 사탕 발린 말도 예의 없어 착한 꺼져 가식 떨지 말아맴돌거나 말 걸거나 박쥐 수행원 성공을 점쳤다는 거짓말 쟁이 어이없어 친한 꺼져널 위한 따윈 기대 말아 음조 믿을 수 없게 음이 손댈 수 없게 잘못된 얘기 당신은 엉망으로 만들지 못해 완성되지 않았다 몰랐지 걸작이 걸작인가에 반복되는 멜로디 멜로디 너무나 완벽한 ~ ~ 팬들은 사랑해그래 영형 영형,3,1,6,3,9
698,아기 아기니 생각이 나난 담배 태울 내가 담배 태울 아기 아기 내가 여자를 차에 태울 여자를 차에 너의 사진도 지울게 어디를 그런지 모르겠어요 취하는 밤내가 담배 어디를 너는 모려나의 생각 내가 때나는 사랑 노래를 쓰고 그것을 놓아 주려고 노력하고 건 배울게 소린 끄고 술을 한잔 마시다 보면 밖엔 해가 다시 뜨고 그것을 놓아 주려고 노력하고 잘 지내고 있는 같아 너를 놓친 나를 탓해나는 나의 길 걸어갈게 인스타그램을 확인해난 이야기를 팔게 너는 웃어야 돼 밝게 너에게 연락은 안 할게 인스타그램을 확인해 아기니 생각이 나난 여자를 차에 너의 사진도 지울게 어디를 그런지 모르겠어요 취하는 밤내가 너는 모려나의 생각 우린 밤을 새우며 놀다 잠이 들곤 했지 이제 널 못 임건 변함없지 의심할 여지가 없습니다 벌고 있는 돈과 입고 있는 옷과 건 넌 못 마음이 아프지 의심할 여지가 없습니다 거 다 거 해난 너만 이뻐해 근데 옆자리는 싸해 이제는 정말로 안녕 해당 신의 시간이 되세요 담배를 태우다 끝나면 가야지 와끝나면 가야지 꼭 아기니 생각이 나난 너의 사진도 지울게 그런지 모르겠어요 취하는 밤내가 모려나의 생각,3,1,-1,3,2
699,세계이 공간 속에 비밀시미 시미가까움은 가면 같은 특수 효과를 줘우린 만질 수 없는 걸 믿지우너도 알지우린 알고 있지 우더 가까워진 건 야생의소리 보다 큰 벽당신은 야생입니다더는 참을 수 없어우난 깨버리지우난 깨버리지깨버리지내가 손대면 뭐든지가지게 돼 나의 온기손끝에 닿는 순간 빠진 느낌그래 당신이 원하는 것을 안다내게 가까이 닿아봐세상은 우리의 월드입니다당신은 내가 알고 있습니다 내가 널 이끄는 보스 돈당신은 내가 알고 있습니다 널 움직인 당신은 있습니다 널 이끄는 보스 돈당신은 당신은 당신은 이끄는 보스 돈당신은 움직인 대로 움직여더 높이 너의 손을 뻗어난 너와 나를 묶지또다시 묶인오다른 우리다른 우리난 절대적인 너의 사장님네가 원해 그것을 좋아한다가지고 싶다면 가져내 선택 그것을 좋아한다난 너와 시선을맞추길 바라왔지 은 필요로하는 것이 당신이 나를 있습니다나만 따라와 멀리널 데리고 겁 없이더 큰 하나를그리고 싶어졌어 응모두 다시 태어난 것처럼내 세계로 와다들 물 만난 노래해두목당신은 움직인 는 그것을 줘기분 내키는 대로좀 가까이가 가까워졌습니다믿고 다가서 줘이젠 눈을 감아 앞에 펼쳐질나의 세계를 맘껏 들이쉬어그대로 충분해 넌 아름다워손끝의 소통 이건 가짜때려 쳐 대신당신에게 다이빙을합니다직접나는 당신을 위해 일하게 만들 수 당신을위한 보스가되었습니다 부질없는 필요하지 않습니다내가 나타내줄게난 알아 너의지금은 두려워하지 않습니다 세상의 애태우게 할 놈핫도그는 입는 것처럼 느껴집니다구스구스나 은 가볍게 비행 할거야네 문 벨을 직접노크할 거야 이건직접 간판당신은 세상 밖에서만 찾던 세계온전하게 조화롭던 세계누구라도 원이 될 있게보내볼래 나의 노래,3,1,-2,-3,-5
700,제길 이렇게 살았어 보다시피 볼 없이 살았어해놓은 없이 가진 없이 그럭저럭 되는대로 그런 하루 하루나도 간절하게 바랬던 있어나도 맘을 다해 했던 일이 있어내 뜻대로 돼준 일은 없어 아무것도 나에게는 쉽지 않아그래 제길 이렇게 살았어 보다시피 볼 살았어믿는 사람 진짜 사랑 한 번 그럭저럭 되는대로 그런 하루 하루나도 간절하게 바랬던 있어나도 맘을 다해 했던 일이 있어내 뜻대로 돼준 일은 없어 아무것도 나에게는 쉽지 않아그래 제길 이렇게 살았어 보다시피 볼 간절하게 바랬던 있어 맘을 다해 했던 일이 있어내 뜻대로 돼준 일은 없어 아무것도 나에게는 쉽지 않아 있어 있어,3,1,0,-3,-3
701,이중 함께하는 특별한 밤 출석 놀 잘 못 노는 사람도 게으른 사람 알잖아 오늘은 신나게 놉시다 말하다 출 확인하십시오출 확인하십시오출 확인하십시오 출석 책 우리의 일주일은 화 수 목 금금 금 가득 쌓인 업무 쉴 틈틈틈없어 졌어 입술이 텄어 얼굴 위에 그어진 빗금 금금 전쟁 같은 삶 거울에 비친 우린 수척해 오늘의 해가 떨어졌으니 전화기를 꺼 여기로 출석 확인하다 일자리 구하기는 하늘에 별별 별 가족들의 기대치는 덜덜덜 오늘도 미끄러진 백조 백수들에게는 휴식마저 벌벌 벌다 잊자 오늘 밤 만은 만들자 우리만의 추억이란 작품이건 낭비가 아닌 재충전 사막 같은 삶을 위한 생수 병 오늘은 여기로 출 확인하다 모여라 여기로 출 확인하다 왼쪽 사람들 오른쪽 사람들 어서 아기 어서 모여 오늘만큼 당신의 마음을 자유롭게 하십시오 오늘만큼 당신의 마음을 자유롭게 하십시오 어서 아기 오늘만큼 당신의 마음을 자유롭게 하십시오 하십시오지고를 들어버리겠다며 당돌하게 거꾸로 물구나무를,3,1,0,0,0
702,그만 울어대 보이 어링 링 지겹지도 않니 넌 뭐가 불만인데 네가 나한테 뭔데 말하려는 뭔데 뭘 말하고 싶은데 뭐 어쩔 건데 갈 길 갈게 두목 밤에 나를 울리게 만들어 끊을 시간이 없어 대답 없는 날 붙잡을 생각은 하지 마지 금은 전화를 받을 수 없어 미안해 노이 나빠 매일 넌 아파 매일매일 여기까지니까두목미자 소년 이러나 싶네 속이 타들어 간대 같은 말만 하네 뚜 뚜 뚜 관심 없어 알아서 해 두목 밤에 나를 울리게 만들어 끊을 시간이 대답 없는 날 붙잡을 생각은 하지 마지 금은 전화를 받을 수 미안해 노이 나빠 매일 넌 아파 매일매일 여기까지니까 두목 당신의 전화로 너무 끝났습니다 내가 가지고 있는 사람은 아닙니다 그만 내려놔 제발 손 치워 그냥 내가 가야 할 같아야 할 같아난 나빠 매일 아파 매일매일 여기까지니까,3,1,-7,-6,-13
703,잠깐만 기다리십시오 말 잘라 미안한데 이러니 이러니 똑같은 말 중 하난 먼저 얘기해야 돼 여기서 그만 끝내 이제 그만 싸우고 싶어 하루도 그냥 넘어가는 일이 없어내 하루가 의미 없어 분 초도 웃을 없어 더는 자신이 없어 오늘은 내가 말할래 네가 어디서 뭘 하든 상관 안 할래가든 말든 맘대로 헤매 번 지겹도록 반복되는 매일 분 기다립니다 내게서 떨어져 줄래 이러니 손 놓고 말해 번을 들어도 말은 거기서 거기 당신의 모든 거짓말과 변명에 지쳤습니다 되돌릴 수 예전으로 남보다 못한 사이가 됐어 우린 서로 부담이 됐어 말곤 내게 더는 상관이 그냥 너에게 말할래 네가 어디서 뭘 하든 상관 안 할래 가든 말든 맘대로 헤매 번 지겹도록 반복되는 매일 네가 없는 이곳에 남겨진 내가 울고 있을 거라 생각하겠지만 괜찮아 반복될 없을 테니까 너와 여기서 그만네가 어디서 뭘 하든 상관 안 할래 가든 말든 맘대로 헤매 번 지겹도록 반복되는 매일,3,1,-5,0,-5
704,보자 보자 보자 두고 넌 미 안보자 머쉬 베놈의 등장 시작해 반격의 서막 음역 시 사람 인생 될지를 몰라돌려라 연락 동창회 열어 빨리 동참해 어서 빨리어 왔어 앉아 딴따라한테 거 술 한잔 따라봐 요즘 어김없이 떨어져 공무원 그렇다면 어깨 토닥 후에 술 따르고 카드 계산 멋이 밴 머쉬 베놈 진정한 머심 애로 그러고 나서 분 뒤 황급히 자리를 뜨는 너의 여자 왜인지 차마 입으론 못해 말이 신어봐 고무신 신데렐라 여자 얘기 싫어하는 자식 헌팅 술집은 가냐 돈 얘기 싫다며 달에 한 번 세진 이유를 알려 주쇼안된다고 했던 나의 친구들 힙합 이래서 역시나 하지 너네 보란 듯이 간질 일나는 계속 뿜어내 몰래 너의 여자와 두 번 해자 두 번에 결혼까지 약속을 해 허락하다 가서 간다 여자 이름 두고 넌 미 안보자 다음네가 가라 하와이 잘 갔다 올게요 누나들과 너무 많은 술값 안 할 거면 집에나 가난 나훈아처럼 그냥 까고 날분 보여줘야만 너넨 입 다물지 아가리 나가리 잘 가세요 손목 무겁다면서 시계는 차 것도 두 개 나네 오빠 허세 부리다 손목 건초염이 걸려라 힙합이잖아 그리운 거는 집 밥이잖아 힙합이 문제인 거냐 원래 놈 아니었잖아뒤지겠어 신념 빌어처먹다 굶어 뒤지겠어 관심 없어 서로 그만 불러 대 이름 다 닳겠어나는 박차고 나가리 상처 나도 씻어 바카디로 카드비로 바뀐 나의 이상형 헬스 끊었어 확인 노 대신 모터 달아 너는 토 달아 덤벼라 세상 아질 수 없다 따라와라 사륜 차보다 빠른 연륜 엄마는 나카야 켄지 아빠는 강일 보너는 일름 보 올빼미족 머쉬 베놈 멋이 밴 놈 두고 넌 미 안보자 가다,3,1,-4,-4,-8
705,뺑이 쳤지 때로는 친구처럼 때로는 가족처럼 하자기에 아침부터 새벽까지 몸 버리고 속 버리고 일했는데 이제 와서 필요 없다 이제 와서 나가라니 웬 말이냐 씨 네가 시키는 대로 내가 다할 아나 씨 네가 시키는 대로 내가 당할 아나 아씨 네가 시키는 대로 내가 당할 아나 아씨 당할 맘대로 시키고 맘대로 끝내도 참았는데 월급날을 기다리며 하루하루 다져가며 버텼는데 회사 사정 어렵다고 임금체불 밥 먹듯이 해대더니 지 살 돈 챙겨 갖고 도망치고 어딜 갔냐 십장생아 씨 다할 아씨 다할 못해 안 해 몸으로 일을 하고 남들처럼 살려는 욕심인가 치사하게 세금 걷고 대책 없다 말하는 대책인가 힘 있으면 보호받고 힘없으면 무시해도 되는 건가 치사해서 못 살겠다 더러워서 못 살겠다 못 참겠다 못해 안 해,3,1,-5,-3,-8
706,염색 안한 양아치 양아치니 뒤에서 할 거 다 하고 할 거 다 하고 그냥 멋져 보일 알았어날 쳐다도 안 봤던 망할 년들에게 소리치면 내가 달라져 보일까 봐난 꽉 마이크를 잡았어 모두에게 손가락질 받아도 끝까지 얼굴에다 똥을 싼다고 너를 생각하며 쓴 가사들 속에 넌 언제나 나쁜 강간범 할 말 없어 양아치 뜨고 싶어서 너를 팔았지 너와 했던 술자리 속에선 한 마디도 못하고 집에 쓴 판타지 괜히 가만히 있는 너를 망가뜨리고 공연장에서 노래 불러 당당히 내가 피해자인 척 랩으로 연기하고 사람들은 위로해 힘내 멋진 놈 곁에 네가 없는 거지 곁엔 없는 거지 스스로에게 물어 문제는 내게 있었지 다가가려 하면 덜컥 났어 겁이 마른 몸이 내가 입은 옷이 맘에 들지 않아서 나를 숨겼지 항상 주위를 맴도는 주변인 되고 싶어 세상 속 주연이 넌 걸레도 꽃뱀도 아니고 어장 주인도 성괴도 아닌데 널 얻으려고 하지 않은 체험한 단어들로 표현해날 더럽다 욕해 너는,3,1,-8,-2,-10
707,자유롭고 싶어 지금 전투력 수치 퍼 입고 싶은 옷 입고 싶어 길거리로 가서 시선을 끌고 싶어내가 보기 싫은 새끼들의 지퍼 닫아버리고 걸 열어주고 싶어 할 말은 하고 살고 싶어그래 내게 욕을 신경 꺼 사랑하고 너도 나라도 아니고 날 말이야 나라라도 날아가고 일이라도 때려 쳐버리고 말아난 일을 하기 싫어 기계처럼 일만 하며 고장 나기 싫어응난 그러고 그게 나쁘던 좋던 말아 그게 나쁘던 좋던 내가 재벌이고 싶으면 말아 그게 돼버리고 싶단 말아난 그냥 돼버리고 주제 파악이고 뭐고 닥치고 내가 누군지 가자 다야 주제라는 있다면 화약처럼 그냥 깨 부시고 깨 부시고 깨 부시고 싶어꾸꾸꾸꾸꿈 깨버리기 싫어깨버리기 싫어깨버리기 싫어 꿈 꿈 깨기 싫다고 꿈 내가 하는 말 말인지 아는 사람 그런 사람 없어없으면 됐어없어도 됐어난 관 뚜껑을 닫겠어내가 살리고 싶은 건 개성 똑같은 새끼들은 지구에 세고 셌,3,1,-5,-4,-9
708,친구가 당신이 아는 암캐와 두 개의 왼쪽 발을 구매하십시오 항상 소녀가 한 일이 멍청한 일이었다 플로 백 벤드를 사용하여 발가락을 만지고 나가고 싶지 않아서 행을 행하고 싶어 보스 광택처럼 빛나는 나이트는 보스와 빛나는 광택처럼 빛나는 나이트입니다 보스와 광택처럼 나이트 보스와 광택과 같은 빛나보고서는 나쁜 사진의 프레스가 필요하지 않습니다 최고위는 모자를 쓰고 바지를 입는다 기회는 내가 가져 갔다고 말하고를 위해 달렸다 과에서 춤을 추면 바닥에서의 서서 내가 그것을 가져갔고를 위해 달렸다 과에서 춤을 추는 바닥은 그들에게 황갈색을 넣게 하자 같은 왕처럼 광택아 나쁜 년이다 보스시 암캐이다 나이트 암캐 와이고 빛나 보스이고 보스 나는이고 보스 빛,3,1,-1,3,2
709,날 다시 보고도 그댄 아무렇지 않네요 편하겠어요 그리 어른스러운 사람이어서 웃으라 하지 말아요 잊으라 하지 말아요 가슴 아픈 것까지 맘대로 말아요 그댈 미워할 래요 그것만은 해줘요 못난 그대가 멀쩡한 그대가 미치도록 미워요 태연한 얼굴 여태 예전 그대로군요 좋은 사람 만나그런 말을 자연스레 건네며 웃으라 하지 잊으라 가슴 아픈 것까지 맘대로 그댈 미워할래요 그것만은 해줘요 못난 그대가 멀쩡한 미치도록 미워요 서로 품을 찾던 숱한 밤들도 두근대던 새벽도 다 흩어졌나요 내겐 살아있는데 살갗 깊숙이 가슴 깊숙이 달라붙어 있는데 지워지지 않는데 잊으라 아픈 것까지 맘대로 그댈 미워할래요 그것만은 해줘요 못난 멀쩡한 미치도록 미워요,3,1,-1,0,-1
710,비와이 가라사대 깝죽거리지 말 지어다 넌 나를 위로 볼지어다 역사로 살지어다 증인의 삶이 될지어다 여기를 밝힐지어다 여길 다 삼킬지어다 구와 신의 기준이 나일 지어다 그게 나일 지어다 비 가라사대 리더는 날 따를지어다 선구자일지어다 돈은 날 찾을지어다 이름의 시대를 만들지어다 한글은 팔릴지어다 잔들을 따를지어다 되고 싶은 내가 될지어다 내가 될지어다 비와이 가라사대 보기나 해 비쉬 모던 위 여호와 밑 가라사대이게 위치 어젠 이제 전설이 돼 열매를 맺어 비 그게 나일 삶으로 나를 뱉어 대역사들은 새겨 댈걸짭들은 베껴 대 진짜들은 말했어 건 최고 최초 날들은 매일매일 배꼽 잡어 배고파도 내걸 만들어 새 걸 창조 계속하고 패권 잡어 배부른 날로 랩으로 바꿔 래퍼는 닥쳐 현재의 고난도 애써 참을 어제로 남아 여태껏 하던 대로 중심은 신의 형상일지어다 세상은 손 안일 영광의 면류관이 날 가질지어다 기준을 제시할지어다 미래를 계시할지어다가 짜는 후회에 살지어다 위에 살지어다 비와이 보기나 해 비쉬 모던 위 여호와 밑 가라사대이게 위치 어젠 이제 전설이 돼 열매를 맺어 비 그게,3,1,-2,-2,-4
711,도마 위에 토막 검은 도화지 안의 도하 속 절대 못 돼 조화 내가 보는 것은입니다 그냥 덫 있는 아나키 아키 아키 아키 앤 앤 앤 아나 아나 아나 너무 어질어질해날 세워줘 여기에 뱀 뱀 뱀들의 선악과 따 먹고선 버리네 안 맞춰 엑스 같은 법에 잃을 없는데 뭘 나눠 이분법에 인간엑스녀도 성녀도 아니네 울려 적신호 삐뽀수갑은 차기 싫어 금목걸이 가져다줘나도 성공하고 싶어내 이름은 앨리스 여긴 너무 이상해 여왕이 되려면 깔려야 해 쟤네 밑으로 갈래 위로 도마 위에 토막 검은 도화지 안의 도하 속 절대 못 돼 조화 내가 보는 것은입니다 그냥 덫 있는 아나키 ,3,1,-1,0,-1
712,누군가가 내게 이렇게 말했지 당신을 지켜줄 의무가 없다고 이는 이렇게 이는 저렇게 지옥에 오신 것을 진심으로 환영합니다 브라질 브라질 브라질 부푼 가슴 안고 이곳에 왔는데 날 반겨주는 것은 썩 유쾌하지 않아 이는 이렇게 저렇게 지옥에 오신 것을 진심으로 환영합니다,3,1,-2,2,0
713,제발 잘난 척하지 말 알고 보면 네가 제일 불쌍해그래 날 자극해봐 재미라도 볼 수 있게 돈 좇다 권력 쫓다 명예만 좇다 가랑이가 찢어져 자빠질 테니까 사랑 좋다 우정 좋다 말들 각오해 뒤통수가 시릴 테니까 안녕 의사 날 살려줘요 확 돌아버리겠으니까 어설픈 말들로 둘러대지 말고 말을 들으십시오 맨정신이 힘들어 아무것도 할 수가 없어 맨정신이 제일 싫어 없인 잠들 수가 없어 시간은 더럽게 안 가고 나이만 들어 죽은 사랑할 일은 더럽게 많은 더하고 싶은 건 하나도 없어 세상이 내겐 차갑고 남 시선은 따갑지 어른 같지만 어린아이작은 키만 훌쩍 자랐지 어릴 적 낭만은 사라진 환상 기분은 광활한 광야 사람들은 날 이해 못 해나도 몰래 맛 가볼래취해라 취해 천국으로 깨고 나면 지옥 못 가난 지금 시금치 없는 뽀빠이 나를 유혹하는 웃음 폭탄 안녕 택시 택시 데려가 줘요 이곳은 너무 힘드니까 며칠 동안만이라도 숨 쉴 수 있게 맨정신이 힘들어 아무것도 할 수가 제일 싫어 없인 잠들 시간은 더럽게 안 가고 나이만 들어 죽은 사랑할 일은 많은 더하고 싶은 건 하나도 없이 모던 두려워 네가 없인 깜깜한 밤이 차가운 세상이 너무 힘에 겨워 없이 아직도 이곳에 홀로 남아나 하나만을 믿고 이렇게 기다리는 내가 바보 같잖아 힘들어 아무것도 할 싫어 잠들 없어라 라라라 라 라라라라 라라라 라 라라라라 라라라 라 라라라라,3,1,-5,6,1
714,널 이제 놓아줘야 될 같아 의미 없는 날짜를 셀 같아내 손이 아닌 꽃이 무대인 나비 다시 날갯짓 하기 이제는 안녕 베의 나에게는 크리스털 별과 비슷한 빛을 가진 다이아몬드 문널 널 위한 걸까 날 위한 건지러 넌 더욱 어울려 누군가의 큰 어깨 제발 글로 갈래 내가 나쁠래 모자 쓰고 말해찡그리며 오지 마 너와 함께인 순간은 불안의 연속에 연속 내가 부족하니 미안해 나의 자존심 우아한 프라다 우아한 샤넬 깔끔한 마르지엘라 같은 너에 반해 잘하려 했지 자격지심 너를 못 가져 너를 못 안아 그댄 변함없이 아주 너무나도 아름다워 달려 누가 먹였니 너의 높은 값어치 언제부터 너는 그리 아름다웠니 누가 넌 과분하데 말없이 그러허나 너에겐 가면 쓰고 감췄지 남겨 미안해 흠집 같은 상처 않음 별거 없는 애처럼 느껴져 몰아세운 거야 미워해줘 날 사랑해준 이제는 알겠어내가 널 가진 것이 아니고 네가 와준 것이라는 것을 없는 도시 압구정의 클럽 속에 먼지 특별하지 않네 너를 위안 삼았나봐 네가 사랑할 오우리 걷던 거릴 지나갈 초라한 내게 그댄 빛을 발해 우아한 프라다 샤넬 깔끔한 마르지엘라 같은 너에 반해 잘하려 했지 자격지심 못 가져 안아 그댄 변함없이 아주 너무나도 아름다워,3,1,4,3,7
715,증명해 증명해 증명해 약간의 펀치와 농담을 할 수 있습니다 걔네들은 왕 우리는 거절합니다녀 째 믿고 가는 나의 촉이 그들은 그들이 똥이라고 말합니다 술 한 잔이 분 안에 지불하십시오 눈빛은 밤에 달과 같은 수프 리틀처럼 밝게 밝아졌습니다 내가 가는 길이 돼지 이제 돼지 빼내 진동 문구점보다 팬시 한 해 누구보다 어디에나 있습니다 목표들을 쫙 눕혀 새 지폐 목표는 손안에 음 모든 건 공감해 뭐라고 요보 겸처럼 애들 날 좋아해다 태울게 그릇 노아의 베난 붕 뜨지 않아 떠나는 별 뭐만 하면 기사 쓰일 툴 전환해서 만든 역 몸집은 작지만 자아는 거인병 당신의 장식 씨발 스타일을 얻었다 인생 당신은 와우 같지 않습니다 은퇴 시킨 놈보단 빚어낸 래퍼가 된 많단 대체 이렇게 쩔어요 모르겠어 요변하지 않을 진린 내가 염소라는 힘을 얻었다 몸 안에서 김이 나와 도망 안 계속 싸워 내가 버는 돈은 기계가 다 세야 해내가 싸는 똥도 금 거위 간 있어 안에 ,3,1,2,2,4
716,내가 뭘 말하든 다들 말하네 알겠습니다 부자 누난 하네 창모 살들은 원해 날 하룻밤 사이 아마 네가 본 애중 가장 내가 랩 스타 늘 취해 눈 풀린 상태로 펼쳐 퍼런 디오르 안 녹색 올 블랙만 입지만 침실은 다양한 색이 가득 보라색이야 그녀 머린 기대 다나 해낸 놈인 거 온 국민 다 안데 손해 보기 싫어 모든 다 말 안 해 차 얘긴 형류와 암 따와 해 아까워 보험 문제 땜에 놓아준 아름다운 라리 레드 달리다 맨 위에 닿아서 별 반도를 떠나간다 화성 떠나기 전에 잠깐만 기억나 내가 했던 말 새끼 손가락 걸어 황혼은 멀었어우린 젊어 다시 우리는 사랑에 빠질 수 있습니다 너를 위해 준비했어 에르메스를 걸쳐 감정에 너를 던져 나와 당신은 사랑에 빠질 수 있습니다 당신은 같은 누군가를 위해 타고 싶어 지금 살거나 죽는 사람에 당신이 무엇을 의미하는지 알고 있다는 것을 알고 있습니다 그들이 당신이 옆에 다시 시작될 것이라는 것을 알고 당신이 춤을 추는 것을 본다 새끼 송가락 걸어 황혼은 멀었어우린 젊어 다시 우리는 사랑에 빠질 수 너를 위해 준비했어 에르메스를 걸쳐 감정에 던져 나와 당신은 같은 누군가를 타고 싶어 지금 살거나 죽는다는 춤을 추는 본다,3,1,2,1,3
717,당신은 그와 말하는 걸 말하는 것처럼 당신이 그와 걷는 것처럼 걸어를 얻으십시오넌 대체 그래난 전혀 이해 못 해나는 문제가 무엇인지 알고 있습니다 그냥 정리하란 말을 이해 못 해 넌 알약이 없습니다 못 버텨 온몸이 길었네 손톱이 기억이 끊겨 조금씩 죽기 직전만큼만 너를 위해 타거나 죽거나 누굴 만났었던 아니에요 마음 오늘 밤은 둘의 마음네 뭘 하고 뭐라고 하던지 괜찮아요 돈을 할 수 있었다 마음네 뭘 하고 뭐라고 하던지 거를 할 수 있었습니다 이제 가야 해 넌 이자카야에서 술 한 모금도 안 마신 내가 널 데려다주겠어 넌 이제 카이엔에서 따듯하게 댑혀엉덩이랑 공기 조심해 플레이어 근데 지금 꽤 남자친구 재료 유형하지 마 나도 안 할게 밀당은 멍청이 겁쟁이 모두가 말하는 그들은 당신의 눈을 보지 않았지만 내가 그런 이유는 하나잖아 진심이야 아깝다고 분일 초도 돌아서면 내기 미스 내비게이션을 무시하기 직전 은 가슴 식혀라고 머린 시켜 집에 가야해시곌봐 눈을 감아나뿐 남자 마음네 뭘 하고 뭐라고 하던지 괜찮아요 돈을 할 수 있었다 당신이 그렇게 걷는 것처럼 말을 있습니다,3,1,-5,-7,-12
718,청구서가 지불 한 날이 끝났으므로 우리는 소주를 불러 내기 위해 맹세합니다 모든 청구서가 지불 한 날의 끝입니다에서 불을 지르기 위해 한판 승부는 청구서가 지불 한 날의 끝입니다 우리는 그린 병이 같은 병을 튀어나오는 소주 푸를 불러 내기 위해 맹세합니다 재범이 형이 산대 재범이 형이 산대 재범이 형이 너네 년을 내가 달 만에 벌어 쩌는 삶을 살게 해 회사 빨 좆까 내가 배운 것은 그게 아냐 자만 않는 맘과 겸손이란 단어 그게 다야 근데 커질 대로 커져가는 나를 봐봐 됐고 한잔 가득 채워 신경 꺼 다시 한잔 마신다 벗어나야 해 너무 취해버린 삶에 소주가 알코올 중독자에게 불을 지르기 맹렬합니다 친구야 너도 나름의 좆같음이 있을 거고 나도 나만 느끼는 좆같은 뭔가가 있는 거잖아 욕하지 마라 나도 소주 빨면 남 얘기 함부로 막 적도 많은데 번 데이고 나서 이제 잘 안 그런다고 옆에서 직접 삶을 본 ,3,1,-7,2,-5
719,흉년올핸 별일이 많았어 특히 안 좋은 일들 원치 않았던 베스트 단연 제일 나쁜 건 그녈 만난 거 나쁜 흉년 집 앞이야 네게 전화해 답도 없고 좋게 끝내보려 했는데 맞아 화난 내려올래 빨리 만 가면 걸릴 공황장애 응사람 볼 땐 사람 눈을 보라던데 당신은 알고 있습니다 충혈된 눈 홍등가처럼 빨개 너무 붉은 색 어의 혀는 귀를 희롱했고 욕 해도 돼 떨어져라 지옥행 지옥 에나 가느라 나도 멍청한 놈이지만 너도 불쌍한 불안 간다 멀리 보내줄게 잘 가요 잘 가요 잘 가요 안녕 나쁜 해가 해참 해 너무 긴 해가 해참 해 하야 내가 이러려고 믿었나 널 넌 입으로 뱉은 약속 깨고 바꿔라 레퍼토리 옆에 알고 보니 있었지 딴 놈 그와 넌 입을 맞추고 돌아와더러운 혀로 핑계를 대런 꼭두각시 마리오네트였을 뿐이라고 너무 아프고 피곤합니다 신은 대체 주셨는지 내게 시련 도와주세요 거룩한 몰리 병신년아 빨리 끝나 제발 정유년은 빨간 닭의 해다 해 시 태그 해시태그 흉년 편히 싹 맡긴 채 숨 쉴 편히 싹 맡긴 채 숨 쉴 연도 나도 멍청한 놈이지만 너도 불쌍한 불안 간다 멀리 보내줄게 안녕 해가 해참 흉년 올핸 별일이 많았어 특히 안 좋은 일들 원치 않았던 와중에 베스트 단연 제일 잘한 건 그녈 떠난 거 안 남았어,3,1,-6,-1,-7
720,들어오라 해 눈을 깔아 비밀로 할 게네 부정과 죄어 드러내 자릴 넘보네 눈 감아 줄게네 본성과 뇌 춤추는 장미를 꺾어 완성한 왕관 나의 거 다시는 얼신 못하게 가시를 친 성관 나를 댄스 워치 노래를 보세요 여기까진 놓아줄게 도망가 얼른 나를 댄스 워치 노래를 보세요 다신 붙잡히지 마그 땐 보게 되는 거야 나쁜 엑스 나쁜 엑스 아주 그냥 나쁜 엑스 아주 그냥 아주 그냥 엑스가 다 신 붙잡히지 마그 땐 보게 되는 거야 미친 자비를 얻었습니다 그러 쥐어 나를 꺾어 상처가 남은 손을 적셔 무서워 보인다 안아 너를 보듬어 제지술로 씻어 죄를 사하여주지 댄스 워치 노래를 보세요 여기까진 놓아줄게 도망가 얼른 다신 붙잡히지 마그 땐 보게 되는 거야 엑스가 다 신 미친 짓을 했건 말을 하건 후횔 하건 상관없어난 무너뜨려날 지르밟은 너를 용서했어 마지막기횔 져버렸다니 안됐어기다려왔어 기대해왔어 이제 엑스가 다 신 미친,3,1,-6,-1,-7
721,색깔은 불 너도 당신의 빛을 찾으십시오 밤 낮 안 가려 빛나지 섬광 꺼질 없이 터져 한철이란 말에 대답해 천만에 기분 너무 높아 대기 위로 구름까지 닿아가지 꼭대기로 엑셀 밟아버려 몇백 킬로 못 쫓아오게 발에 부서지다 뜨고 방해되는 앞에 치워 벽을 넘어뛰어 그냥 뚫어 부정적인 휘어 태양보다 뜨겁습니다 계속 불을 피워 주지 않는 남에 말은 치워 위로 내가 제일 튀어 색깔을 내가 제일 띄어 달려 게임 용량을 계속 키워 차고 일어나 페달을 밀어 앞에 장애물을 치워 닿을 때까지 계속 다시 하다 죽은 다음에야 쉴래 박차고 일어나 페달을 밀어 앞에 장애물을 닿을 때까지 다시 하다 앞으로만 후원해 빨간빛을 태워 버리십시오불을 붙여 번민한 발을 다시 로드 속도 올려 추월해 앞으로만 너무 숨이 차 도 화재를 뱉으십시오 절대 안 멈추지 도착지까지 살고 있어 좋은 인생 유지해 주위 긍정적인 분위기 진부한 색깔이랑 더는 못 섞여 예상되기 싫어 번을 꺾어 방식대로 벗어나지 굴레 없지 문제 끊임없이 절대 안주 안 해 얻어 돈 명성 엔진 과열해 가까이 오면 데임 절대 안주 해얻어 돈 명성 엔진 과열해 가까이 오면 데임 안주 해 차고 일어나 페달을 밀어내 장애물을 치워닿을 때까지 하다 죽은 다음에야 쉴래 박차고 밀어내 치워닿을 앞으로만 후원해 화상을 입으십시오,3,1,-6,-2,-8
722,아무리 힘들어도 웃었어내 곁을 지켜주던 널 보며작은 하나하나날 살아준 땜에너에게 익숙해져 버려서너 없는 모든것이 낯설어언제나 함께하며내손을 꼭 잡아준 땜에다 땜에 행복했는데널 닮은 사람은 세상을 뒤져도찾을 수가 없잖아다 땜에 울잖아그리워 오늘도 세상을 다 뒤져도찾을 수가 없는데난 어떡해아무리 많은 말을 해봐도지루한 시간만이 흘러가따분한 얘기조차웃어주며 들어준 땜에다 땜에 행복했는데널 닮은 사람은 세상을 뒤져도찾을수가 없잖아다 울잖아그리워 오늘도 다 뒤져도찾을수가 없는데난 어떡해너 때문에다 행복했는데널 닮은 사람은 뒤져도찾을수가 없잖아다 울잖아그리워 오늘도 다 없는데난 어떡해,3,1,-3,3,0
723,언제까지 그렇게 누워만 있을 건가 번데기처럼 가만히 안 된다고 그렇게 말로만 하지 말고 아래로부터 찬찬히 한번 엎어보자 어마어마 무시무시하게 대단한 음모가 있는 건가 엄청난 것이 왔구나 피가 거꾸로 솟고 천지가 열리고 돌고 돌고 다시 한번 엎어보자 드디어 올 것이 왔다 우주의 모든 기운이 그대와 나만을 둘러싼다 무서울 것이 없구나 한 번만 엎어보자,3,1,-1,1,0
724,이름은 도끼 힙합 좋아해 모를 리 없을 나의 이름 좋아하지 않아도 싫을 리 없을 나의 리듬 취미는 쇼핑 여행 또는 영화 이제부턴 너와 함께하고 싶어 둘이 술이 아닌 스무디 킹 레모네이드 아이스티 입엔 담배 대신 사탕 또는 아이스크림 주말엔 클럽 술집에서 돈 낭비하거나 아무 여자나 붙잡고 끌어안기 같은 건 하지 않아 공연장 녹음실에서 달에 나올 앨범 준비하며 지내 요즘엔 초중고 할 없이 남녀노소 입에 달고 사는 욕도 하지 않아 쉽게 믿을 수 없단 것도 잘 알아 나에 대해 알려줄게 손 잡고 따라와 베이비 베이비 사랑해 사랑해 학력은 초졸이지만 삶은 초졸하지 않아 네게 주는 사랑 굳이 돌려받지 않아도 괜찮아 그냥 받아 공주처럼 당신을 대우합니다 나보다 잘난 놈은 많을지 몰라도 나처럼 널 사랑할 수 있는 확률은 숫자 카드 맞추기 놀이 뛰어갈게 내가 필요할 조금만 기다려 줘 데리러 갈게 내가 거기에 있을 거야 필요할 모든 것을 필요 모던 걸 잃어버린 지금 내겐 너뿐 시 분 장소는 오케이 잘 알아 거기 이쁘게 하고 당신이 곤경을 본다 흰색 메르세데스 스피커 펍을 노크합니다처럼 비어있는 옆자린 거 타자 가자네가 어디든 달려갈게 항상 위아 올라가 옳아 세상 어디든 너와 함께라면 네가 어디든 달려갈게 항상 위아 올라가 옳아 세상 너와 함께라면 사랑,3,1,2,-2,0
725,잠잘 너보다 잠 잘 드는 머리 덜 굴리는 남자들은 네가 울며 겨자로 만나는 여자 그냥 싹 버려 말 안 들으면 수발들어 떠받들어 쭉 그렇게 대해 줘 맘대로 네가 산 빽 들고 밤엔 네가 받드는 걘 우릴 받들어 월화에서 금토 양화대교부터 영동 청담까지 다 가로등 불 켜지는 밤 우린 눈 떠 죽어도 지키는 품격 쉽게 뺏기보단 훔쳐우린 여유롭고 너는 그냥 굼떠 억울하면 잘 보고 느껴 헤이 거기 언니 일루와 옆에 앉아 언니 데리고 차린 많아 말아 말아 말아 말이 심지의 불은 타오르지 우리네 밤도 타살 얼음 위 발걸음 빠져들 거란 긴장되는 당연하지 모든 나른하지 오빠 맛있겠다는 안의 악마 목소릴 자극하지 하면 일어나비틀거리면 받아줄게 부재중 백 개는 남긴 남자친구 대신 내가 하루 맡아둘게 원하는 대로 다 이뤄져네 환상들 다 꺼집어내 줘우린 밤바람의 노예 늑대랑 암캐 짐승답게 갈게 헤이 거기 언니 일루와 옆에 앉아 데리고 차린 많아 짐승답게 갈게 오늘은 내가 돼 줄게 너의 빨대로 시간에 나온 새끼 들다 같아 아닌 척 돌아가 긴 시간이 아깝기에 음 떡 되게 맥일 돈 있으니까 아빠가 뭐 하냐 묻지 마 눈치 보다 안 웃긴데 웃지 말고 내가 쓰는 만큼 너도 지금 이동하십시오기대지는 마 좁은 어깨 일을 봤으면은 선을 넘진 말았으면 해 말았으면 해 눈꺼풀 눈 뒤덮게 우리들은 구름 위로 도보 취했다면 별 위로 드러누워네 애인 샷건이 연기를 불어넣어 걔는 우리랑 있을 땐 안 부끄러워 헤이 거기 일루와 옆에 앉아 데리고 차린 많아,3,1,-2,-3,-5
726,꿈이었어 너와 마주했던 미라클 헛수고였어 너와 함께했던 시간들 옷방에 많은 옷들이 대체 상관이야 멋있게 입어도 나갈 데가 없다 컬렉터는 지겹고 남 주기는 싫어 내가 꼴이야 실용적으로 생각하기 너무 귀찮아 사과하긴 싫어 그냥 안 만들래 미안한 건 미안함 귀찮아넌 성질을 건든다전부 다 꺼졌으면 싶어꺼졌으면 싶어꺼졌으면 싶어 전기를 잘라버려 싹 다 꺼져버려 휘발 망해 버려 휘발 태워버려 휘발 휘발유 발라버려 사랑은 안 해 나의 맘이 메말라서 물을 뿌려야 해 나의 심장은 건성 너를 잊고 싶지만 초능력이 없어나는 없어 차도 차도 남 분위기 갑분싸분위기 바꿔봐틀어봐 하드 락 오늘 아니요빠꾸야시간 빠르다 너와 헤어진 지 개월째 너무 아쉬워서 오늘 날씨 최곤데 비라도 내렸으면 싶어 영화처럼 분위기나 잡게 비참해 귀찮게 넌 성질을 건든다전부 다 꺼졌으면 싶어꺼졌으면 싶어 전기를 잘라버려 싹 꺼져버려 망해 버려 태워버려 휘발유 발라버려나쁜 짓 배워버려 악당이 되어버려 태워버려 태워버려나쁜 짓 배워버려 악당이 되어버려,3,1,-4,2,-2
727,해당 지역의 컴백이 아냐 떠난 적 없으니까 고개들이 돌아 진정해 목 꺾일라 분홍빛의 얼음 드립 드립 드립 피즈 게임이 아냐 진 적이 없으니까 짖어봐 목에 목줄은 거니까 땅바닥에 닿은 페달 우리는 두 개의를 간다 초록 비를 내려 머리 위로 두목 여행 아기 겸손하게 그냥 앉아있어 그냥 앉아 몰락에 대한 베이비 탑많은 사람들이 시도했습니다 람보르기니가 들을 나를 우리가 당기면 당신을 알고 있습니다 셧다운 간판 내리고 문 잠가 셧다운 채찍 돼지 채찍 채찍 돼 검은색 분홍색으로 한 번 햇볕에 쬐면 우리가 당겨서 당신을 알고 있습니다 셧다운 간판 내리고 문 잠가 끄기 나쁜 지상에 있고 싶다 옳은 슬리 딘 나가되고 싶어 하는 지망생의 내가 전 세계에서 당신이 되었다면 세 명입니다에 진주는 우리가 투자 한 수업을 수업에 투자했습니다 하지 않는 드레스를 보십시오 구매를 구입합니다 우리는 그것이를 요청합니다 팝스타이지만은 파파라치에게 작별 인사를 합니다 쪽을 얻으신시오 그것이 아는 것이 아니라는 것을 위해 웃을 것이다 나중에 공정한 그것 당신의 지역에서 지금 지역은 다운되었습니다 그것 셧다운네 답안지야 똑바로 두목 수면 아기 뒤집어봐 이건 가격표야 자신의 차선에서 저렴한 베이비 스테이 원인 미디엄 들을 나를 잡아 당기면 당신을 알고 있습니다 간판 내리고 문 잠가 돼지 돼 검은색 분홍색으로 한 번 햇볕에 쬐면 당겨서 아래로 휘젓는 채로 계속 지켜보고,3,1,4,-7,-3
728,반복된 빌딩 속에서 오래전에 지쳐있는 네게 느껴나는 알아버렸어그래 아기 끝내자 졸업이니 불안이 보여 걱정하지 마세요 날 보고 웃어줘 네가 나로 인해 벗어날 수 있게 영혼이 살아나는 굽 밑에 노랜 우릴 받치고 너는 춤췄지이건 너와 나를 위해 내가 너로 인해 벗어날 수 있게 영혼이 살아나네 몸짓에 노래 너와 나를 감싸고 마주쳤어 걱정하지 마세요 날 보고 웃어줘 걱정하지 마세요 날 보고 웃어줘 웃어 관광 떠나기 전 이틀 남아 예쁜 널 떠올리다가 너의 집 앞이잖아 유혹이 잦아 건반 잡다 이제 마크 긴 예사롭지 않은 기류 안에 찻잔 언덕 위의 나의 선 하늘에서 잠을 깨요 최하 북내 술집에서 제일 아름다운 개헤엄 원하는 없대 그녀는 소원마저 취저난 모든 동물의 왕에 같은 삶이 도시 상처받을 일은 없도록 해너의 표정 변화 하나에 들통나는 에너지니 적난 너지 열두 개 도의 화음보다 예쁜 민낯이 지진형이의 사진 속 시차 빼기 소녀였던 너는 지금 순간 네가 필요한 시간은 두 번 지금 또는 영원히 계속해서 웃어 오늘 녹음 끝 스케줄 다 뺄게 연봉 억 천 찍었으니 걔넬 팰게 찐따에서 맨 위 맹세코 게으름을 피운 적 없지 웃어줄래 걔네 들이 뭐래 욕하던 걔네 들이 뭐래 세션맨 해서 만 원을 받던 때에도 너는 곁에서 있었어 이제는 노래를 듣고선 춤춰줘 술잔에 예거를 부었어 잘 되는 울먹여 잘 되는 울었어울지 마 얼굴이 부어요 이제는 웃어,3,1,0,1,1
729,열여덟 번의 낙엽이 졌지 너도 알듯이 입술이 찢어질 빨개벗은 기분이 들었고 입었어 마른이건 의미 없지 이전 술래잡기 같아 근데 못 잡는 모습은 바보 같았고 이제야 혼자인 이유를 알 같아 내가 괜찮아 벌써 걔네들의 속 안이 다 보여 형 이건 속이는 거지 작년 겨울 아우터 열 배로 떼다 팔던 것처럼 형들의 기준보다 컸지 그들의 기분보다 높이에 있지만 여태 내가 놓친 겨울 가을에 멈춰 있지 낙하 당신은 그것을 할 수 있습니다 나를 장려한 다날 어지럽게 애매한 관계들이 덮친 더위를 떼어 내고 나니 번지는 색 그것 카키 남아있는 먼지를 떼어 내고 막지 숫자들의 엮인 메시지 우정에 목숨 걸어도 없지 옆엔 몸만 남아있고 겁이 뱉네 할 수 있다고 말했다 친구 간 대 슬프다 안돼 밤이 지 잠에 들지 못해 따 위스 키다 시 병신 돼서 병원 고민해도 현주 너는 날 믿지 다들 괜찮냐고 물어봐 불안정에 묻어가 기억하길 원한다면 울어봐 관계는 추억 같은 거만 주더라 그려간 꿈들은 이제 흐려가도 걔네한테 주면 안 돼 숨어 소년이 주면 안 돼 소년 아주면 안 돼 소년아 작가들은 떠나게 하지 소녀가 마천 이별에 닿았고 찢어진 옷에 스며 향이 할 수 있다고 말했다 친구 간 대 슬프다 되나는 있다고 말했다 친구 간 대 슬프다 안돼 시간에 돌아왔습니다 뺏긴 그녀가 필요하다면 이제 일어 민소매 간에 돌아왔습니다 뺏긴 그녀가 필요하다면 이제 일어나,3,1,-8,4,-4
730,는 태그를 터뜨립니다좆까 가격표 훔쳐 너의 마음 모든 얼음 뭘 째려 세밀한 세정 세미성 걔를 훔쳐나는 너무 많은 암캐를 얻었다 눈머니 이거에 숨어 뒤에 나의 나쁜 짓을 할 땐 내가 먼저 하지에 살지 모여 한가운데 아이아이가 모여서 무리 나이가 넘자 사기 쳐 릴타치같이계속해서 벌어 두 배로 차분해 분에도 노래로 만 앨범 내도 되겠네 이거 레벨이 그렇게 합니다 어린 나이에 부자 돼버리네 아토피 걸린 목 나에 체인 늘어나 앨범이 컨트롤 못 해져 스피드 레이스 거울에 보여 신나 대면식 대리석 테이블 위 희미하게 보이는 이게 태도지가 지지 못 해도 이유인 놓쳐 앨범 내놔 새끼야 트로피 나에게 밟아선 놈 데리고 화난 리얼해 병신아 넌 못해 영비같이 우는 태그를 터뜨립니다좆까 가격표 훔쳐 너의 마음 모든 얼음 뭘 째려 세밀한 세정 세미성 걔를 훔쳐나는 너무 많은 암캐를 얻었다 눈머니 이거에 숨어 뒤에 나의 나쁜 짓을 할 땐 내가 먼저 하지에 살지노랑 초록 파랑 레인보 돈을 모아 프라다 짤랑 님,3,1,-9,-2,-11
731,허락하다 는 살고 있습니다 는 살고 있습니다 는 입니다갱 우리는 정상에 올라우리들은 잘 나갈 수 밖에그래 그래너가 팬이라면 다 퍼줄 수 있어모든 것너가 팬이라면 다 퍼줄 수 있어모든 우린 움직여 바삐 우리들은 구미호그대들은 카카시덫 사냥꾼 요나가 어디에 있습니까 알려줄게 줄을 쳤다아 그전에 랩하기 전으로 널되감기필요한건 찾기도 전에내 것입니다시간 문제야시간은 입니다뭐 다 바라는 대로 되지는 않지만 미리말해둬우리는 정상에 있습니다내입으로안해도그리고 그것을 살고 있습니다안봐도 비디오 롤렛 그것을 살아 가고 있습니다치원이 팬이면 이리온반응은 안봐도 비디오네 비명 소리 듣고 싶어 인이어뺐어 바보들 거주해 랜선튈려고 별의 별 걸 다해 최선내가 얻는 지 알고 싶어 갱 추가 등에있는 빨대자국으로벌어 돈을 쓸어 담어내가 로또에서 이겼던 것처럼아직 해야될게 많아더이상은 못해 가난딸려오는 돈에 비해내 지갑은 너무 작아맨날 바빠배달 단골헐렁한 바지그러나 오늘 밤 스테이크와 랍스터에 우리살맛나지시간갱 우리는 정상에 올라우리들은 잘 나갈 밖에그래 그래너가 팬이라면 퍼줄 있어모든 것너가 살아내일이 없게 흥청망청 최대 현기증얘넨 모른 척하고 꽂아 빨대쪽 빨아 먹고 클라우트 추격가끔 빼고 한패같아보여 매일매일우리 보고 하는게똑 같아 보여근데도 졸려허리띠 빡세게 조여안그러면 우리가 조져어린 소년들논현 블락시간 갱난공불락우리는이 히트 시계를 때는 없이 그들을 죽였습니다 쉴 틈 없이 달려왔지내 손목에 수갑 채워재범답게 나여기서 이것을 죽이고 있습니다난 힙합 씬에서신 아버지구원을 하러 왔지같은 라인업이어도 페이가 달라당신은 팀을 엉망으로 만들 없습니다나의 패션나이키 또는 디자이너손목 그리고목걸이 블링회장님 되어가는 과정하는 사업이 개인지물 폭탄에서다 핵 핵 거려 처럼나를 보면 처럼브래지어 던져 매일 평면처럼휴무돈을 뿌려 던져 처럼시구 몸을 풀다펌삥좀됐어 거울 보고 몸을 풀다개런티 보다 원해지분 몸을 풀다지분 있습니다 그것을 살아 가고,3,1,-4,-5,-9
732,집시 소녀 도망가자 계속 보면 너도 망가져 벨트 매고 도어 창문 잠가둬 뒤도 안 보고 밟게 한땐 너도 영리한 타입 제의 눈 천리안 타입 파도 못 타고 멀미할 놈 멀리할 타입 넌 파도 위에 섰었고 수평선 너머 스캔해도 뚜껑은 거기 없었어 졸렸지 사는 이게 다야 숨이 조였지 가자 바다 이쁜 나라 거기 어디였지 말 안 통해도 요샌 돈이 번역기 너는 번아웃이 아닌 세기 히피 신념 있는 차이로 시치미 떼기 쉽지 빠르게 뛰는 세상 돈이 우리가 원한 열반 여긴 너무 비싸 안녕 집시 소녀 세상은 달아나 우리가 안 피해도 멸종 직전 세상은 남아나 우린 눈을 위에로 떠 별 보는 소녀 너는 나의 거울 떨어본 알아 너의 겨울 별 보는 너는 나의 거울 떨어본 알아 너의 겨울 집시 잘 하면 나의 주마등의 여우조연 너랑 쨀 생각 땜에 나사 조여 망해가는 세상 너로 인해 여유로워 양기의 음 음기의 양 하이 비해 약은 분 뒤에 넌 영원함의 조각 지금에 늘 집중하지 사람 대신 주님을 질투하지 쟤는 인스타 셀렙 쟤는 갱스터 비치 누군 현모 누군 양처 비슷하지 다들 내일 내일 내일 보고 뛸 심산이고 나도 인간이고 간혹 같은 실수하지 네가 날 잘 잡으면 역시 너의 바위 시대의 틈에 낀 발을 꺼낼 사이 지구라는 우주선 억의 승객 다 좌표 없이 불안해도 우린 매일이 축제 안녕 세상은 달아나 우리가 피해도 멸종 직전 남아나 우린 눈을 위에로 떠 별 보는 거울 떨어본 알아 겨울 앓아 여긴 우주의 작은 점안의 작은 점안의 작은 안의 섬 같은 하늘 아래 너랑 웃네의 동네 나무는 상록 야자방 따신 하얀 모래사장 초록 바다 부서지는 파도 앞에 반짝이는 땜에 반짝이는 눈을 눈 안에 담아 안녕 달아나 피해도 멸종 직전 남아나 위에로 떠,3,1,-4,-1,-5
733,사업에서 벗어나지 않습니다 계속해서 나오십시오 다 여긴 증인 넌 바른 척하는 범인 찔리는 걸 당신은 그것을 느낍니다 네가 뭔데 솔직하지 못해넌 다를 건 대체 뭔데 소년 나쁜 소년 생각해 네가 하고픈 대로 소년 모르면 믿고 싶은 대로 아무것도 아님 한판 승부 당신은 돈입니다 알려진 나에게 일이 아니야 욕을 하는 이윤 다 있는 가야나 아닌 안에 우리가 파티를 하기 우리는 파티하지 않습니다 걱정 드라마를 한 번도 하지 않습니다 우린 아침까지 야생 신경 쓸건 따로 몰라 오늘 다 집어치워 눈치 보지 말고 볼륨 업 우리는 멍청한 멍청한 바보 바보 누가 뭐래도 드럼 갈 때까지 아기 멍청한 바보 누가 뭐래도 드럼 갈 때까지 베이비 우리는 간다 몰입하니 눈 몰리는 이치 시시콜콜 무료함을 완충해내키면 곧장 노래가 흐름을 얻으십시오 주도권을 그립보다 거리낌 허물어 허락하다 돌변함은 때때에 아무렴 어때까무러치게 즐겨 사는 거지 방식은 파티를 따르지 않는다 파티 하지 않는다 걱정 드라마를 한 번도 하지 우린 아침까지 야생 신경 쓸건 따로 몰라 오늘 집어치워터지게 올려 볼륨 업 누가 뭐래도 드럼 갈 때까지 아기 베이비 간다 숨이 차올라 심장을 죄여 풀어 나의 사슬 일어나 오늘 밤 지나 해가 뜰 계속 내일 일은 내일 은 끝이 저질러 같은 바보로 간다 아기 베이비 드럼을 골라,3,1,-7,2,-5
734,엉덩이 빵빵빵 남자들은 탐탐탐 입술은 냠냠냠 어딜 가도 당당당 등장은 짠짠짠 뛰자 뛰자 방방방 디스코 팡팡팡 안녕하세요 비시 지금 어디여 도쿄의 쇼핑 행위 개인 제트기에서 일어나 매일 아침 꼬끼오 마카오에서 카드를 뒤집습니다 내가 제일 잘나가 전화를 날려 버리지 않고 그릴에서 카카오 다이아몬드에 나를 때리지 않겠습니다 날 말려 누가 피부 톤 내가 두바이에서 얻은 소년들은 당신의 소년들을 주저하지 않을 것입니다 엉덩이 빵빵빵 남자들은 탐탐탐 입술은 냠냠냠 어딜 가도 당당당 등장은 짠짠짠 뛰자 방방방 디스코 팡팡팡 안녕하세요 비시 옐로 골드와 그것은 노란 뼈처럼 빛나고 전화에서 셀카로 나를 볼 수 없었습니다 상하이에서 나를 찾으십시오의 샷이 무엇인지 알고 있습니다 아시아 소녀들이 소파에서 춤을 추었습니다 그들은 알고 있으며 그들은 노래방에 있는 것처럼 모든 단어를 노래합니다 엉덩이 빵빵빵 남자들은 탐탐탐 입술은 냠냠냠 어딜 가도 당당당 등장은 짠짠짠 방방방 디스코 팡팡팡 안녕 비시가 불을 피우는 것은 나쁜 여자가 바닥에 내려오는 많은 나쁜 여자가 아웃 킬린을 아프게 한다 비시,3,1,-2,-9,-11
735,파티 타임 아는 사람 없네 지루해 앉아있기만 해 바텐더 뭘 마셔야 해 그걸로 줘 빨간색이기 때문입니다 음악 바뀌었네 위로 템포 여전해 다운 템포에 술은 안 마셔 그냥 색깔이 맘에 들어 맘에 들어 골랐어 널 봤어빨간 스커트 빨간 립스틱 그것은 요점입니다 넌 서서 떠들고 있는 멍청한 여자들과는 달라나는 넌 보일 보이지 않아안타까운 마음에 쳐다만 봤네 거를 통해 사용을 통해를 통해를 통해를 통해 본다 요즘엔 되는 없네 내일도 일하러 가야 돼 바텐더 한잔 독하게 줘봐 크레디트카드 줄게 친구들에게 한 잔씩 쫙 돌려줘봐 헤이헤이 한도 초과 그냥 춤 당기다가 집에 가고 싶어 엉뚱한 여자 안기잖아 도망가고 싶어 적당히 끼 부리다가 갈래 밤새는 건 무리잖아 친구 눈 피해서 몰래 나가다가 걸렸어 널 봤어 빨간 스커트 빨간 립스틱 그것은 요점입니다 넌 서서 떠들고 있는 멍청한 여자들과는 달라나는 보일 보이지 않아안타까운 마음에 쳐다만 봤네 당신을 통해 본다 왼쪽으로 보 없어 다시 뒤로 보 없어 오른쪽으로 보 가도 없네 다시 앞으로 보낸 안 보여 머리는 땡땡 클럽 안은 퇴근시간의 뱅뱅사거리 같아 완전 바글바글 그녀 근처에 와글와글 이상한 기분이야 몸이 가벼운 걸 취한 건 아냐워어 쟤 누구야 궁금할 분야 너무 괜찮은 걸 놓치면 후회할 거야 너를 보인다 보일 보이지 않아안타까운 마음에 쳐다만 봤네 거를 사용을 본다,3,1,-8,8,0
736,이리도 세상엔 이별이 많은지 사랑이 힘든 건지 궁금했었죠란 이제 또다시 묻고 있죠 견디는지 많은 슬픔 끝나긴 하는지 괜찮아요 다 그렇듯 이러다 말겠죠에 가슴도 눈물도 다 가라 앉겠죠더 안을수록 부서져 버릴 우리를 알고 있죠고 내는 일이 사랑이라는 걸 사랑해 사랑해 말해줄 시간이 아직도 많을 알았죠 언젠간 누군가 그대를 가져갈 사람 벌써부터 부러워지네요 행복하지 마요 행복하려면 사랑한 날 잊어야 하잖아 가시가 박힌 숨 쉴 때마다 눈물이 흘러와 사는 사는 것이 아니죠 사랑하지 마요 내가 누구와도 영원할 수 없어 그대를 그곳에 두고 온 그것만 기억하면 찾을 수 있죠 멈춰있는 사랑인 거죠 괜찮아요 웃어요 하루에도 번씩 마음이 바뀌죠또 버리고 주워 담고 오늘도 그래요 꼭 좋은 사람 만날 거라고 말하는 나였지만 나의 가슴은 그댈 잡고 있죠 사랑해 나에게 말해줄 그대의 목소리 이제 들을 수 없겠죠 지금만 잠시만 머물다 올 것을 그대의 곁에 있는 사람도 아나요 행복하지마요 행복하려면 사랑한 날 잊어야 하잖아 가시가 박힌 숨 쉴 때마다 눈물이 흘러와 사는 것이 아니죠 사랑하지 마요 내가 누구와도 영원할 없어 그대를 그곳에 두고 온 그것만 기억하면 찾을 멈춰있는 사랑인 거죠 괜찮아요 웃어요 사랑하지 내가 누구와도 영원할 없어 그곳에 두고 온 그것만 기억하면 찾을 멈춰있는 사랑인 거죠 웃어요 눈물도 아픔도 우괜찮죠,3,1,-1,-3,-4
737,때때로 우리는 웃고 때때로 우리는 울고 있지만 우리는 지금 바비가 반을 가져갔다는 것을 알고 있다고 생각합니다 쇠고기의 쇠고기 당신은 데서 반응하기 위해를 지불할 수 없습니다 누군가가 승리 랩 랩 와야 랩에 앉아 있습니다는 말하기 드리 지가 그냥은 닫는 틈이 아니다 때때로 우리가 웃고 울고 있을 같아요 당신이 지금 반을 가져간 것을 알고 있다고 생각합니다 그들이 그들이 모든 것을 말할 에스는 트렌치에 있는 모든 것이 릴리쉬 한 릴 레스 캔을 연주하지 않는다에서 살인자처럼 행동하는 것은 당신과 당신은 넥의 나에서 나에서 나온 것만 좋아합니다 주변의 의는 내가 케이 케이트 마를 얻었습니다 웃고 울고 있습니다 당신이 지금 반을 가져갔다는 알고 있다고 생각합니다 그녀가 가져갔다 그녀는 우리가 당신의 블록에서 가를 가져갔다 그들은 그들이 모든 말할 때의 가이 말할 때의 어디에서나 그와 멍청한 일을 할 때와 그는 이야기를 말해주지 않는다는 것은 알지 못한다고 말하는지에 대해 말해주지 않는다는 것은 예서를 낳았다는 알지 못한다는 이야기를 말한다 와를 원한다는 후회가 죽기를 원합니다는 먹는다 믿기 어렵다고 믿기 어렵다는 점은 그들이의 미친 듯이 멍청한 우리가 있다는 그것은 것들과 이를 어디에서나 어디에 있습니까,3,1,-9,4,-5
738,네가 무엇을 하든 죽일 것이다 내가 무엇을 하든 진짜가 될 것이 다 똑바로 이게 네가 바 바란 짐승 모드 남자는 담배 여자는 바람피울 연기이기는 비트 비트 키보드로 힙합 하는 놈들보다 백 배는 열심히 살지 랩은 만만한 장르가 너무 많은 장군 어중이떠중이들아 다 갖춰라 매너를 버스 하나도 제대로 못 끌어가는 놈들이 랩이나 음악을 논하려 하니들 여기는 지금도 똑같이 다 이렇게 랩을 하지 새 글자 두 글자씩밖에 못 말해 중환 자지 어머니 아버지 실어증 환자들 사짜들 자신을 뒤로하고 거울을 봅니다 가져오려면 독창적으로 해봐 뭐 빨리 성의들이의 이름으로의 오신 것을 환영합니다 거꾸로 돌려봐 이기다 넌 하수구 구수하지 실력이 파업 중인 애들이 뒤에서 시위는 겁나 하지 당신이 두려워하는 사람 비트 위에서 당당해넌 거진 주머니와 없는 실력까지 가난해나는 필요하지 않습니다 아냐 부처 정육점입니가 다니 살을 깎아버려 같은 바바다 바꿔라,3,1,-3,-7,-10
739,누가 돌아온 지 맞춰봐 요 팝 우리가 다시 했어 환호와 기대 속에 첫 등장 의심할 여지가 없습니다 남들과 차별화되는 순간 나갈 문은 없어 넌 넋이 나가게 돼 아주 잘 바위 바위 바위 바위를 바라면 꼬마들 재롱잔치를 멈춰 분위기는 벌써 무르익었고 순식간에 객석을 정복 카펫을 깔아 헹가래 받아터지는 팝 병 박차를 가해 거기에 많은 가짜 가벌들아 세게 울어 웽 웽 무대가 떠나가게 비명 질러 땍땍 아무나 데려오시고 마음 내키는 대로 움직여 다 됐어 정적을 깨워 적당히 할 생각 버려 멍청한 엄지를 세워 열기를 불태워 구역의 미친놈들 모여라 아주아주 좋은 안 나오면 쳐들어간 다조 조여 들어간다 안 나오면 쳐들어간다 내가 당신을 위해 무엇을 할 수 있습니까 안 나오면 쳐들어간 다조 조여 들어간다 쳐들어간다 폭주하는 악당 빨간 불로는 못 막아내 밑으로 주목 한다 전반에 힘찬 함성 발상이 봐거기 똥 폼 잡지 마 손들어 벌 받자 하나가 된 듯이 단합을 해약 간의 소음을 만드십시오 벌들아 세게 울어 웽 무대가 떠나가게 비명 질러 땍땍 꽃미남들은 기를 써 센 척해도 너무 귀여운 걸 깽판 부려 개판 분전 콘셉트는 우리가 전문이야 레거시 간 다 됐어 정적을 깨워 적당히 할 생각들은 갖다 버려 멍청한 엄지를 세워 열기를 불태워 구역의 미친놈들 모여라 아주아주 좋다 당신은,3,1,-2,2,0
